##LongTitle: Ботаніка. Агульная (БНТ)
##HTMLDescription_BEGIN
<div>
	<p class="dictdesc-st">Створана на падставе:</p>
	<p><b>Ботаніка. Агульная і спэцыяльная</b>. Менск: Інбелкульт, 1924.</p>
</div>
<div>
	<p class="spoiler">Прадмова</p>
	<p>Проэкт беларускай ботанічнай тэрмінолёгіі, надрукованы ў гэтай кнізе, складаецца з дзьвюх частак. Першая зьмяшчае ў сабе тэрмінолёгію Агульнае Ботанікі (анатомія, морфолёгія і фізіолёгія расьлін) і складаецца з расійска-беларускага слоўніка і пры ім двох паказчыкаў − для лацінскіх і беларускіх тэрмінаў з Агульнае Ботанікі. Другая частка складаецца з лацінска-расійска-беларускага слоўніка назваў вышэйшых расьлін (гал. чынам Spermatophyta), спатыканых і агульна вядомых у Беларусі. Назвы сем‘яў, родаў і відаў расьлін зьмешчаны тут разам у парадку лацінскага альфабэту. Да асноўнага слоўніка дададзены два паказчыкі тэрмінаў − беларускі і расійскі. Дзякуючы гэтаму, адшукаць патрэбную назву ці тэрмін павінна быць даволі лёгка.</p>
	<p>Увесь проэкт тэрмінолёгіі быў уперад зложаны Дырэктарам Менскае Балотнае Станцыі, сябрам Інбелкульту <b>Вітольдам Міхальскім</b>. Пасьля на працягу 1922−1923 гадоў проэкт быў перагледжаны і прыняты Прыродазнаўчай Сэкцыяй Інстытуту Беларускае Культуры, а часткаю быў заслуханы і ў пленуме Інбелкульту. Найбольш значны ўдзел у гэтай працы па перагляду прыймалі сябры Інбелкульту С. Некрашэвіч, М. Азбукін, М. Грамыка, А. Круталевіч, Ч. Родзевіч і А. Смоліч.</p>
	<p>Першая частка проэкту (Агульная Ботаніка) была ўжо надрукована ў № 7−8 „Вест. Нар. Кам. Асьветы С. С. Р. Б.“ за 1922 г. Вымагала яна, аднак, пэўных паправак і дапаўненьняў. Папраўкі і дадаткі ў гэтую частку проэкту, а таксама ўпарадкаваньне і тэхнічная рэдакцыя абедзьвюх частак, улажэньне паказчыкаў і г. д. выпаўнены сябрам Інбелкульту Ар. Смолічам.</p>
	<p>Выпускаючы гэты сшытак тэрмінолёгіі ў сьвет, мусім адзначыць яе проэктовы характар. Беларуская мова мае дужа багаты запас ботанічных назваў і тэрмінаў, якія толькі часткова выяўлены; на грунце гэтага выяўленага народнага матар’ялу і пабудована нашая тэрмінолёгія. Аднак новыя запісы і досьледы дадуць, пэўна, шмат больш гэтага матар’ялу, чым яго было ў нашым карыстаньні, і тады можна будзе паправіць тыя недасканаласьці, якія могуць спаткацца ў гэтай працы.</p>
	<p>Усе ўвагі і дадаткі да ботанічнае тэрмінолёгіі трэба накіроўваць у Інстытут Беларускае Культуры (Менск, Наркампрос), у Прыродазнаўчую Сэкцыю.</p>
</div>
##HTMLDescription_END
##ArticleLang: ru/be

акклиматизация	акліматызацыя
альпийская флора	альпэйская расьліннасьць, флёра
анемофильные растения	ветрапыльныя расьліны
антеридий	заплодня, антэрыд
антоциан	антоцыян
апотеция	апотэцыя
арктическая область	арктычная краіна
архегоний	родніца, архэгон
аспарагин	ашпарагіна
ассимиляция	прысваеньне, асыміляцыя
ахроматин	ахроматын
базидиальные грибы (Basidiomycetes)	базідыяльныя грыбы
базидия	базідыя
бактерии клубеньковые	бактэрыі корнябародаўкавыя
безбелковые семена	бязьбелевае насеньне
безцветковые растения	бяскветкавыя расьліны
безчерешковый (лист)	бесхвастковы (ліст)
белковое вещество	бялковая матэрыя, белкавіна
белковые семена	бе´левае насеньне
белок (albumen)	бялок
белок (семени - endospermum)	насенная бель
боб (плод - legumen)	струк
болото моховое	імшара
бор	бор
брожение	бушаваньне
брюшко (архегония)	чэраўка (родніцы)
бугорок	гарбок, гарбінка
бутон	пупышка
вакуоля	ваднічок, вакуоля
вегетативный	роставы (вэгетацыйны)
венчик (corolla)	вяночак
венчиковидный околоцветник	вяночкаватае аквецьце
вересчатник	верасьняк
верхушечная клетка	верхавінная каморка
верхушечный лист	верхавінны ліст
верхушечный рост	верхавінны рост
верхушка	верхавіна
ветвление (ramificatio)	галінаваньне
ветвистый	галіністы
ветка	галіна
ветроопыляемые растения	ветрапыльныя расьліны
вечнозеленые растения	вечназялёныя расьліны
вид (species)	від
видообразование	відатварэньне
вилка (разветвление)	вілкі
винная ягода	фіга
влагалище (vagina)	похва
вместилище выделений	камора выдзелінаў
водоросли (Algae)	вадаросты
водяные растения	вадзяныя расьліны
войлок	лямец
волокна древесные	валокны дрэўныя
волокна лубяные	валокны лыкавыя
волосок (trichoma)	валасок
воронкообразный (цветок)	лейкаваты
восковой налет	васковая павалока
восходящий ток	узьбежны ток
вспомогательная клетка	дапаможная каморка
вторичный	другарадны
вьющиеся растения	уюнцовыя, павойныя расьліны
галофиты	расьліны-солялюбы
гамета	гамэта
гелиотропизм	сьветлазваротнасьць, геліотропізм
геотропизм положительный	землязваротнасьць (геотропізм) простая
геотропизм отрицательный	землязваротнасьць (геотропізм) адмоўная
гербарий	зельнік
гибрид	мяшанец, гібрыд
гигроскопическое движение	гіграскопавы рух
гигрофиты	расьліны-мокралюбы
гифы	гіфы
глазок	вочка
глазок спящий	вочка сьпячае
гниение	гніцьцё
годичный слой	гадавы слой
головка (capitulum)	галоўка
голосемянные (Gymnospermae)	голанасенныя
городчатый (лист)	зарубчасты
грибница	грыбня
губа (labellum)	губа
губчатая ткань	губкаватая тканка
гумус	перагной, гумус
движение растения	рух расьліны
двойное оплодотворение	падвойнае запладненьне
двоякоперистый лист	двойча-перкаваты ліст
двугнездный (плод)	двохзакутны
двугубый венчик	двугубы вяночак
двудольные растения (Dicotyledones)	двулісьценевыя
двудомные растения	разнапнёвыя расьліны
двулетние растения	двохгадовыя расьліны
двуполый цветок	двохродавая кветка
деление клетки	дзяленьне каморкі
деревянение (оболочки)	дзервяненьне (абалонкі)
деревянистый	дзеравісты
диаграмма (цветка)	дыяграма
дикорастущий	дзікарослы
диморфизм	двупастацёвасьць, дыморфізм
дичок	дзічка
дланевидно-раздельный лист	далонепадзельны ліст
доля (листа - pars)	частка (ліста)
донце (луковицы)	пятка (цыбуліны)
древесина (Xylem)	драўніна
древесные волокна	дрэўныя валокны
древовидный папоротник	дрэваватая папараць
дрожжи	дрожджы
друза	друза
дубильные вещества	гарбоўныя матэрыі
дугонервный лист	дугажылкаваты ліст
дыхание	дыханьне
дышать	дыхаць
жгутик (fagellum)	джгуцік
желвачки (клубеньки - у бобовых)	каранёвыя бародаўкі
железистый волосок	залозісты валасок
женский цветок	слупковая, жаночая кветка
живчик (zoospora)	жыўчык, зароднік
жилка	жылка
жиры	тлушчы
жолудь(жёлудь)	жолуд
завиток (cincinnus)	завітка
завязь	плодазавязь
зазубренный	шчарбаты
замкнутый пучок	замкнёная вязка
замыкающая клетка	замыкальная каморка
запасные вещества	запасная матэрыя
зародыш (embryo)	зародак
зародышевый мешок	зародкавы мяшочак
заросток (prothalium)	прадростак
зачаток	зачатак
зачаточный	зачатковы
защитный	ахоўны
звездчатый	заркаваты
зев (faux)	зеў
зерна крахмальные	крухмальныя галачкі
зерна хлорофиловые	хлёрафільныя дробачкі
зерновка (caryopsis)	зерняўка
злаки (Gramineae)	травы
зольное вещество	попельная матэрыя
зонтик (umbella)	парасонік
зооспора (zoospora)	жыўчык, зароднік
зрелость	дасьпеласьць
зубчатый	зубкаваты
интеркалярный рост	устаўкавы рост
инулин	інулін
испарение (transpiratio)	параваньне
камбиальное кольцо	мязговы персьцень
камбий (cambium)	мязга
канал поровый	сітавінкавы ход
каротин	каротына
кисть (botrys)	гронка
клетка (cellula)	каморка
клеточная оболочка	каморкавая абалонка
клеточное ядро	каморкавае ядро
клеточный сок	каморкавы сок
клетчатка (cellulosa)	абалоніна
клубень (tuber)	бульбіна
клубеньки (у бобовых)	каранёвыя бародаўкі
клубеньковые бактерии	корнябародаўкавыя бактэрыі
кожистый	скураваты
кожица (epidermis)	скурка, эпідэрміс
колос (spica)	колас
колосок	каласок
кольца древесины	драўніновыя персьцяні
кольцевание	абручкаваньне
колючка	калючка
конус наростания	стажок нарастаньня
копуляция	спалкаваньне, копуляцыя
копьевидный	дзідаваты
кора первичная	кара першапачаткавая
кора вторичная	кара звычайная
корень (radix)	корань
корешок (radicula)	карэньчык
корзинка	кошычак
корневище (rhizoma)	сьцябло-корань
корневой чехлик (calyptra)	каранёвы каптурок
корневые волоски	каранёвыя валаскі
корнеплод	кораньплод
коробочка (capsula)	пушачка
костянка (drupa)	костаўка
красящее вещество	фарбоўнік
крахмал (amylum)	крухмал
крахмальные зерна	крухмальныя галачкі
кристаллоносный	крышталяваты
крона (дерева)	карона
крылатка (samara)	крылаўка
крылья (alae)	крыльлі
крышечка плода	вечка плоду
крючок	гаплік
ксантофил	ксантофіль
ксерофиты	расьліны-сухалюбы
куст	куст
кустарник	хмызьняк
кутикула	надскурка, кутыкуля
лазящие растения	расьліны-лазуны
ланцетовидный	ланцэтаваты
легумин	легумін
лентовидный	стужкаваты
лепесток	пялёстка, кветкалісьцік
лесная растительность	лесавая расьліннасьць
летучка	апушок
лианы	ліяны
линейный	лініяваты
линька (корня)	ліняньне
лист	ліст
листва	лісьцё
лиственный	ліставы
листовка	торбачка
листорасположение	лісталад
листосложение (почки - vernatio)	лістасклад
листочек (foliolum)	лісток
лишайники (lichenes)	лішаі
лодочка (carina)	чаўначок
ложная ось	нібы-вось
ложный плод	нібы-плод
лопастный лист	лопасны ліст
лопасть (lobus)	лопасьць
луб	лыка
лубяная паренхима	лыкавая парэнхіма
лубяные волокна	лыкавыя валокны
луковица (bulbus)	цыбуліна
лупулин	люпуліна
луч сердцевинный	асяродкавы прамень
макроспора	вяліказароднік
масло растительное	алей
маслянистые семена	алейнае насеньне
материнский	матчынскі
махровый цветок	поўная кветка
междоузлие (internodium)	цэўка
межклетное пространство	міжкаморкавая прастора
межклеточные канальцы	міжкаморкавыя хады
метелка (panicula)	мяцёлка
механическая ткань	мэханічная тканка
микорица	корнягрыб, мікарыдза
микроспора	дробназароднік
мицелий	грыбня
млечный сосуд	малочная судзінка
многолетнее растение	шматгадовая расьліна
мотыльковый венчик	матылёвы вяночак
моховое болото	імшара
мохообразные (Bryophyta)	махаватыя
мочки	валасьнікі
мужской цветок	пылковая, мужчынская кветка
мутовка	кальчак
мутовчатый	кальчаковы
мучнистое семя	мучністае семя
мякоть	мякіш
набухание	набраканьне
надкожица (cuticula)	надскурка, кутыкуля
налет восковой	васковая павалока
напряжение ткани	напружанасьць тканак
наростание(нарастание)	нарастаньне
насекомоядные растения	мошкаедныя расьліны
наследственность	спадчыннасьць
нектарник	мёднік
непарноперистый лист	непарнапёркаваты ліст
неполный цветок	няцэлая кветка
нервация	жылкаваньне
нервы	жылкі, нэрвы
низовой лист	нізавы ліст
нисходящий ток	зьбежны ток
нитрификация	нітрыфікацыя
нить (filamentum)	нітка
ноготок	кіпцік
нутационное движение	нутацыйны рух, вагальны рух
обвертка (involucrum)	акрыўка
обверточка	акрывачка
области растительные	краіны расьлінныя
обоеполый цветок	двохродавая кветка
оболочка клетки	абалонка каморкі
образование клеток	утварэньне каморак
образовательная ткань	творная тканка
общий пучок	супольная вязка
одеревенение оболочки	зьдзервяненьне абалонкі
однодольные растения	адналісьценевыя расьліны
одноклеточные растения	аднакаморкавыя расьліны
однолетние растения	аднагадовыя расьліны
однополый цветок	аднародавая кветка
озимь	азіміна
околоплодник (pericarpium)	каляплоднік
околоцветник (perianthium)	аквецьце
окраска	афарбаваньне
оплодотворение	запладненьне
опробковение (оболочки)	скаркавеньне (абалонкі)
оптимум	оптымум
опыление	запылкаваньне
орган	орган
орех (nux)	арэх
ослизнение оболочки	абсьлізьненьне абалонкі
основная ткань	асноўная тканка
ость (spinula)	восьць
ось (rachis)	вось
отбор	адбор
отверстие	адтуліна
отводок	адводак
отгиб	адхіл
открытый пучок	адкрытая вязка
отпрыск	паростак, гучок
очередной	чарговы
пазуха (листовая)	пазуха (ліставая)
палисадная паренхима	парканістая парэнхіма
пальчатый	пальчасты
папоротник	папараць
паразит	чужаед
паренхима древесная	парэнхіма дрэўная
паренхима лубяная	парэнхіма лыкавая
паренхимная клетка	парэнхімная каморка
парноперистый лист	парнапёркаваты ліст
парус (vexillum)	жагель, сьцяжок
пелена (грибов)	плеўка грыбная
пептон	пэптон
первичная кора	першапачаткавая кара
первичная ткань	першапачаткавая тканка
первичный сердцевинный луч	першапачаткавы асяродкавы прамень
перекрестное опыление	крыжавое запылкаваньне
период вегетации	пэрыод росту, вэгетацыйны пэрыод
перистый лист	перкаваты ліст
пестик (pestillum)	слупок
печеночные мхи (Hepaticae)	пячоначнікі
пильчатый	пілаваты
питание	жыўленьне
питательное вещество	пажыўная матэрыя
пища	пожыў
плазмодий	плязмод
плазмолиз	плязмоліза
планктон	плянктон
пластиды	плястыды
пластинка листовая (lamina)	пласток ліставы
пластические вещества	плястычная матэрыя
пленка	плеўка
плесневые грибы	цьвілёвыя грыбы
плеть	вус
плод (fructus)	плод
плодовая ветка	плодавая галіна
плодолистик	плодалісьцік
плодоношение	плодаваньне
побег	паростак, гучок
поглощение	паглынаньне
подвой	дзічка
поколение	пакаленьне
покоющаяся(покоящаяся) спора	нярухомы зароднік
покров	акрыцьцё
покровная ткань	акрыцьцёвая тканка
покров семяпочки (pericarpium)	каляплоднік
покровы цветка (perianthium, perigonium)	аквецьце
полный цветок (completus)	цэлая кветка
половые органы	родавыя органы
понтийская область	понтыйская краіна
попеременные листья	пазьменна-разложанае лісьцё
поперечный разрез	папярочны разрэз
пора	сітавінка
поровый канал	сітавінкавы ход
поросль	адросткі, атожылкі
последовательный	пасьлядоўны
початок (spadix)	булаўка, кіёўка
почва	глеба
почечка (gemmula)	пучочак
почка (gemma)	пучок
почковидный	ныркаваты
предросток	прадростак
прерии	прэрыі
прививка	прышчэпка
привой	прышчэпа
придаток	дадатак
придаточные корни	прыбытковае карэньне
прилистник (stipula)	прылістак
присоска (haustoria)	сысок
прицветник (bractea)	прыкветак
прицепка	прычэпка
пробковая ткань	коркавая тканка
проводящий пучок	праводная вязка
продольный разрез	уздоўжны разрэз
продолговатый	даўгаваты
прозенхима	прозэнхіма, тканка валакністая
прозенхимная клетка	прозэнхімная каморка
проращивание	прарошчваньне
проростание(прорастание) семян	прарастаньне насеньня
простейшие (организмы)	найпрасьцейшыя (організмы)
простой лист	просты ліст
протоплазма	протоплязма
пучок	вязка
пыльник (anthera)	пыльнік
пыльниковый мешок	пылковы мяшочак
пыльца	пылок
пыльцевая трубочка	пылковая трубачка
радиальный разрез	прамянёвы разрэз
разветвление (ramificatio)	галінаваньне
развилина	разьвіліна
раздельнолепестный (венчик)	вольнапялёсткавы (вяночак)
раздельный	падзельны
раздражимость	раздражлівасьць
раздражитель	раздражнік
размножение бесполое	размнажэньне бязродавае
размножение половое	размнажэньне родавае
разновидность (varietas)	адмена
разноспоровые	рознароднікавыя
разрез поперечный	разрэз папярочны
разрез продольный	разрэз уздоўжны
разрез радиальный	разрэз прамянёвы
разрез тангентальный	разрэз тангентальны
расположение листьев	лісталад
распускаться	распукацца
растение	расьліна
растения гидрофильные	расьліны-вадалюбы
растения двудомные (dioecae)	расьліны рознапнёвыя
растения однодомные (monoecae)	расьліны аднапнёвыя
растения одноклеточные	расьліны аднакаморкавыя
растительная область	расьлінная краіна
растительное масло	алей
растительное сообщество	расьліннае згуртаваньне
раструб (ochrea)	розьверць
реснички (ciliae)	расьнічкі
ржавчина хлебная	іржа збажавая
род (genus)	род
розетка (листьев)	акружак
рост верхушечный	рост верхавінны
рост интеркалярный	рост устаўкавы
ростовая ветка	роставая галіна
ростовое движение	роставы рух
росток	парастак
рубчик	рубчык
рыльце (stigma)	лычок
саванны	саваны
самоопыление	самазапылкаваньне
самопроизвольное движение	самавольны рух
сапрофиты	расьліны-гнілаеды
сахаристые вещества	цукраватая матэрыя
свернутый	згорнуты
свободнолепестный (венчик)	вольнапялёсткавы
сегмент	адцінак ліста
селекция	сэлекцыя
селитра	салетра
семейство	сям'я
семенник	насеньнік
семенные растения	насенныя расьліны
семя	семя, насеньне
семявход	ваконца
семядоля	лісьцень
семязачаток (ovulum, gemmula)	семязавязь
семянка (achaenium)	семячка
семяножка (funiculus)	семяножка
семяносец (placenta)	семяложак
семяпочка (семязачаток, яичко)	семязавязь
сердцевидный (лист)	сэрцаваты (ліст)
сердцевина	асяродкавіна
сердцевинная трубка	асяродкавая трубка
сердцевинный луч	асяродкавы прамень
сережка (amentum)	каткі
сетчатый сосуд	сеткаватая судзінка
сидеральная система	сыдэральная сыстэма
сидячий лист	бесхвастковы ліст
ситовидные трубки	сітаватыя трубкі
скорлупа	лушпайка
скрещивание	крыжаваньне
скрытосемянные	акрытанасенныя
слизистые грибы	сьлізяватыя грыбы
слоевище (thallus)	паросьля
слоевцовые растения (Thallophyta)	паросьлевыя расьліны
сложный лист	складаны ліст
сложный пестик	складаны слупок
слоистость крахмала	слаістасьць крухмалу
слоистость оболочки	слаістасьць абалонкі
слой (годичный)	слой гадавы
созревание	дасьпяваньне
сок клеточный	каморкавы сок
соломина	саломіна
солончаковые растения	расьліны-солялюбы
сообщество растительное	згуртаваньне расьліннае
сорная растительность	пустазельле
сосальце (haustoria)	сысок
сосудисто-волокнистый пучок	судзінкава-валакняная вязка
сосуды	судзінкі
соцветие	суквецьце
социальные растения	гуртовыя расьліны
спайка (connectivum)	зьвязка, злучка
специальный пучок	асобая вязка
спиральное листорасположение	пакручасты лісталад
спора весенняя	зароднік веснавы
спора зимняя	зароднік зімовы
спора летняя	зароднік летні
спорангий	зародня
споровые растения	зароднікавыя расьліны
спящие глазки	сьпячыя вочкі
средиземноморская область	міжземнаморская краіна
срединный лист	сяродкавы ліст
срез	зрэз
сростнолепестные	зрослапялёсткавыя
ствол	пень
стебель (cormus)	сьцябло
стержень	стрыжань
столбик (stylus)	шыйка
столбчатая ткань	слупкаватая тканка
стрелка	стрэлка
стреловидный лист	стрэлкаваты ліст
строение	будова
стручок (siliqua)	лускаўка
сумка (ascus)	торбачка
сумчатые грибы (Ascomycetes)	торбачкавыя грыбы
супротивные листья	процілежныя лісты
тангентальный разрез	тангентальны разрэз
термотропизм	цяплозваротнасьць
ткани	тканкі
тор (цветоложе, receptaculum)	дно кветкі, кветадоньне
торф	торф
точка роста	пункт росту
травы	зельле
травянистый	зельляваты
транспирация	параваньне, трансьпірацыя
тройчатый лист	патройны ліст
тропизм	зваротнасьць
трубка венчика	трубка вяночка
трубка чашечки	трубка падвяночка
трубчатый цветок	трубкаватая кветка
трутовик (polyporus)	губка
тундра	тундра
тургесценция	напружанасьць
тургор	напружаньне, тургор
тычинка (stamen)	тычачка
тычинковая нить (filamentum)	тычачковая нітка
углеводы	вугляводы
углонервный лист	кутажылкавы ліст
узел	каленка
уредоспоры	летнія зароднікі, урэдаспоры
усвоение азота	прысваеньне азоту
усик	вусік
устойчивость	стойкасьць
устьице (stoma)	прадушынка ліставая
утолщение оболочки	пагрубеньне абалонкі
утолщение стебля	пагрубеньне сьцябла
фермент	фэрмэнт
фига	фіга
флаг (vexillum)	сьцяжок, жагель
флора	расьліннасьць, флёра
хвойные растения	ігластыя, шыльнікавыя расьліны
хвоя	ігліца, шыльнік
хлороз	бледніца
хлорофил	хлёрофіль, лістазелень
хлорофиловые зерна	хлёрофільныя дробачкі
хохолок (pappus)	чубок
цветение	красаваньне, цьвіценьне
цветок	кветка, краска
цветок бесполый	кветка бязродавая
цветок воронкообразный	кветка лейкаватая
цветок женский	кветка слупковая, жаночая
цветок махровый	кветка поўная
цветок мужской	кветка пылковая, мужчынская
цветок неполный	кветка няцэлая
цветок обоеполый	кветка двохродавая
цветок однополый	кветка аднародавая
цветок полный (completus)	кветка цэлая
цветок трубчатый	кветка трубкаватая
цветок язычковый	кветка язычкаватая
цветоложе (receptaculum)	кветадоньне
цветоножка (pedunculus)	кветаножка
целлюлеза(целлюлоза)	абалоніна
чашелистик (sepalum)	падвяночкавы лісток
чашечка (calyx)	падвяночак
черенок	зразок
черешок (petiolus)	хвасток ліставы
чехлик корневой (calyptra)	каптурок каранёвы
чечевичка	сачавічка
чешуевидный	лускаваты
чешуйка	лусачка
чувствительность	чуласьць
шип	калючка
шишка	шышка
шляпка	шапка
шляпочные грибы	шапкаватыя грыбы
щетинка	паўсьцінка
щиток	шчыток
экологическая география	эколёгічная географія
эмбриональный	зародкавы, эмбрыональны
эндемизм	эндэмізм
эпидермис	скурка, эпідэрміс
эпифиты	расьліны-жываросты
этиолирование	этыоляваньне
ягода (bacca)	ягада
ядро	ядро
ядро клеточное	ядро каморкавае
ядрышко	ядзерка
язычек(язычок) (ligula)	язычок
язычковый цветок	язычкаватая кветка
яичко или семячко	яечка, семязавязь
