##Title: Практыка і тэорыя літаратурнага мастацтва (БНТ)
##HTMLDescription_BEGIN
<div>
	<p class="dictdesc-st">Створана на падставе:</p>
	<p>Практыка і тэорыя літаратурнага мастацтва</b>. Менск: Інбелкульт, 1923.</p>
</div>
<div>
	<p class="spoiler">Прадмова</p>
	<p>Апрацаваньне тэрмінолёгіі <i>«Практыка і тэорыя літаратурнага  мастацтва»</i> пачалося <i>Гуманітарнай Сэкцыяй Беларускае Навукова-Тэрмінолёгічнае Камісіі</i> ў 1921 г., а закончылася ў 1922 г. – <i>Тэрмінолёгічнай Камісіяй Гуманітарнай Сэкцыі Інстытуту Беларускае Культуры.</i></p>
	<p>Спачатку мелася на мэце апрацаваньне сьцісла стылістычнай тэрмінолёгіі, г. з. па тэорыі прозы і поэзіі. Але калі прышлося падбіраць тэрміны, то адразу выясьнілася немагчымасьць прытрымлівацца гэтае сьцісласьці: тэорыя прозы й поэзіі так шырока абхоплівае ўсе галіны літаратурнага мастацтва, што выдзеліць сьцісла стылістычныя тэрміны й замкнуцца ў пэўных рамках было-б непажаданым абмежаваньнем усяе працы ў дадзенай галіне. Апрача таго, калі-б і выдзеліць дзе якія сьцісла стылістычныя тэрміны, то яны амаль што ўсе пераняты ўсімі народамі з грэцкае або лацінскае мовы, як, напр., <i>проза, поэзія, драма, лірыка</i>, якія не паддаюцца перакладу, і гэткім чынам прышлося-б даць не беларускія тэрміны, а чужаземныя ў беларускім правапісе. Дзеля гэтых вось прычын было вырашана надаць тэрмінолёгіі болей жыцьцёвага характару і абхапіць хоць частку таго літаратурнага слоўнікавага матар‘ялу, з якім на кожным кроку прыходзіцца спатыкацца кожнаму пісьменьніку ў сваёй літаратурнай працы. Гэтым Тэрмінолёгічная Камісія манілася дасягнуць хоць і ня поўнасьцю дзьвюх мэт: 1) даць самыя патрэбныя тэрміны для тэорыі прозы й поэзіі і 2) даць беларускі тэрмінолёгічны матар‘ял для літаратурнае практыкі, каб гэтым хоць крыху дапамагчы нашаму пісьменству, асабліва часапіснаму, пазбавіцца ад лішняй, у большай частцы непатрэбнай і незразумелай чужаземшчыны.</p>
	<p>Разглядаючы чужаземныя тэрміны, Камісія старалася па магчымасьці даваць, заместа іх, толькі −  беларускія, а калі й пакідаліся чужаземныя, то ўжо такія, што: або агульна-прынятыя, як, напр.: <i>літаратура, сонэт, ода</i>, або − пашыраныя і ў народзе, як, напр.: <i>камэдыя, талент, артысту</i>. Побач з беларускім ставіўся чужаземны тэрмін толькі тады, калі ён − так сама добра вядомае слова ў народзе. Агулам жа Камісія лічыла лішнім даваць чужаземныя тэрміны побач з беларускімі, зважаючы на тое, што калі хто захоча карыстацца з чужаземшчыны, то яе знойдзе і паміма беларускай тэрмінолёгіі.</p>
	<p>Уся зьмешчаная ў гэтай кнізе тэрмінолёгія «Практыка й тэорыя літаратурнага мастацтва» канчаткова разгледжана й прынята <i>Тэрмінолёгічнай Камісіяй Гуманітарнае Сэкцыі Інстытуту Беларускае Культуры</i> ў складзе сяброў Камісіі: <i>М. Байкова, М. Гуткоўскага, Я. Лёсіка, І. Луцэвіча, К. Міцкевіча, С. Некрашэвіча, С. Плаўніка і У. Чаржынскага</i>.</p>
	<p>Слоўнікавы матар’ял для тэрмінолёгіі ў ліку 2500 слоў сабраў паводле альфабэту, упарадкаваў, ператлумачыў пабеларуску і прынятую тэрмінолёгію зрэдагаваў.</p>
	<p><i>Старшыня Гуманітарнай Сэкцыі Інстытуту Беларускае Культуры <b>Ів. Луцэвіч</b>.</i></p>
	<p>Менск студзень 1923 г.</p>
</div>
##HTMLDescription_END
##ArticleLang: ru/be

абонемент	перадплата
абонент	перадплатчык
абсурд	недарэчнасьць
абсурдный	недарэчны
авансцена	перадсцэна
авантюра	авантура
авантюрист	авантурнік
авантюристический	авантурны
автобиограф	уласнажыцьцяпісец
автобиографический	уласнажыцьцяпісны
автобиография	уласнажыцьцяпіс
автограф	уласнапіс
автор	аўтор
авторизованный	аўторызаваны
авторитет	аўторытэт
автотип	адбітка
адонический стих	адонісавы верш
акростих	акростых
акт (действие)	дзея
актер	актор
актриса	акторка
актуальность	здольнадзейнасьць
актуальный	здольнадзейны
акцент	націск, вымова, акцэнт
акцентировать	акцэнтаваць
акцентуация	акцэнтаваньне
акция	дзеяньне, дзея
александрийский стих	александрыйскі верш
алкеев стих	алькейскі верш
алкмеонический стих	алькмэонічны верш
аллегорический	іншасказальны
аллегория	іншасказ
аллитерация	сугучнасьць
аллюзия	намяненьне
альбом	альбом
альманах	альманах
амфиболический	двузначны
амфиболия	двузначнасьць
амфибрахий	амфібрах
амфибрахический	амфібрахічны
анаграмма	надпіс
анаграф	надпіс
анакреонтические стихи	анакрэонтычныя вершы
анакрустический стих	анакрустычны верш
аналогический	падобны
аналогия	падобнасьць
анапест	анапэст
анапестический	анапэстычны
анастрофа	перастаўка
анафора	паўтарэньне
анахронизм	нясучаснасьць
анекдот	анэкдот
анекдотический	анэкдотны
аноним	бязыменьнік
анонимный	бязыменны
анонс	паведамленьне
антикритика	антыкрытыка
антологическое стихотворение	антолёгічны верш
антология	антолёгія
антракт	перапынак
аплодисменты	воплескі
апокриф	апокрыф
апокрифический	апокрыфічны
аполог	байка
апострофа	зварот
апофеоз	убагаўленьне, апотэоз
аппозиция	дасказ
аргумент	довад
аргументация	давядзеньне
ария	сьпеў
артизм	мастацкасьць, артызм
артист	мастак, артысты
артистический	мастацкі, артыстычны
архаизм	старасьведчына
архаистический	старасьвецкі
ассонанс	сугалосьсе
ассимиляция	упадабленьне
аудитория	слухальня
аутентик	аўтэнтык
аутентический	аўтэнтычны
афареза	скарочаньне, усячэньне
афиша	абвестка
афоризм	выслоўе
балет	балет
баллада	баляда
банальность	будзённасьць
банальный	будзённы
бард	бард
баркарола	баркароля
баснописец	байкапісец
баснословный	баечны
басня	байка
бахий	бахі
беллетрист	бэлетрысты
беллетристика	краснае пісьменства, бэлетрыстыка
беллетристический	бэлетрыстычны
белый стих	белы верш
бессмыслица	недарэчнасьць
библиограф	кнігавед
библиография	кнігапіс
библиотека	кніжня
библиотекарь	кнігар
библия	біблія
биограф	жыцьцяпісец
биографический	жыцьцяпісны
биография	жыцьцяпіс
благозвучие	мілагучнасьць
благозвучный	мілагучны
богатырский эпос	гэроічны эпос
богатырь	волат, асілак
божественность	боскасьць
божественный	боскі
божество	боства
брошюра	сшытак, брошура
буквальный	літаральны
буколика	буколіка
буф-опера	комічная опэра
былина	быліна
быль	быль
быт	быт
бытописатель	бытапісец
бюллетень	паведамленьне
вакхическая стопа	бахічная стопа
варваризм	чужаслоў
вариант	адменьнік
введение	уводзіны
вдохновение	надхненьне
версификатор	вершавальнік
версификация	вершаваньне
версия	чутка, пагалоска
вертеп	батлейка
вертепное действо	батлеечная дзея
вестник	зьвястун
вилланела	вілянэля
витиеватость	віцьеватасьць
витиеватый	віцьеваты
внезапность	раптоўнасьць
водевиль	водэвіль
возвещение	апавяшчэньне
возвышенный	узьнёслы
воззвание	адозва
возобновление	аднаўленьне
волшебник	чараўнік
волшебница	чараўніца
волшебный	чараўнічы
воображение	выабражэньне
вопрос	пытаньне
вопрошание	запытаньне
восклицание	вокліч
воспевание	апяваньне
воспитание	выхаваньне
воспоминание	успамін
восприимчивость	перанятлівасьць
восприятие	пераняцьце
восторг	узьнясеньне, захапленьне
восторженный (лиризм)	узьнёслы
восхищение	захапленьне
впечатление	уражаньне
вступление	уступ
второстепенный	другарадны
вульгаризм	прастаслоўе
вульгарный	прастацкі
выражение	выраз
выразительность	выразнасьць, выразістасьць, выразьлівасьць
выразительный	выразны, выразісты, выразьлівы
газета	часопіс, газэта
галлицизм	галіцызм
гармонизация	суладжаньне
гармонический	суладны
гармоничность	суладнасьць
гармония	суладзьдзе
гасконада	гасконада
гексаметр	шасьцістоп, шасьцімер, гэксамэтр
генеалогия	радавод
гениальность	гэніяльнасьць
гениальный	гэніяльны
гений	гэні
героизм	гэроізм
героиня	гэроіня
герой	гэрой
героический стих	гэроічны верш
героический эпос	гэроічны эпос
гимн	гымн
гипербола	пераўвялічаньне
гиперболический	пераўвялічаны
глава	разьдзел
гликонический стих	гліконічны верш
говор	гаворка, гоман
говор (диалект)	гаворка
гомоним	аднайменьнік
градация	ступеняваньне
грамота (акт)	грамата
грамота, грамотность	пісьменнасьць
грамотный	пісьменны
графоман	графоман
графомания	графоманія
дактилический	дактылічны
дактиль	дактыль
двусмысленность	двузначнасьць
двустишие	двуверш
действие	дзея
действительность	рэчавістасьць
действительный	рэчавісты
действующие лица	асобы дзеі
декадент	дэкадэнт
декадентизм	дэкадэнцтва
декастихон	дзесяціверш
декламатор	дэкляматар
декламация	дэклямацыя
декламировать	дэклямаваць
декорация	дэкорацыя
декорировать	дэкараваць
диалект	гаворка
диалектика	дыялектыка
диалог	размова
диалогический	размоўны
дивертисмент	розназбор
дидактизм	навучальнасьць
дидактическая поэзия	навучальная поэзыя
диколический	дыколічны
диколон	дыколён
дикция	вымаўленьне
дисгармония	разладзьдзе
дискуссия	супрэчка
диспондей	дыспондэй
диспут	дыспут
диссонанс	рознагучнасьць
дифирамб	выхваленьне
дифтонг	двугук
диффамация	абняслава
дневник	дзеньнік
добавление	дадатак
довод	довад
документ	дакумэнт
дополнение	дапаўненьне
достижение	дасяг
дохмий	дохмі
драма	драма
драматизировать	драматызаваць
драматизм	драматызм
драматический	драматычны
драматург	драматысты
драматургия	драматыка
дуализм	двуістотнасьць
дубликат	падвойнік, дубальт
дуэт	двусьпеў
евангелие	эвангэля
евангелический	эвангэлічны
естественность	натуральнасьць
жанр	род
жанровый	радавы
жаргон	жаргон
жесткость	жорсткасьць
жестокость	акрутнасьць
живописец	маляр
живописный	маляўнічы
живопись	малярства
жизненность	жыцьцёвасьць
журнал	часапіс
журналист	часапісец
журналистика	часапісьменства
журнальный	часапісны
заблуждение	абмылка
завещание	адпіс, тэстамант
завязка	завязка
загадка	загадка
загадочность	загадковасьць
загадочный	загадковы
заглавие	загаловак
заглавный	загалоўны
заговор (литер.)	загавор, замова
заговор (юрид.)	змова
заголовок	загаловак
загромождение	заграмаджэньне
заимствование	запазычаньне
заклинание	загаварваньне, заклінаньне
заклятие	закляцьце
заметка	нататка, заметка
замечание	увага, заўважаньне
замысел	задум
занавес	заслона
записки	запіскі
запросы	вымогі
заурядный	звычайны
звено	зьвяно
звукоподражание	гукаперайманьне
зияние	аднагалосьсе
знание	веда
зодчество	будаўніцтва
зодчий	будаўнічы
зрелище	відовішча
зритель	глядзельнік, відоўца
зрительный зал	глядзельня, відоўня
игра (на инструм.)	граньне
игра (артистов, слов)	ігра
идеал	ідэал
идеализировать	ідэалізаваць
идеализм	ідэалізм
идеалист	ідэалісты
идеальность	ідэальнасьць
идеальный	ідэальны
идейность	ідэйнасьць
идейный	ідэйны
идентичность	тоесамасьць
идентичный	той самы
идеолог	ідэолёг
идеология	ідэолёгія
идея	ідэя
идиллический	сяляначны
идиллия	сялянка, ідылія
избыток	надмер
изваяние	вылепак
известие	вестка
известный	вядомы
издание	выданьне
издатель	выдавец
издательство	выдавецтва
изложение	выкладаньне, выклад
изображение	выяўленьне, маляваньне, вобраз
изобразительный	вобразны
изотонический	аднагучны
изречение	выслоўе
изучение	выўчэньне
изысканность	вытворнасьць
изысканный	вытворны
изящество	прыгожасьць
изящный	прыгожы
иллюзия	ілюзія
иллюзорный	ілюзійны
иллюстрация	ілюстрацыя
иллюстрированный	ілюстраваны
иллюстрировать	ілюстраваць
импрессионизм	імпрэсіонізм
импровизатор	імпровізатар
импровизация	імпровізацыя
импровизировать	імпровізаваць
индивидуальность	асабовасьць
индивидуальный	асабовы
инициалы	ініцыялы, пачатнікі
иносказание	іншасказ
иносказательно	іншасказна
иностранный	чужаземны
инспирация	надханьне
инспирированный	надханы
инсценизатор	усцэнізатар
инсценизация	усцэнізаваньне
инсценизирование	усцэнізаваньне
инсценизировать	усцэнізаваць
интеллект	розум
интеллектуальность	разумовасьць
интеллектуальный	разумовы
интервью	размова
интервьюер	размоўца
интервьюировать	распытваць
интерлюдия	паміждзея
интермедия	паміждзея
интернационал	міжнародня
интернационализм	міжнароднасьць
интернациональный	міжнародны
интимность	інтымнасьць
интимный	інтымны
интонация	вымова
интрига	інтрыга
интуитивный	падсьвядомы
интуиция	падсьвядомасьць
информация	асьведамленьне
информирование	асьведамленьне
информировать	асьведамляць
ионический стих	ёнічны верш
иронизирование	вьсьмяханьне
иронизировать	высьмяхацца
иронический	высьмешлівы
ирония	высьмешка
искажение	скажэньне
искание	шуканьне
исключение	вынятак, выключэньне
исключительный	вынятковы, выключны
искусственность	штучнасьць
искусственный	штучны
искусство	штукарства
историк	гісторык
историограф	гісторыяпісец
историография	гісторыяпіс
исторический	гісторычны
история	гісторыя
источник	крыніца
какофония	немілагучнасьць
каламбур	жартаслоўе
каламбурист	жартаслоўца
каламбурный	жартаслоўны
календарный	каляндарны
календарь	каляндар
каллиграф	прыгожапісец
каллиграфия	прыгожапіс
кансиона	кансыёна
кантата	кантата
кантилена	кантылена
канты	канты
канцион	канцыён
канцона	канцона
карикатура	карыкатура
карикатурист	карыкатурысты
карикатурный	карыкатурны
картина	малюнак, вобраз
картинность	маляўнічасьць, вобразнасьць
картинный	маляўнічы, вобразны
каталог	рэчасьпіс
катастрофа (драм.)	разьвязка
класс (сосл.)	кляса, стан
классик	клясык
классицизм	клясыцызм
классический	клясычны
классный	клясавы
классовый	клясавы, станавы
клерикализм	клерыкалізм
клерикальный	клерыкальны
книга	кніга
книжный	кніжны
коллективизм	суспольнасьць
коллективный	суспольны
коллизия	супрэчнасьць
колорит	афарбоўка
комедиант	комэдыянт
комедия	комэдыя
комизм	комізм
комик	комік
комический	комічны
компилировать	падбіраць, компіляваць
компилятивный	зборны, компіляцыйны
компилятор	падборшчык, компілятар
компиляция	збор, зьбіраніна, компіляцыя
комплект	поўналік
комплектование	упоўналічваньне
композитор	композытар
композиция	композыцыя
коммуна	комуна
коммунизм	комунізм
коммунистический	комуністычны
контраст	супраціўнасьць
копирование	копіяваньне, сьпісваньне
копия	копія
корректирование	выпраўляньне, корэктаваньне
корректировать	выпраўляць, корэктаваць
корректор	выпраўшчык, корэктар
корректура	выпраўка, корэкта
корреспондент	дапішчык
корреспонденция (газ.)	допіс
космический	сусьветны
космополит	сусьветнік, космополіт
космополитический	сусьветна-грамадзянскі
крайность	крайнасьць
красная строка	новы радок
красноречивый	красамоўны
красноречие	красамоўства
красота	прыгожасьць, хараство
краткость	кораткасьць
критик	крытык
критика	крытыка
критический	крытычны
кукольная комедия	лялечная комэдыя
кукольный тэатр	лялечны тэатр
кулиса	засьценьне, куліса
кульминационный	найвысшы, кульмінацыйны
культ	культ
культура	культура
культурный	культурны
куплет	прыпеўка
куплетист	прыпявальнік
курс	курс
лаконизм	маласлоўе, ляконізм
лаконический	маласлоўны, ляконічны
лапидарный (стиль)	сьціслы, ляпідарны
ласкательный	ласкальны
латинизм	лацінізм
легенда	легэнда
легендарный	легэндарны
лейтмотив	кіраўнічая думка
лексикографический	словапісны
лексикография	словапіс
лексиколог	словазнаўца
лексикология	словазнаўства
лексикон	слоўнік
лексический	слоўнікавы
лекция	лекцыя
леонический стих	леонічны верш
летописец	летапісец
летописный	летапісны
летопись	летапіс
либретто	зьмесьнік, лібрэта
лингвист	мовазнаўца
лингвистика	мовазнаўства
лингвистический	мовазнаўчы
лира	ліра
лиризм	лірызм
лирик	лірык
лирика	лірыка
лирический	лірычны
лиро-эпический	ліроэпічны
листовка	лістоўка
литера	літара
литерализм	літаралізм
литеральный	літаральны
литератор	літаратар
литература	літаратура
литература белорусская	літаратура беларуская
литература еврейская	літаратура жыдоўская
литература малорусская	літаратура ўкраинская
литература польская	літаратура польская
литература русская	літаратура расейская, маскоўская
литограф	камнедрукар
литографирование	камнедрук
литографированный	камнедрукаваны
литографировать	камнедрукаваць
литографический	камнедрукарскі
литография	камнедрукарня
лицевой (драм.)	асабовы
лицо (дейст.)	асоба
личность	асоба
личный	асабовы, асабісты
лубочный	тандэтны
любитель	аматар
любительский	аматарскі
любовник	палюбоўнік
любовница	палюбоўніца
любовный	палюбоўны
любовь	любасьць
макаронизм	макаронізм
макаронический	макаронічны
манера	манера
маньерист	манерысты
манерный	манерны
манускрипт	рукапіс
марионетка	лялька
марионеточный театр	лялечны тэатр
маска	маска
маскарад	маскарад
маскарадный	маскарадны
маскирование	маскаваньне
материал	матар'ял
мелодекламация	мэлёдэклямацыя
мелодический	мілагучны, мэлёдыйны
мелодия	мэлёдыя
мелодрама	мэлёдрама
мелодраматический	мэлёдраматычны
мелочь	драбніца
меморандум	напамінаньне
мемориал	памятнік
мемория	памятка
мемуары	успаміны
мессианизм	пасланіцтва, мэсыянізм
метабола	перастанова
метастрофа	ухіл
метафора	пераносьня, мэтафора
метафорический	пераносны
метонимический	перайменны
метонимия	перайменьне
метр	мера, стопа, мэтр
метрика (в стихах)	мера, мэтрыка
метрический	мэтрычны
мимика	мігаваньне, міміка
мимический	мігоўны, мімічны
миниатюра	мініятура
минорный (переносн.)	журблівы
мировоззрение	сьветагляд
миросозерцание	сьветапогляд
мистерия	містэрыя
мистик	містык
мистика	містыка
мистификация	ашуканства
мистицизм	містыцызм
мистический	містычны
миф	міт
мифический	мітычны
мифолог	мітолёг
мифологический	мітолёгічны
мифология	мітолёгія
многословие	многаслоўе
многочисленность	многалікасьць
многочисленный	многалікавы, натоўпны
могущественный	магутны
могущество	магутнасьць
модернизм	модэрнізм
модернизованный	модэрнізаваны
модернист	модерністы
монограмма	монограма
монографический	монографічны
монография	монографія
монодрама	монодрама
моноклическое стихотворение	аднамерны верш
монолог	монолёг
монологический	монолёгічны
моносиллабический	аднаскладовы
моностих	аднаверш
монотонность	аднастайнасьць
монотонный	аднастайны
монумент	помнік
монументальный	помнікавы
морализатор	навучальнік, абычайнік
моралист	навучальнік, абычайнік
мораль	навучальнасьць, абычайнасьць
моральный	навучальны, абычайны
морфология	формаслоўе
мотив (литерат.)	аснова, падстава
мотивированный	абаснованы
мотивировать	абасноўваць
мотто	мотто
мудрость	мудрасьць
мудрствование	мудраваньне
муза	муза
музыка	музыка
музыкальность	музыкальнасьць, музычнасьць
музыкальный	музыкальны, музычны
мыслитель	мысьліцель
мыслительница	мысьліцелька
мыслить	мысьліць, думаць
мысль	мысьль, думка
мышление	мысьленьне, думаньне
наблюдатель	назорца, назіральнік
наблюдательность	назорнасьць, назіральнасьць
наблюдать	назіраць, спасьцерагаць
наблюдение	назіраньне, спасьцярога
набросок	накідак
наглядно	відавочна, наглядна
надутость	насуплівасьць
надутый	насуплены
назначение	назначэньне, заданьне
наивность	наіўнасьць, прастадушнасьць
наивный	наіўны, прастадушны
наизусть	напамяць
наклонность	нахіл
накопление	награмаджэньне
намек	намяненьне
напев	напеў
направление	кірунак
например	напрыклад
напыщенность	напышлівасьць
напыщенный	напышлівы
наречие (грам.)	прыслоўе
наречие (диалект.)	гутарка
нарицательный	агульны
народ	народ, люд
народнический	народніцкі, людовы
народничество	народніцтва, людовасьць
народный	народны, людовы
наружность	надворнасьць, павярхоўнасьць
наружный	надворны, павярхоўны
нарушение	нарушэньне
наслаждение	асалода
настроение	настрой
насущность	неабходнасьць
насущный	неабходны
натура	прырода, натура
натурализовать	натуралізаваць
натурализм	натуралізм
натуралист	прыроднік, натуралісты
натуральный	прыродны, натуральны
наука	навука
научение	навучаньне
научный	навуковы
национализм	нацыяналізм
национальность	нацыянальнасьць
национальный	нацыянальны
нация	нацыя
начало	пачатак
начальный	пачатковы
начертание	нарыс
начинание	пачынаньне
начитанность	начытанасьць
начитанный	начытаны
негодование	абурэньне, сердаваньне
недоразумение	непаразуменьне
неестественный	ненатуральны
неизбежность	няўхільнасьць
неизбежный	няўхільны
некролог	пасьмерце
некрологический	пасьмярцёвы
неодушевленный	няжывы
неожиданность	неспадзеўнасьць
неожиданный	неспадзеўны
неологизм	новатвор
неологический	новатворны
неопределенность	неазначанасьць
неопределенный	неазначаны
несовместимость	нясумеснасьць
несовместимый	нясумесны
несогласный	нязгодны
несогласованный	няўзгоднены
несоразмерность	неразьмернасьць
несоразмерный	неразьмерны
новелла	новэля, апавяданьне
новеллист	новэлісты, апавядальнік
номинальный	назоўны
нормальный	нормальны
Nota bene (N.B.)	увага
нравоучение	навучальнасьць
нравоучительный	навучальны, моральны
нравственность	абычайнасьць
нравственный	абычайны
номер	нумар
обдуманность	абдуманасьць
обдуманный	абдуманы
обзор	агляд
областной	краёвы
область	краіна
область знания	галіна веды
обличать	вінаваціць
обличение	вінавачаньне
обличитель	вінавальнік
обличительный	абвіняльны
обновление	абнова
обожествление	абагаўленьне
обозреватель	аглядач, аглядчык
обозрение	агляд
оборот	зварот
обоснование	абаснова, угрунтаваньне
обоснованный	абаснаваны, угрунтаваны
образ	вобраз
образец	узор
образный	вобразны
образование	асьвета, адукацыя, утварэньне
образцовый	узоравы, прыкладны
обращение	зьвяртаньне
обряд	абрад
обрядность	абраднасьць
обрядовый	абрадавы
обстановка (сцены)	абстаноўка
обстановочность	абстаноўчасьць
обстановочный	абстаноўчы
обусловленность	абумоўленасьць
обусловленный	абумоўлены
общеупотребительный	агульнаўжываны, звычайны
обычай	звычай
объявление	абвестка
объяснение	аб'ясьненьне
объяснительный	аб'ясьняльны
оглавление	сьпіс, зьмест
оговор	абмова
оговорка	абмоўка
ограничение	абмежаваньне
ода	ода
одаренность	даравітасьць
одаренный	даравіты
одновременный	адначасны
однозвучность	аднагучнасьць
однозвучный	аднагучны
однообразие	аднастайнасьць
однообразный	аднастайны
односложный	аднаскладовы
односторонний	аднабокі
односторонность	аднабокасьць
одухотворенность	адухаўленьне
одухотворенный	адухоўлены
одушевление	адухаўленьне
одушевленность	адухоўленасьць
одушевленный	адухоўлены
оживление	ажыўленьне
оживленность	ажыўленасьць, жывасьць
оживленный	ажыўлены
оживлять	ажыўляць
окончание	заканчэньне
окончание (гр.)	канчатак
окончательный	канчальны
октава	васьміверш
олицетворение	увасабленьне
олицетворенный	увасоблены
ономатопея	гукаперайманьне
опера	опэра
оперетка	опэрэтка
оперетта	опэрэтка
опереточный	опэрэтны
оперный	опэрны
опечатка	друкарская памылка
описание	апісаньне
описательный	апісальны
описка	апіска
оппонент	процімоўца, супярэчнік
оппонировать	супярэчыць
определение	азначэньне
определенный	пэўны, азначаны
опровергать	абвяргаць
опровержение	абвяржэньне
оптимизм	сьветлагляднасьць, оптымізм
оптимист	сьветлагляднік, оптымісты
оптимистический	сьветлаглядны, оптымістычны
опытность	дасьведчаньне
опытный	дасьведчаны
оратор	прамоўца, красамоўца
оратория	ораторыя, прамова
ораторский	красамоўны
ораторство	красамоўнасьць
орган (инстр.)	арганы
орган (печати)	часопіс
ореол	аўрэоля, злотаблеск
оригинал	першаўзор, уласнопіс, орыгінал
оригинальность	самабытнасьць
оригинальный	уласнапісны, самабытны
ориентация	кірунак
ориентироваться	накіроўвацца, разьбірацца
оркестр	оркестра, капэльля
оркестровка	оркестраваньне
орнамент	орнамэнт, украса
орнаментика	орнамэнтыка, украсаваньне
орфография	правапіс
осмысленность	уразумленасьць, сэнсоўнасьць
осмысленный	сэнсоўны
осмыслить	уразумець, надаць сэнс
осмыслять	асмысьляць
особенность	асаблівасьць
особенный	асаблівы
остроумие	досьціп
остроумный	дасьціпны
отвлеченность	адцягненасьць
отвлеченный	адцягнены
отзвук	водгук
отличие	адзнака
отличительный	адзначны, асаблівы, адметны
отличный	выдатны, розны
отношение	адносіны
отпечаток	адбітак
отражение	адбітак, адбіцьце, адсьвет
отрывок	урывак
отрывочный	урыўковы
отрицание	адмоўе
отрицательный	адмоўны
отчетливость	выразнасьць
отчетливый	выразны
очередной	чарговы
очередь	чарга, чарод
очерк	нарыс
очертание	абрыс
ошибка	абмылка, памылка
официальный	службовы, офіцыяльны
официоз (орг. печати)	урадовая часопісь
памфлет	памфлет
памфлетист	памфлетысты
памфлетный	памфлетны
памятник	помнік
памятный	памятны
память	памяць
панегирик	выхвала
панегирист	выхвальнік
панегирический	выхвальны
панорама	панорама
пантомима	мігадзея
парабола	прыповесьць, прыраўнаньне
параболический	прыповесьцевы, прыраўнальны
параграмма	параграма
параграф	параграф
парадокс	парадокс (процізвычайнае зданьне)
парадоксальный	парадоксальны, процізвычайны
параллелизировать	супастаўляць
параллелизм (лит.)	супастава
параллельный	супастаўны
пародирование	пераніцоўваньне
пародировать	пераніцоўваць
пародист	пераніцавальнік
пародия	пераніцаваньне
пароним	сугучнік
пасквиль	брахняпіс
пасквильный	брахняпісны
пасквилянт	брахняпісец
пастораль	пастырка
пасторальный	пастырскі
патетизм	надпачуцьцёвасьць
патетический	надпачуцьцёвы
патетичность	надпачуцьцёвасьць
пауза	перапынак
пафос	напышлівасьць
певец	пясьняр, сьпявак (хор)
певица	сьпявачка
педагог	настаўнік
педагогика	настаўніцтва
педагогический	настаўнічы
пейзаж	краебраз
пение	пяяньне, сьпяваньне
пентаметр	пэнтамэтр
пентастихион	пяціверш
пеон	пэон
первичный	первястковы
первоначальный	першапачатковы
перевод	пераклад
переводный	перакладны
переводчик	перакладчык
переклад	пераклад
переложение	пераказ
перенесение	перанос
перенос	перанос
переносный	пераносны
пересказ	пераказ
период	кругаход
периодический	кругаходны
перифраз	перамоўе
перефразирование	перамаўленьне
перефразировать	перамаўляць
персонификация	увасабленьне
персонифицировать	увасабляць
песельник	песельнік
песенник (сборн. песен)	сьпеўнік
песенник (автор песен)	песьнятворца
песенный	сьпеўны
песнотворчество	песьнятворчасьць
песня	песьня
пессимизм	смутнагляд
пессимист	смутнаглядца
пессимистический	смутнаглядны
петь	пець, пяяць, сьпяваць
печатание	друкаваньне
печатаный	друкаваны
печатный	друкарскі
печать (знак)	пячаць, пячатка
печать (полигр.)	друк
пиеса, пьеса	дзеятвор, сцэнічны твор
писание (священ.)	пісьмо (сьвятое)
писатель	пісьменьнік
писательница	пісьменьніца
письмена	напісы
письменность	пісьменства
письменный	пісоўны
письмо	ліст
письмо (калигр.)	пісаньне
плавность	плыўнасьць
плавный	плыўны
плагиат	творакрадзтва
плагиатор	творакрадца
плакат	плякат
плакатный	плякатны
план	плян
планомерность	пляновасьць
планомерные	пляновы
пластика	плястыка
пластический	плястычны
пластичность	плястычнасьць, выпукласьць
плеоназм	многаслоўе
плеонастический	многаслоўны
поверье	павер'е
повествование	апавяданьне
повествователь	апавядальнік
повествовательный	апавядальны
повесть	повесьць
повременный	кругачасны
повседневность	абыдзённасьць
повседневный	абыдзённы
повторение	паўтарэньне
поговорка	прыгаворка, прымоўка
погрешность	хіба, агрэх
подзаголовок	падзагаловак
подлинник	аўтэнтык
подлинность	аўтэнтычнасьць
подлинный	аўтэнтычны
подобие	падобнасьць
подражание	перайманьне
подражатель	пераймальнік
подражательность	пераймальнасьць
подражательный	пераймальны
подражать	пераймаць
подстрочный	падрадковы
подходящий	адпаведны, падобны
подчинение	залежнасьць
поза	пастава
позирование	удаваньне
познание	пазнаньне
полемика	спрэчкапіс
полемист	спрэчкапісец
полемический	спрэчкапісны
политик	політык
политика	політыка
политический	політычны
положительность	дадатнасьць, станоўчасьць
положительный	дадатны, станоўчы
полонизм	полёнізм
понимание	разуменьне
понятие	паняцьце, разуменьне
понятный	зразумелы
популяризатор	пашыральнік
популяризация	пашырэньне
популяризировать	пашыраць
популярность	агульнадаступнасьць, усевядомасьць
популярный	агульнадаступны, усевядомы
порицание	ганьбеньне
порицатель	ганьбіцель
порицательный	ганебны
порнограф	страмопісец
порнографический	страмопісны
порнография	страмопіс
посвящение	ахвяраваньне, пасьвячэньне
послание	пасланьне
последователь	пасьледавальнік
последовательность	паступовасьць
последовательный	паступовы
последствие	вынік
послесловие	пасьляслоўе
пословица	прыказка
постановка	пастаноўка
постановочный	пастаноўны
постепенный	ступянёвы
построение	будова
построенный	збудованы
построчный	адрадковы
Postscriptum (P.S.)	прыпіска
поучение	навучаньне
поучительный	навучальны
похождение	прыгода
пошлость	нікчэмнасьць
пошлый	нікчэмны
поэзия	поэзія
поэма	поэма
поэт	поэта
поэтесса	поэтка
поэтика	поэтыка
поэтический	поэтычны
пояснение	паясьненьне
пояснительный	паясьняльны
правдоподобие	праўдападобнасьць
правдоподобный	праўдападобны
правило	правіла
правильность	правіловасьць
правильный	правіловы
правописание	правапіс
празднословие	марнаслоўе
практик	практык
практика	практыка
практический	практычны
предание	паданьне
предисловие	прадмова
предлог (гр.)	прыймя
предложение	выслоўе
предостережение	перасьцярога
предпочтение	перавага
предрассудок	забабоны
предрассудочный	забабонны
представление (театр.)	прыстаўленьне
преемственность	пераймальнасьць
преемственный	пераймальны
преимущество	перавага
премия	нагарода
преобладание	перавага
преобладающий	пераважны
преобразование	ператварэньне
пресса	друк
прибавление	дадатак
прибаутка	прыгаворка
признак	азнака, прымета
прикладной	практычны
приключение	здарэньне, прыгода
применение	прыстасаваньне, дастасаваньне, ужываньне
пример	прыклад
примечание	увага
примитив	пярвестак
примитивность	первястковасьць
примитивный	первястковы
принцип	аснова
принципиальность	асноўнасьць
принципиальный	асноўны
приписка	прыпіска
присказка	прыказка
приставка	прыстаўка
приставочный	прыстаўны
приступ	прыступ
присущий	уласьцівы
притча	прыповесьць
причитание	прычытваньне
пробел	пробель
провинциализм	краінаслоўе
провинциальный	краінны
провинция	краіна
программа	програма
программный	програмны
прогресс	поступ
прогрессивность	паступовасьць
прогрессивный	паступовы
продолжение	працяг
проза	проза
прозаизм	прозаізм
прозаик	прозаік
прозаический	прозаічны
прозопопея	увасабленьне
произведение	твор
произвольный	адвольны
произношение	вымаўляньне, вымова, выгаворка
происхождение	пахаджэньне
происшествие	праява
прокламация	адозва
прокламирование	абвяшчэньне
пролетариат	пролетарыят
пролетарий	пролетары
пролетарский	пролетарскі
пролог	прадслоўе
проповедник	казальнік
проповеднический	казальны
проповедь	казаньне
пропуск	перапуск
прорицание	прараканьне
прорицатель	праракальнік
пророк	прарок
пророческий	прароцкі
пророчество	прароцтва
просветитель	асьвячальнік
просветительный	асьветны
просвещение	асьвета
просвещенный	асьвечаны
просодика	прозодыка
просодический	прозодычны
просодия	прозодыя
просодономазия	многаслоўе
противоположность	процілежнасьць
противоречивый	супярэчны
противоречие	супярэчнасьць
прототип	першаўзор
прототипный	першаўзорны
процесс	развой
псевдоним	займеньне
псевдонимный	займенны
публика	грамадзянства
публикация	апавяшчэньне
публицист	часапісец
публицистика	часапіснасьць
публицистический	часапісны
пунктуация	пунктаваньне
пустословие	пустаслоўе
путаница	блытаніна
путеводитель	праважаты
путешественник	падарожнік, вандроўнік
путешествие	падарожжа, вандраваньне
разбор	разбор
развитие	разьвіцьцё
развязка	разьвязка
разговор	размова, гутарка
разговорный	размоўны
разговорчивый	гутарлівы, гаваркі
раздел	разьдзел
разделение	падзел
различие	рознасьць
размер	разьмер
размерный	разьмерны
размышление	разважаньне, размысьленьне
разновидность	адмена
разновидный	адменны
разнообразие	рознастайнасьць
разнообразный	рознастайны
разностопный	рознастопны
рапсод	рапсод
рапсодический	рапсодыйны
рапсодия	рапсодыя
распространение	распаўсюджаньне
распространенный	распаўсюджаны
рассказ	апавяданьне
рассказчик	апавядальнік
рассудок	розум
рассудочность	разумовасьць
рассудочный	разумовы
рассуждение	разважаньне, развага
реализм	рэалізм
реалист	рэалісты
реальность	рэчавістасьць
реальный	рэчавісты
ребус	рэбус
революционный	рэволюцыйны
революция	рэволюцыя
редактирование	рэдагаваньне
редактировать	рэдагаваць
редактор	рэдактар
редакторство	рэдактарства
редакционный	рэдакцыйны
редакция	рэдакцыя
резонер	разумавальнік
резонерство	разумаваньне
резонировать	разумаваць
результат	вынік
резюме	абагульненьне
резюмирование	абагульненьне
резюмировать	абагульняць
реклама	рэкляма
рекламирование	рэклямаваньне
рекламировать	рэклямаваць
рекламный	рэклямны
ремарка	адметка
репертуар	рэпэртуар
репетиция	проба, паўтарэньне
реплика	пададказ
репортер	вястун
реторика, риторика	красамоўства
реторический, риторический	красамоўны
реферат	даклад
рефрен	прыпеўка
рецензент	ацэньнік
рецензировать	ацэньваць
рецензия	ацэнка
речь (орат.)	прамова
речь	мова
ритм	рытм
ритмика	рытміка
ритмический	рытмічны
рифма	рыфма
рифма глагольная	рыфма дзеяслоўная
рифма дактилическая	рыфма дактылічная
рифма женская	рыфма жаночая
рифма мужская	рыфма мужчынская
рифма составная	рыфма мяшаная
рифмика	рыфміка
рифмический	рыфмічны
роль	роля
роман	повесьць
романист	повесьцяпісец
романический	любоўны
романс	романс
романтизм	романтызм
романтик	романтык
романтический	романтычны
рондо	рондо
ропалический стих	ропалічны верш
рубрика	рубрыка
руководство (действ.)	кіраваньне
руководство (литерат.)	падручнік, правадніцтва
рукопись	рукапіс
руссицизм (русизм)	маскалізм
рыцарь	рыцар
рыцарский	рыцарскі
рыцарство	рыцарства
сага	сага
сентиментализм	чульлівасьць
сентименталист	чульлівец
сентиментальность	чульлівасьць
сентиментальный	чульлівы
сарказм	злосьмех
саркастический	зласьмешлівы
сатира	сатыра
сатирик	сатырык
сатирический	сатырычны
сафический стих	сафічны верш
сборник	зборнік
сверхъестественность	надпрыроднасьць, надзвычайнасьць
сверхъестественный	надпрыродны, надзвычайны
свойство	уласьцівасьць
связь	сувязь, зьвязак, лучнасьць
священный	сьвяты
секстина	сэкстына
сенсационный	дзівосны
сенсация	дзівота
сентенция	навучка
серенада	сэрэнада
сжатость	сьцісласьць
сжатый	сьціслы
силлаба	склад
силлабический	складовы
силуэт	ценярыс
символ	сымболь
символизирование	сымболізаваньне
символизировать	сымболізаваць
символика	сымболіка
символист	сымболісты
символический	сымболічны
симфония	сымфонія
синекдоха	сынэкдоха
синоним	блізказначнік
синонимика	навука аб блізказначніках
синонимический	блізказначны
система	уклад, парадак, лад
систематизация	упарадкаваньне
систематизатор	укладальнік
систематизировать	укладаць, упарадкоўваць
систематика	упарадкаваньне, сыстэматыка
систематический	сыстэматычны
сказание	апавяданьне
сказатель	казальнік
сказка	казка
сказочность	казачнасьць, баечнасьць
сказочный	казачны, баечны
скандирование	скандаваньне
скандировать	скандаваць
скептик	сумнявальнік
скептицизм	сумнявальнасьць
скептический	сумнявальны
склад (речи)	склад
скороговорка	быстрамоўка
скульптор	разьбяр
скульптура	разьба, разьбярства
следствие (лог.)	скутак
словарный	слоўнікавы
словарь	слоўнік
словесность	пісьменства, літаратура
словесный	слоўны
слово	слова
словотолкование	тлумачэньне
словотолкователь	тлумач
слог	склад
сложный (запутанный)	завілы
сложный (состоящ. из слогов)	складовы
случай	выпадак, здарэньне
смысл	змысл, сэнс
собеседование	гутарка
собирание	зьбіраньне
собиратель	зьбіральнік
соблюдение	захаваньне
собрание (обществ.)	сход
собрание (соч.)	збор
совершенный	дасканалы
совершенство	дасканаласьць
совет	рада
советский	радавы
совещание	нарада
совещательный	дарадчы
совпадение	зьбежнасьць
современник	сучасьнік
современный	сучасны
согласный (псих.)	згодны
согласование	узгадненьне
содержание (лит.)	зьмест
содержание (эконом.)	утрыманьне
содержательность	зьмеснасьць
содержательный	зьмесны
созвучие	сугучнасьць
созвучный	сугучны
создание	утварэньне, стварэньне
сознание	сьвядомасьць, прытомнасьць, прызнаньне
сознательный	сьвядомы
солецизм	солецызм
сомнение	сум, сумненьне
сомнительный	сумненны, сумны
соната	соната
сонет	сонэт
соответственный	адпаведны
соответствие	адпаведнасьць
соотношение	суадносіны
соперник	перамагальнік
соперничество	перамаганьне
сопоставление	параўнаньне
соревнование	выпярэдніцтва
соревнователь	выпярэднік
сословие	стан
сословный	станавы
составитель	укладальнік
составление	укладаньне
составной	складальны
состояние (душ.)	стан
состояние (матер.)	маемасьць
сотрудник	супрацоўнік
сотрудничество	супрацоўніцтва
социализм	соцыялізм
социальный	соцыяльны
сочетание	злучэньне
сочинение	твор
сочинитель	аўтар
сочинять	укладаць
спондеический	спондэічны
спондей	спондэй
способность	здольнасьць, здатнасьць
справка	даведка
справочник	даведнік
справочный	даведачны
сравнение	параўнаньне
сравнительный	параўнальны
ссылка	адноска
стансы	стансы
старина	старына
статут	статут
стенограф	скорапісец
стенографический	скорапісны
стенография	скорапісь
степень	ступень
стереотип	адлівак
стереотипный	адліўны (пераносн.: зьбіты)
стечение	зьбег
стилизация	стылізацыя
стилист	стылісты
стилистика	стылістыка
стилистический	стылістычны
стиль	стыль, склад, лад
стильный	стылёвы
стих	верш
стихийность	навальнасьць
стихийный	навальны
стихия	навала
стихосложение	вершаваньне
стихотворец	вершатворца
стихотворный	вершаваны
стихотворство	вершаваньне
стопа (бумага)	рэза
стопа (стихотв.)	мера, стопа
страница	бок, старонка
странность	дзіўнасьць
странный	дзіўны
странствование	вандроўка
странствователь	вандроўца
странствующий	вандроўны
страстность	палкасьць
страстный	палкі
страсть	пал
стремительность	імпэт
стремительный	імпэтны
стремление	імкненьне
строй	лад, будова
стройность	складнасьць, стройнасьць
стройный	складны, стройны
строка	радок
строфа	зваротка
строчный	радковы
структура	будова
студирование	выўчэньне, студыяваньне
студия	студыя
субъективность	асабовасьць, асабістасьць
субъективный	асабовы, асабісты
сумбур	недарэчнасьць
сумбурный	недарэчны
суфлер	падказьнік
существенность	істотнасьць
существенный	істотны
схема	нарыс
схематический	нарысны
сходственный	падобны
сходство	падобнасьць, падабенства
схоластик	схолястык
схоластика	схолястыка
схоластический	схолястычны
сцена (место)	сцэна
сцена (явление)	зьява
сценический	сцэнічны
сценичность	сцэнічнасьць
сюжет	аснова, прадмет
тавтограмма	адналітарнік, таўтограма
тавтологический	тоеслоўны, таўтолёгічны
тавтология	тоеслоўе, таўтолёгія
талант	талент
талантливость	талентнасьць
талантный	талентны
творение	твор
творец	творца
творческий	творчы
творчество	творчасьць
театр	тэатр
театральный	тэатральны
текст	тэкст
текстуальный	літаральны
тема	заданьне
темник	заданьнік
темп	тэмп
тенденциозность	прадузятасьць
тенденциозный	прадузяты
тенденция	імкненьне, прадузятасьць
теоретик	тэорэтык
теория	тэорыя
термин (назв. предм.)	тэрмін, назва
термин (срок)	тэрмін
терминологический	тэрмінолёгічны, назваслоўны
терминология	тэрмінолёгія, назваслоўе
терцет	тэрцэт
терцины	тэрцыны
техника	тэхніка
технический	тэхнічны
тип	тып
типический	тыповы
типичность	тыповасьць
типограф	друкар
типографический	друкарскі, друкарны
типография	друкарня
тирада (лит.)	доўгаслоўе
титло	надпісак
титул (книги)	загаловак
тождественность	тоесамасьць
тождественный	тоесамы
тождество	тоесамасьць
том	том
томность	млявасьць
томный (от томность)	млявы
томный (от том, напр.: трехтомный)	томавы (напр.: трохтомавы)
тон	тон
тональность	тональнасьць
тонация	тонацыя
тонический	тонічны
торжественность	урачыстасьць
торжественный	урачысты
торжество	урачыстасьць
точность	дакладнасьць
точный	дакладны
трагедия	трагэдыя
трагизм	трагізм
трагик	трагік
трагикомедия	трагікамэдыя
трагикомический	трагікомічны
трагический	трагічны
трагичность	трагічнасьць
традиционный	паданевы
традиция	паданьне
трактат (философ.)	разважаньне
трактат (юрид.)	умова
транскрипция	пісьмо
трафарет (перенос.)	зьбіцьце
трафарет (худ.)	узор
трафаретный (переносн.)	зьбіты
трафаретный (худ.)	адузорны
тривиальность	брыдота
тривиальный	брыдотны
трилогия	троечасьце
триолет	трыолет
триумф	трыумф
триумфальный	трыумфальны
трогательность	жаласьлівасьць
трогательный	жаласьлівы
троп	троп
трохей	трохэй
труппа	таварыства драматычнае
ударение	націск
ударяемый	націскны
указание	паказаньне
указатель	паказальнік
указательный	паказальны
украинизм	украінізм
ум	розум
умничанье	мудраваньне
умолчание	недасказ
умствование	мудраваньне
универсал	усеагульнік
универсальность	усеагульнасьць
универсальный	усеагульны
уподобление	упадабленьне
уподобленный	упадоблены
ускорение	прысьпяшэньне
ускоренный	прысьпешаны
условие	умова
условность	умоўнасьць
условный	умоўны
уста	вусны
устный	вусны
утопист	утопісты
утопический	утопічны
утопия	утопія
утрированный	увыдатнены
утрировать	увыдатняць
утрировка	увыдатненьне
участвовать	прымаць удзел
участие	удзел, учасьце
участник	удзельнік, учасьнік
учебник	падручнік
учебный	навучальны
учение	вучэньне
ученик	вучань
ученический	вучнёўскі
ученость	вучонасьць
ученый	вучоны
учитывание	меркаваньне
учитывать	меркаваць
фабула	аснова
факт	факт
фактический	фактычны
фантазер	фантасты
фантазирование	фантазьяваньне
фантазировать	фантазьяваць
фантазия	фантазія
фантастический	фантастычны
фарс	фарса
фатализм	фаталізм
фаталист	фаталісты
фаталистический	фаталістычны
фатальность	фатальнасьць
фатальный	фатальны
фатум	фатум, лёс
феерический	фэерычны
феерия	фэерыя
фельетон	фэльетон
фельетонист	фэльетоністы
фельетонный	фэльетонны
фигура	фігура
фигуральный	вобразны
филолог	філёлёг
филологический	філёлёгічны
филология	філёлёгія
финал	заканчэньне, разьвязка
фольклор	фольклёр
фольклорист	фольклёрысты
фон	грунт
форма	форма
формализм	формалізм
формалист	формалісты
формальный	формальны
формулировать	акрэсьліваць
формулировка	акрасьленьне
фрагмент	адрывак
фраза	выслоўе
фразеология	словасклад
фразер	краснабай
футуризм	футурызм
футурист	футурысты
футуристический	футурыстычны
хаос	бязладзьдзе
хаотический	бязладны
хаотичность	бязладнасьць
характер	характар
характеризовать	характарызаваць
характеристика	характарыстыка
характерный	характэрны
хартия	грамата, скрутак
хор	хор
хорей	хорэй
хорист	хорысты
хоровод	карагод
хороводный	карагодны
хрестоматия	чытанка, выпісы
хрия	выпрацаваньне
хроника	хроніка
хроникер	дзяньнікар
хроникерский	дзяньнікарскі
хронограмма	хронограма
хронография	хронографія
хронолог	хронолёг
хронологический	хронолёгічны
хронология	хронолёгія
художественность	мастацкасьць
художественный	мастацкі
художество	мастацтва
художник	мастак
цезура	супынка, цэзура
целесообразность	мэтазгоднасьць
целесообразный	мэтазгодны
цензура	цэнзура
цикл	круг
циклики	цыклікі
циклический	кругавы
цинизм	цынізм
циник	цынік
цинический	цынічны
циркуляр	наўкольнік
частица	часьцінка
частность	паасобнасьць
частный	паасобны
частушка	дрындушка
часть	часьць, часьціна, частка
чередование	чаргаваньне
четкий	чытальны
читатель	чытач
чтение	чытаньне
чтец	чытальнік
чудесный	цудоўны
чудный	дзіўны, дзівачны
чудо	цуд
шаблон	прымернік
шаблон (переносн.)	зьбіцьце
шаблонный	прымернікавы
шаблонный (переносн.)	зьбіты
шарада	шарада
школа	школа
школьник	школьнік
школьный	школьны
шутка	жарт
шутливый	жартаўлівы
шутник	жартаўнік
шутовство	жарты
эвфонический	мілагучны
эвфония	мілагучнасьць
эзоп	эзоп
эзоповский язык	эзопава мова
экземпляр	паасобнік, прымернік
эклога	эклёга
экспозиция	выклад
экспрессионизм	экспрэсыянізм
экспрессия	выразістасьць
экспромт	экспромпт
экспромтный	экспромтавы
экстаз	захапленьне
элегический	элегійны, жаласьлівы
элегия	элегія
элемент	пярвестак, элемэнт
элементарный	первястковы, пачатковы
эмблема	эмблема
эмоциональность	пачуцьцёвасьць
эмоциональный	пачуцьцёвы
эмоция	пачуцьцё
энтузиазм	запал, энтузыязм
энтузиаст	запаленец, энтузыясты
энциклопедизм	энцыклёпэдызм
энциклопедист	энцыклёпэдысты
энциклопедический	энцыклёпэдычны
энциклопедия	энцыклёпэдыя
эпиграмма	эпіграма
эпиграф	надпіс, эпіграф
эпизод	выпадак, эпізод
эпизодический	выпадковы, эпізодычны
эпик	эпік
эпилог	дасказаньне
эпистола	ліст
эпистолия	ліст
эпистолярный	лістоўны
эпитафия	надмагільны надпіс
эпитет	прысловак
эпический	эпічны
эпопея	эпопея
эпос	эпос
эротик	эротык
эротика	эротыка
эротический	эротычны
эскиз	нарыс
эскизный	нарысавы
эстет	эстэт
эстетика	эстэтыка
эстетический	эстэтычны
этика	этыка
этический	этычны
этнограф	людазнаўца
этнографический	людазнаўчы
этнография	людазнаўства
этюд	нарыс
эффект	уражаньне
явление (драм.)	зьява
ямб	ямб
ямбический	ямбічны
юмор	гумар
юморист	гумарысты
юмористика	гумарыстыка
юмористический	гумарыстычны
