##Title: Элемэнтарная матэматыка (БНТ)
##HTMLDescription_BEGIN
<div>
	<p class="dictdesc-st">Створана на падставе:</p>
	<p><b>Элемэнтарная матэматыка</b> (Арытмэтыка, Альгэбра, Геомэтрыя, Трыгономэтрыя, Асновы Аналітычнай Геомэтрыі і Вышэйшага Аналізу). Менск: Інбелкульт, 1922.</p>
</div>
<div>
	<p class="spoiler">Прадмова</p>
	<p>Выходзячая ў сьвет <i>«Беларуская тэрмінолёгія элемэнтарнай матэматыкі»</i> зьяўляецца вынікам працы <i>Матэматычнай Сэкцыі Беларускай Навукова-Тэрмінолёгічнай Камісіі</i>, утворанай у лютым 1921 году, і <i>Прыродазнаўчага Аддзелу Інстытуту Беларускае Культуры</i> (з пачатку 1922 году).</p>
	<p>Праца гэтая вялася ў наступным парадку: кожны з членаў Матэм. Сэкцыі браў на сябе апрацаваньне ў чатырох мовах (расейскай, польскай, украінскай і беларускай) тэрмінолёгіі пэўнай галіны матэматыкі і свой проект падаваў на разгляд Матэм. Сэкцыі. Прынятая Сэкцыяй тэрмінолёгія канчаткова зацьверджвалася агульным сходам Нав.-Тэрм. Камісіі, а ў Інстытуце Беларускай Культуры - агульным сходам Прыродазнаўчага Аддзелу.</p>
	<p>У аснову матэматычнай тэрмінолёгіі паложаны словы, істнуючыя ў жывой народнай мове, як <i>астача, бок, велічыня, вышыня, вылічыць, даўжыня, дуга, кірунак, лік</i> і г.д. Але, дзякуючы абстрактнасьці матэматычных разуменьняў, такіх чыстых тэрмінаў народная мова мае надта мала. Дзеля гэтага прыходзілася або ўтвараць нэолёгізмы, або браць чужаземныя тэрміны. Нэолёгізмы ўтвараліся выключна на аснове істнуючых у жывой мове слоў, згодна з унутраным сэнсам данага тэрміну і з законамі беларускае мовы. Такім чынам, зьявіліся тэрміны: <i>прастора, ступень, уяўны, дасьледаваньне, адмоўны, простакутнік</i> і г.д.</p>
	<p>У тых выпадках, калі ў народнай мове ня было адпаведных слоў, або калі ўтвораныя нэолёгізмы былі вельмі штучныя, або, урэшце, калі даныя тэрміны прынялі ўжо інтэрнацыянальную ахварбоўку, - прыймаліся чужаземныя тэрміны, як, напрыклад: <i>гомотэтыя, інтэрполяцыя, дыфэрэнцыял, інтэграл, факторыял, модуль</i> і г.д.</p>
	<p>У некаторых выпадках (як компроміс пры асабліва спрэчных тэрмінах) прыймаліся па два тэрміны: чужаземны і беларускі (нэолёгізм). Такім чынам зьявіліся: <i>аксіома і пэўнік, дырэктрысы і кіраўніцы, дыскрымінант і адрозьнік, сымэтрыя і суразьмернасьць</i> і г.д.</p>
	<p>Часам у слоўніку сустрачаюцца па два беларускія тэрміны на адзін расейскі. Гэта бывае тады, калі расейскі тэрмін можа ўжывацца ў двох розных сэнсах (напрыклад, расейскае «заключение» можна разумець у сэнсе «заключэньня», як трэцяй часткі ўсяго разважаньня, і ў сэнсе «вываду», як выніку з разважаньня).</p>
	<p>Па ўсіх галінах матэматыкі (арытмэтыка, альгэбра, геомэтрыя, трыгономэтрыя, аналітычная геомэтрыя і вышэйшы аналіз) аўтарамі было запрапанована больш за 2 тысячы тэрмінаў; посьле падвойнага фільтру (сэкцыі і агульнага сходу) было прынята да 1200 тэрмінаў.</p>
	<p>Пры тэхнічнай апрацоўцы данага слоўніка гэты лік быў скарочаны да 900.</p>
	<p>Апрацаваньне тэрмінолёгіі паасобных галін матэматыкі належыць:</p>
	<ul>
	<li>па арытмэтыцы - <b>Л.Більдзюкевічу</b> і <b>Ф.Бураку</b>,
	<li>па геомэтрыі і трыгономэтрыі - <b>Ф.Бураку</b>,
	<li>па альгэбры, аналітычнай геомэтрыі і вышэйшаму аналізу - <b>А.Круталевічу</b>.
	</ul>
	<p><i>Сэкрэтар Прыродазнаўчага Аддзелу Інстытуту Беларускай Культуры</i> <b>А.Круталевіч</b>.</p>
	<p>Менск, сьнежань, 1922.</p>
</div>
##HTMLDescription_END
##ArticleLang: ru/be

абсолютный	абсолютны
абсурд	недарэчнасьць
абсцисса	абсцыса
азимут	азімут
аксиома	аксіома, пэўнік
аксиома пространства	аксіома, пэўнік прасторы
акция	акцыя
алгебра	альгэбра
алгебраически	альгэбрычна
алгебраический	альгэбрычны
алгоритм	альгорытм
амплитуда	амплітуда
анализ	аналіз, разбор
анализ бесконечно-малых	аналіз бязьмежна-малых
апофема	апотэма
аргумент	аргумэнт
арифметика	арытмэтыка
арифметический	арытмэтычны
арксинус	арксінус
арккосинус	арккосінус
арктангенс	арктангенс
арккотангенс	арккотангенс
ассимптоты гиперболы	асымптоты, амальнедатычныя гіпэрболі
астролябия	астролябія
базис	падстава
безграничный	бязьмежны, безгранічны
безошибочно	бясхібна, правільна
бесконечно-большой	бязьмежна-вялікі
бесконечно-малый	бязьмежна-малы
бесконечность	бязьмежнасьць
бесконечный	бязьмежны, бесканцовы (дроб!)
беспредельно	безгранічна
бесчисленное множество	безьліч
биквадратное уравнение	двохквадратовае раўнаньне
биллион	біліён
бином	біном, двохчлен
биссектриса	роўнасечная, бісэктрыса
бок трапеции	бок трапэзу
боковая грань	бочная сьцяна
боковые ребра	бочныя канты
буквенное обозначение	літарнае абазначэньне
буквенное уравнение	літарнае раўнаньне
валюта векселя	валюта вэксаля
вексель	вэксаль
величина	велічыня
величина постоянная	велічыня сталая
величина переменная	велічыня зьменная
величина зависимая	[велічыня залежная
величина независимая	велічыня незалежная
величина действительная	велічыня сапраўдная
величина мнимая	велічыня уяўная
величина комплексная	велічыня комплексная
величина конечная	велічыня скончаная
величина бесконечно-большая	велічыня бязьмежна-вялікая
величина бесконечно-малая	велічыня бязьмежна-малая
величина эквивалентная	велічыня роўнаважная
величина произвольно-малая	велічыня адвольна-малая
величина приближенная	велічыня прыбліжаная
величина стремящаяся к нулю	велічыня, якая імкнецца да нуля
величина увеличивающаяся беспредельно	велічыня, якая павялічваецца безгранічна
величина стремящаяся к пределу	велічыня, якая імкнецца да граніцы
величина тригонометрическая	велічыня трыгономэтрычная
вершина угла	вяршыня кута
взаимно-обратный	узаемна-адваротны
взаимно-простые числа	узаемна-простыя лікі
взаимно-первые числа	узаемна-першыя лікі
взносы	уклады, узносы
взять слагаемым	узяць складнікам
виды неопределенности	віды неазначанасьці
вложение	улажэньне
вместимость	ёмасьць
вместительность	ёмістасьць
вне (фигуры)	па-за (фігурай)
внешний	знадворны
внутренний	унутраны
вогнутый	угнуты
возвратное уравнение	зваротнае раўнаньне
возвысить в степень	праступеняваць, падняць у ступень
возвышение в степень	ступеняваньне, падняцьце ў ступень
возрастание	узрастаньне
возрастающий	узрастаючы
восьмигранник правильный, октаэдр	васьмісьценьнік правільны, октаэдр
вписанный	упісаны
вращение	вярчэньне
вспомогательное неизвестное	дапаможны нявядомы (лік)
выпрямление	выпростваньне
выпуклый	выгнуты
выражение	выраз
высота	вышыня
высший анализ	вышэйшы аналіз
высший член многочлена	вышэйшы член многачлену
вычисление	вылічэньне
вычислить	вылічыць
вычитаемое	аднімнік
вычитание	адніманьне, адыманьне
геометрия	геомэтрыя
геометрия аналитическая	геомэтрыя аналітычная
геометрия на плоскости	геомэтрыя на роўніцы
геометрия аналитическая в пространстве	геомэтрыя аналітычная ў прасторы
геометрическая фигура	геомэтрычная фігура
геометрическое место точек	геомэтрычнае месца пунктаў
геометрическое тело	геомэтрычнае цела
гипербола	гіпэрболя
гипербола равносторонняя	гіпэрболя роўнабочная
гипотенуза	проціпростакутная, гіпотэнуза
гиппократовы луночки	гіпократавы сярпочкі
гомографическое уравнение	гомографічнае раўнаньне
гомотетия	гомотэтыя
гониометрия	гоніомэтрыя
горизонтальный	паземны
градус	градус
градус дуговой	градус дугавы
градус угловой	градус кутавы
грань	сьценка
график	вобраз графічны, графік
графический	графічны
группа чисел	група лікаў
группирование	групаваньне
двадцатигранник правильный, икосаэдр	дваццацісьценьнік правільны, ікосаэдр
двенадцатигранник правильный, додекаэдр	дванаццацісьценьнік правільны, додэкаэдр
двойной	падвойны
двоякий	дваякі
двояко	дваяка
двузначное число	двохзнакавы лік (напр.: «24»)
двузначный	двохзначны (маючы два значэньні)
двукратно	двакраць
двучлен	двохчлен
действие	дзеяньне
действительный, вещественный	сапраўдны
деление	(как действие) дзяленьне; (разделение) падзел
делимое	дзеліва
делимость чисел	падзельнасьць лікаў
делитель	дзельнік
десятичные единицы	дзесятковыя адзінкі
десятичный состав чисел	дзесятковы склад лікаў
детерминант	дэтэрмінант, вызначнік
диагональ	ускосіна, дыягональ
диаметр	прамер, дыямэтр
дивиденд	дывідэнд
директрисы	дырэктрысы, кіраўніцы
дисконт векселя	дысконт вэксаля
дискриминант	дыскрымінант, адрозьнік
дифференциал	дыфэрэнцыял
дифференциальное исчисление	дыфэрэнцыяльнае лічэньне
дифференциальное уравнение	дыфэрэнцыяльнае раўнаньне
дифференцирование	дыфэрэнцыяваньне
дифференцировать	дыфэрэнцыяваць
длина	даўжыня
доказательство	довад
доказательство через наложение	довад за дапамогаю накладаньня
доказательство от противного или приведение к нелепости	довад ад супраціўнага або зьвядзеньне да недарэчнасьці
доказательство прямое	довад просты
доказательство через совместимость	довад за дапамогаю сумяшчальнасьці
должник	даўжнік, вінавайца
доли единицы	часткі адзінкі
дописывание	дапісваньне
дополнительный	дадатковы, дапаўняючы
достаточная точность	выстарчаючая дакладнасьць
дробность	дробавасьць
дробный	дробавы
дробь	дроб
дробь десятичная бесконечная	дроб дзесятковы бесканцовы
дробь десятичная конечная	дроб дзесятковы скончаны
дробь неправильная	дроб неўласьцівы; роўны адзінцы, большы за адзінку
дробь периодичная простая	дроб чысты пэрыодычны (або паўторны)
дробь периодичная смешанная	дроб мяшаны пэрыодычны (або паўторны)
дробь правильная	дроб уласьцівы, меншы за адзінку
дробь простая	дроб звычайны
дуга	дуга
дуга дополнительная	дуга дапаўняючая
единица	адзінка
единица измерения	адзінка (памеру); мерка
единичное отношение	адзінкавы стасунак
зависимая величина	залежная велічыня
зависимость	залежнасьць
задание	заданьне
задача числовая	задача на лікі
задачи на вычисление	задачы на вылічэньне
задачи на вычисление времени	задачы на вылічэнне часу
задачи на построение	задачы на збудаваньне
задачи на проценты	задачы на адсоткі, процанты
задачи неопределенные	задачы неазначаныя
заключение (теоремы)	заключэньне, вывад (тэорэмы)
заключение в скобки	зачыненьне ў дужкі
заключить в скобки	зачыніць у дужкі
закрытие скобок	зачыненьне дужак
закрыть скобки	зачыніць дужкі
замена переменных	замена зьменных
звено дроби	сустаў дробу
знак	знак
знаменатель дроби	назоўнік дробу
знаменатель отношения	зьмест стасунку
знаменатель прогрессии	множнік прогрэсіі
значащие цифры	значачыя цыфры (лічбіны)
избыток	перавышка
известная величина	вядомая велічыня
извлекать корень	дабываць корань
извлечение корня	караняваньне, дабываньне кораня
изменение	зьмена
измерение величины	мераньне, памер велічыні
измерение пространства	памер прасторы
измерения	вымеры
изображение	(действие) рысаваньне; (результат) нарыс, вобраз
изображение чисел с помощью отрезков	азначэньне лікаў за дапамогаю адцінкаў
именованное число дробное	дробавы найменны лік
именованное число простое	просты найменны лік
именованное число составное	складаны найменны лік
интеграл	інтэграл
интеграл общий	інтэграл агульны
интеграл определенный	інтэграл азначаны
интеграл неопределенный	інтэграл неазначаны
интеграл простой	інтэграл звычайны
интеграл двойной	інтэграл падвойны
интеграл тройной	інтэграл патройны
интеграл многократный	інтэграл многаразавы
интегральное исчисление	інтэгральнае лічэньне
интегрирование	інтэграваньне
интегрирование непосредственное	інтэграваньне бэспасрэднае
интегрирование через разложение	інтэграваньне праз раскладаньне
интегрирование через подстановку	інтэграваньне праз падстаноўку
интегрирование по частям	інтэграваньне часткамі
интегрирование с помощью рядов	інтэграваньне за дапамогаю радоў
интегрировать	інтэграваць
интегрированный множитель	множнік інтэграваны
интервал	інтэрвал
интерполировать	інтэрполяваць
интерполяция	інтэрполяцыя
интерпретация	інтэрпрэтацыя
иррациональный	ірацыональны, нявымерны
исключение неизвестного	выключэньне невядомага
исключить	выключыць
искомая величина	шуканая велічыня
исследование	дасьледаваньне
истинное значение	сапраўднае значэньне
исчисление	вылічэньне
касание	дотык
катет	прыпростакутная, катэт
квадрант (четверть)	чвэртка, квадрант
квадрат	квадрат
квадратный	квадратовы
квадратура	квадратура
класс	кляса
классификация	клясыфікацыя
количество	колькасьць
коммерческий учет векселя	гандлёвае адлічэньне з вэксаля, дысконт
компланация	комплянацыя
комплексный	комплексны
конгруентность	сумяшчальнасьць, конгруэнтнасьць
конгруентность фигуры	сумяшчальныя, конгруэнтныя фігуры
конгруенция	сумяшчэньне, конгруэнцыя
конгруенция прямая	сумяшчэнне простае, конгруэнцыя простая
конгруенция непрямая	сумяшчэнне абернутае, конгруэнцыя абернутая
конечная дробь	скончаны дроб
контур	абрыс, контур
конус	стажок, конус
конус прямой круговой	стажок, конус кругавы просты
конус усеченный	стажок, конус сьцяты
конхоида	конхоіда
концентрический	супольнаасяродкавы
координаты	коордынаты
корень (1-ой степени)	корань (1-ае ступені)
корень уравнения	разьвязак раўнаньня
косеканс	косэканс
косинус	косінус
косинусоида	косінусоіда
котангенс	котангенс
котангенсоида	котангенсоіда
коэффициент	коэфіцыэнт
коэффициент угловой	кутавы коэфіцыэнт
крайние члены пропорции	канцавыя члены пропорцыі
крестик косой	крыжык касы (укосны)
кривые I порядка	крывыя I парадку
кривые ІІ порядка	крывыя ІІ парадку
критическое значение переменной	крытычнае значэньне зьменнай
круг	круг
круг большой	круг вялікі
круг малый	круг малы
круглые тела	круглыя целы
куб	куб
кубатура	кубатура
кубический	кубічны
лемма	лема
лента землемерная	істужка каморніцкая
линейка	лінейка
линейный	лінейны
линия	лінія
линия бесконечная	лінія бесканцовая
линия вогнутая	лінія ўгнутая
линия вспомогательная	лінія дапаможная
линия выпуклая	лінія выгнутая
линия замкнутая	лінія замкнутая
линия касательная	лінія датычная
линия конечная	лінія канцовая
линия кривая	лінія крывая
линия ломанная	лінія ламаная
линия наклонная	лінія нахіленая
линия направляющая	лінія кіруючая
линия непрерывная	лінія неперарыўная
линия объемлемая	лінія абыманая
линия объемлющая	лінія абымаючая
линия образующая	лінія фармуючая
линия пересечения	лінія перасеку
линия перпендикулярная	лінія простастаўная
линия полупрямая	лінія аднаканцовая
линия прямая	лінія простая
линия равноделящая	лінія роўнасечная
линия секущая	лінія сякучая
линия средняя (трапеции)	лінія сярэдняя (трапэзу)
линии взаимно-перпендикулярные	лініі ўзаемна-простастаўныя
линии параллельные	лініі роўналежныя
линии пересекающиеся	лініі перасякальныя
линии прилежащие	лініі прылеглыя
линии прямые скрещивающиеся	лініі простыя мімабежныя
линии рассекаются	лініі расьсякаюцца
логарифм	лёгарытм
логарифмирование	лёгарытмаваньне
логарифмический	лёгарытмічны
луч	прамень
мантисса	мантыса
математика	матэматыка
математические предложения	матэматычныя цьвярджэньні
медиана	сярэдніца, мэдыяна
метрическая система мер	мэтрычны ўклад мерак
минус	мінус, менш
минута	мінута
минута дуговая	мінута дугавая
минута угловая	мінута кутавая
мнимый	уяўны
многогранник	многасьценьнік
многозначное (число)	многазнакавы (лік)
многоугольник	многакутнік
многоугольник вогнутый	многакутнік угнуты
многоугольник вписанный	многакутнік упісаны
многоугольник выпуклый	многакутнік выгнуты
многоугольник звездчатый	многакутнік зорчаты
многоугольник одноименный	многакутнік аднайменны
многоугольник описанный	многакутнік апісаны
многоугольник правильный	многакутнік правільны
множимое	множыва
множитель	множнік
модуль	модуль
названия чисел	назовы лікаў
наибольшее значение	найбольшае значэньне
наименьшее значение	найменшае значэньне
наименьшее общее кратное	найменшы супольны кратны лік
наклонение	нахіленьне
наклонный	нахілены
наложение	накладаньне
направление	кірунак
направление одинаковое	кірунак аднакі
направление противоположное	кірунак супраціўны
направление прямой	кірунак простае (лініі)
направленный отрезок	накіраваны адцінак
натуральный ряд чисел	натуральны рад лікаў
наугольник	накутнік
начало координат	пачатак коордынат
недостаток	недахват
невозможность	немагчымасьць
независимая переменная	зьменная незалежная
незначащая цифра	нязначачая цыфра (лічбіна)
неизвестная величина	невядомая велічыня
неограниченно приближается	неагранічана збліжаецца
неограниченно уменьшается	неагранічана зьмяншаецца
неопределенность	неазначанасьць
неопределенный	неазначаны
неправильный	няправільны
непрерывная дробь	неперарыўны дроб
непрерывность	неперарыўнасьць
непрерывный	неперарыўны
неравенство	няроўнасьць
несовместимые уравнения	нязгодныя раўнаньні
несовмещение	несумяшчальнасьць
несоизмеримые отрезки	нясупольнамерныя адцінкі
несократимый	нескарачальны
нечетный	няцотны
низший член многочлена	ніжэйшы член многачлену
нормаль	нормаль
нормальный	нормальны
нуль	ноль
нумерация	нумэрацыя
обозначение	абазначэньне
обратное отношение	адваротны стасунак
обратно-пропорционально	адваротна-пропорцыянальна
обращение	замена
общая мера	супольная мера
общее свойство	супольная ўласьцівасьць
общий наибольший делитель	найбольшы супольны падзельнік
общий член ряда	агульны член раду
объём	аб'ём
ограниченное число решений	агранічаны лік разьвязкаў
однозначный	адназнакавы (лік)
однократный	аднакратны
однородное уравнение	аднароднае раўнаньне
однородные величины	аднародныя вялічыні
односторонний	аднабочны
одночлен	адначлен
окружность	акружына
окружность вневписанная	акружына прыўпісаная
окружность вписанная	акружына ўпісаная
окружность вписать	акружыну ўпісаць
окружность описанная	акружына апісаная
окружность описать	акружыну апісаць
опирается	апіраецца
описать дугу	апісаць дугу
определение	азначэньне
определитель	вызначнік
ордината	ордыната
оси координат	восі коордынат
основание	(системы логарифмов) аснова; (геом.) аснова, падстава
основание верхнее трапеции	аснова, падстава верхняя трапэзу
основание нижнее трапеции	аснова, падстава ніжняя трапэзу
основание перпендикуляра	аснова, падстава простастаўнай
основание треугольника	аснова, падстава трыкутніка
основания математики	асновы матэматыкі
ось абсцисс или х-ов	вось абсцыс або х-аў
ось ординат или у-ов	вось ордынат або у-аў
ось большая эллипса	вось вялікая эліпсы
ось малая	вось малая
ось вращения	вось вярчэньня або абаротавая
ось симметрии	вось суразьмернасьці, сымэтрыі
остаток (<i>при делении</i>)	астача
остаток ряда	астача раду
ответ (<i>задачи</i>)	адказ
отвлеченное число	бязыменны лік
отложение отрезков	адкладаньне адцінкаў
относительное положение	адноснае палажэньне
относительное число	адносны лік
отношение	стасунак
отнять	адняць, зьменшыць
отрезок пирамиды	адцінак піраміды
отрезок прямой	адцінак простай
отрезки соизмеримые	адцінкі супольнамерныя
отрезки несоизмеримые	адцінкі нясупольнамерныя
отрезки поделить в крайнем и среднем отношении	адцінкі падзяліць у крайным і сярэднім стасунку
отрицательное число	адмоўны лік
ошибка	абмылка, памылка
ошибочность	абмылковасьць
парабола	параболя
параметр	парамэтр
параллелепипед	роўналежнасьценьнік
параллелепипед прямоугольный	роўналежнасьценьнік простакутны
параллелограмм	роўналежнабочнік
параллельный	роўналежны
первоначальные множители	простыя множнікі
перемена	зьмена
переменная величина	зьменная велічыня
переместительный	перамяшчальны
пересечение	перасячэньне
перестановка	перастаўка, перастаноўка
периметр	абвод
период (<i>дроби</i>)	пэрыод, паўторнасьць
периодический	пэрыодычны, паўторны
перпендикуляр	простастаўная (лінія)
перпендикуляр восставить (к прямой)	простастаўную ўзьвесьці, паставіць
перпендикуляр опустить (на прямую)	простастаўную зьвесіць (на простую)
пирамида	піраміда
пирамида треугольная	піраміда трохсьценная
пирамида четырехугольная и т.д.	піраміда чатырохсьценная і г.д.
пирамида усеченная	піраміда сьцятая
письменное счисление	пісоўнае зьлічэньне
планиметрия	плянімэтрыя
плоскость	роўніца
плоскость диагональная	роўніца ўскосная
плоскость касательная	роўніца датычная
плоскость параллельная	роўніца роўналежная
плоскость перпендикулярная	роўніца простастаўная
плоскость секущая	роўніца сякучая
плоскость сливающаяся	роўніца, якая зьліваецца, зьлітная
плоскостной	роўнічны
площадь	плошча, поле
плюс	плюс
поверка	праверка
поверхность	паверхня
поверхность боковая	паверхня бочная
поверхность вращения	паверхня вярчэньня
поверхность коническая	паверхня стажковая, конічная
поверхность кривая	паверхня крывая
поверхность полная	паверхня суцэльная
поверхность цилиндрическая	паверхня вальцовая, цыліндрычная
поверхность шаровая или сферическая	паверхня кулістая або сфэрычная
поворотные значения функций	паваротныя значэньні функцый
погрешность	хібнасьць
подкоренная величина	падкарэнная велічыня
поднормаль	паднормаль
подобие	падобнасьць
подобные фигуры	падобныя фігуры
подставить (численное значение)	падставіць (лікавае значэньне)
подсчет	падрахунак, падлік
подсчитывать	падлічаць
подходящая дробь	падыходзячы дроб
подынтегральное выражение	пад'інтэгральны выраз
показательный	паказальнікавы
показатель степени	паказальнік ступені
половина	палавіна
положение (плоскости)	палажэньне (роўніцы)
положительное число	дадатны лік
полукруг	поўкруг
полуокружность	поўакружына
полупериметр	поўабвод
полуплоскость	поўроўніца
полуразность (дуг)	поўрозьніца (дуг)
полусумма (дуг)	поўсума (дуг)
полюс	канцавосьсе, полюс
попарно	парамі
попарно-сопряженные	парамі зьвязаныя
поперечный	папярочны
порядок бесконечно-малых	парадак бязьмежна-малых
последовательное отложение отрезков	паступовае адкладаньне адцінкаў
последовательный	паступовы
последующий	наступны, другі
постоянная величина	сталая велічыня
построение	збудаваньне
построение корней уравнения	пабудова разьвязкаў раўнаньня
постулат	постулят, вымога
потенцирование	потэнцыраваньне
почленно	пачленна
правило смешения	правіла зьмяшаньня
правило товарищества или пропорционного деления	правіла таварыства або пропорцыональнага падзелу
правильность	правільнасьць
превратить	замяніць
превращение (мер нисшего наименования в меры высшего)	замена (дробных мер у буйныя)
предел	граніца
предел интеграла	граніца інтэгралу
предел интеграла верхний	граніца інтэгралу верхняя
предел интеграла нижний	граніца інтэгралу ніжняя
предельное значение	гранічнае значэньне
предельное положение	гранічнае палажэньне
предельный	гранічны
представление (графическое)	прадстаўленьне (графічнае)
предыдущий (<i>член отношения</i>)	пярэдні, першы
преобразование	перайначваньне
преобразование координат	ператварэньне коордынат
приближение	прыбліжэньне
приближенная квадратура	прыбліжаная квадратура
приближенное отношение	прыбліжаны стасунак
приближенные значения дробей	прыбліжаныя значэньні дробаў
приближенный результат	прыбліжаны рэзультат
приведение дробей к одному знаменателю	прьвядзеньне дробаў да супольнага назоўніка
приведение подобных членов	злучэньне падобных членаў
приведение, сведение	прывядзеньне
призма	кантаслуп, прызма
призма наклонная	кантаслуп нахілены, прызма нахіленая
призма правильная	кантаслуп правільны, прызма правільная
призма прямая	кантаслуп просты, прызма простая
признак	азнака
признак достаточный	азнака выстарчаючая
признак необходимый	азнака неабходная
признаки делимости	прыметы падзельнасьці
признаки равенства треугольников	прыметы роўнасьці трыкутнікаў
прилежащий отрезок	прылеглы адцінак
приложение алгебры к геометрии	прыстасаваньне альгэбры да геомэтрыі
приращение	прырост
прогрессия	прогрэсія
прогрессия арифметическая	прогрэсія арытмэтычная
прогрессия геометрическая	прогрэсія геомэтрычная
проекция	проэкцыя, спад
произведение	здабытак
производитель	сумножнік
производная	паходная (выводная)
производная первая, вторая	паходная першая, другая
производная высшего порядка	паходная вышэйшага парадку
производный	выводны
произвольный (множитель)	адвольны (множнік)
пропорциональный	пропорцыянальны
пропорция арифметическая	пропорцыя арытмэтычная
пропорция геометрическая	пропорцыя геомэтрычная
пропорция непрерывная	пропорцыя неперарыўная
пропорция производная	пропорцыя выводная
пропорция сложная	пропорцыя складаная, зложаная
простое или первоначальное число	просты лік
пространственная сеть кубов	прасторавая сетка кубаў
пространство	прастора
противолежащий (угол)	процілежны (кут)
противоположный	супраціўны, процілежны (геом.)
противоречащие уравнения	супярэчныя раўнаньні
процент	адсотак, процант
проценты простые	адсоткі, процанты звычайныя
проценты сложные	адсоткі, процанты складаныя
процесс изменения	процэс зьмены
прямое отношение	просты стасунак
прямой	просты
прямая	простая
прямо-пропорциональные величины	проста-пропорцыянальныя вялічыні
прямоугольник	простакутнік
равенство	роўнасьць
равновеликий	роўнавялікі
равновеликость	роўнавялікасьць
равновеликость по дополнению	роўнавялікасць праз дапаўненьне
равновеликость по разложению	роўнавялікасць праз раскладаньне
равносильные уравнения	роўнаважныя раўнаньні
радиан	радыян
радикал	радыкал
радикальное уравнение	радыкальнае раўнаньне (нявымернае)
радиус	радыус, прамень
радиус-вектор	радыус-вэктор, прамень рухомы
развернутая поверхность	разьвінутая паверхня
развертка	разьвіненьне
развертывать, развернуть (бином)	разьвінаць, разьвінуць (біном)
разделительный, распределительный закон действий	разлучны закон дзеяньняў
раздробление	замена (буйных мер у дробныя)
разложение (<i>на множители</i>)	расклад, раскладаньне
разложение бинома	расклад, разьвіненьне біному
размещения	разьмяшчэньні
разность	розьніца
разрыв (функции)	разрыў (функцыі)
разрядные единицы	дзесятковыя адзінкі
раскрытие неопределенности	выяўленьне, раскрыцьцё неазначанасьці
раскрыть скобки	расчыніць дужкі
расположенный (<i>геом.</i>)	паложаны
расположенный многочлен	упарадкаваны многачлен
расстояние	адлегласьць
растворение	расхіл
растворение граней	расхіл сьценак
растворение сторон угла	расхіл бакоў кута
растворение циркуля	расхіл цыркуля
расходящийся ряд	разьбежны рад
рациональное число	рацыянальны, вымерны лік
ребро	кант
результат	рэзультат
решение (процесс)	разьвязаньне
решение (результат)	разьвязак
ромб	сукосьнік, ромб
ряд	рад
ряд биноминальный	рад біномінальны
ряд гармонический	рад гармонічны
ряд знакопеременный	рад зьменазнакавы
ряд знакопостоянный	рад сталазнакавы
ряд колеблющийся	рад вагальны
ряд логарифмический	рад лёгарытмічны
ряд показательный	рад паказальнікавы
ряд расходящийся	рад разьбежны
ряд сопряженный	рад супрэжаны
ряд степенной	рад ступянёвы
ряд сходящийся	рад зьбежны
с избытком	з перавышкай
с недостатком	з недахватам
с точностью	з дакладнасьцю
свободный член уравнения	вольны член раўнаньня
сегмент	кругадрэз, сэгмэнт
секанс	сэканс
сектор	кругавыраз, сэктор
секунда	сэкунда
секунда дуговая	сэкунда дугавая
секунда угловая	сэкунда кутавая
сечение	сячэньне, перасек
сечение параллельное	сячэньне роўналежнае, перасек роўналежны
сечение перпендикулярное	сячэньне простастаўнае, перасек простастаўны
сечение площадей	сячэнне плошчаў
сечения конические	стажковыя перасекі
симметричное уравненение	сымэтрычнае раўнаньне
симметричные точки	суразьмерныя, сымэтрычныя пункты
симметрия	суразьмернасьць, сымэтрыя
синтез	сынтэз
синус	сінус
синусоида	сінусоіда
система	уклад, сыстэма
система координат	уклад коордынат
система координат косоугольная	уклад коордынат косакутны
система координат полярная	уклад коордынат полярны, канцавосны
система координат прямолинейная	уклад коордынат просталінейны
система координат прямоугольная	уклад коордынат простакутны
скобки	дужкі
слагаемое	складнік
следствие	вынік
словесное счисление	слоўнае зьлічэньне
сложение	складаньне
сложные проценты	складаныя адсоткі, процанты
сложный	складаны
смешанное число	мяшаны лік
совместимые уравненнения	згодныя раўнаньні
совместимый	згодны
совмещение	сумяшчальнасьць
совокупность чисел	збор лікаў
совпадение (точек)	супаданьне (пунктаў)
соединение	злучэньне
соединительный	злучны
соизмеримое число	вымерны лік
соизмеримые величины	супольнамерныя вялічыні
сокращение дробей	скарачаньне дробаў
сомножитель	сумножнік
соответственно равные (фигуры)	адпаведна-роўныя (фігуры)
соответствующие элементы	адпавядаючыя элемэнты
соотношение	залежнасьць
составное число	складаны лік
состав теоремы	склад тэорэмы
сочетание	комбінацыя
спираль	скрутка, сьпіраль
способ неопределенных коэффициентов	спосаб неазначаных коэфіцыентаў
способ последовательного деления	спосаб вычэрпываючага дзяленьня
способ пределов	спосаб граніц
способ приведения к единице	спосаб прывядзеньня да адзінкі
способ пропорционального деления	спосаб пропорцыянальнага падзелу
спрямление (ректификация) кривых	выпростваньне (рэктыфікацыя) крывых
сравнение	параўнаньне
средний (член пропорции)	сярэдні (член пропорцыі)
срочные взносы	пэрыодычныя ўклады
срочные уплаты	тэрміновыя выплаты
степенное количество	ступянёвая велічыня
степень	ступень
стереометрия	стэрэомэтрыя
сторона треугольника	бок трыкутніка
сторона угла	бок кута
стремление к пределу	імкненьне да граніцы
стягивать	сьцягваць
сумма	сума
суммирование рядов	сумаваньне радоў
сходимость рядов	зьбежнасьць радоў
сходственные стороны	адпаведныя бакі
сходящийся ряд	зьбежны рад
счет	лічэньне
счисление	зьлічэньне
считать	лічыць
таблица	табліца
таблицы пятизначные	табліцы пяцёхцыфровыя
таблицы семизначные	табліцы сямёхцыфровыя
таблицы тригонометрические	табліцы трыгономэтрычныя
тангенс	тангенс
тангенсоида	тангенсоіда
тела круглые	круглыя целы
тело геометрическое	геомэтрычнае цела
теодолит	тэодоліт
теорема	тэорэма
теорема вспомогательная	тэорэма дапаможная
теорема обратная	тэорэма адваротная
теорема противоположная	тэорэма процілежная
теорема прямая	тэорэма простая
теория пределов	тэорыя граніц
тождественный	тожсамы
тождество	тожсамасьць
точка (<i>геом.</i>)	(<i>знак</i>) кропка; (<i>геом.</i>) пункт
точка высот или ортоцентр	пункт перасячэньня вышыняў, ортоцэнтр
точка касания	пункт дотыку
точки недоступные	пункты недаступныя
точки перегиба	пункты перахілу
точность	дакладнасьць
транспортир	кутамер-пераносьнік, транспортыр
трансцендентный	пераступны, трансцэндэнтны
трапеция	трапэз
трапеция равнобочная	трапэз роўнабочны
треугольник	трыкутнік
треугольник косоугольный	трыкутнік косакутны
треугольник остроугольный	трыкутнік востракутны
треугольник прямоугольный	трыкутнік простакутны
треугольник равнобедренный	трыкутнік роўнаплечы
треугольник равносторонний	трыкутнік роўнабочны
треугольник равноугольный	трыкутнік роўнакутны
треугольник разносторонний	трыкутнік рознабочны
треугольник тупоугольный	трыкутнік тупакутны
трехчлен	трохчлен
триангуляционная сеть	трыангуляцыйная, трыкутнікавальная сетка
триангуляция	трыангуляцыя, трыкутнікаваньне
тригонометрический	трыгономэтрычны
тригонометрия	трыгономэтрыя
тригонометрия прямолинейная	трыгономэтрыя просталінейная або роўнічная
тригонометрия сферическая	трыгономэтрыя кулістая або сфэрычная
троичный	тройчы
тройное правило	тройнае правіла; задачы на пропорцыянальныя вялічыні
тройное правило простое	тройнае правіла простае
тройное правило сложное	тройнае правіла складанае
убывающая прогрессия	спадаючая прогрэсія
убыль	убытак
увеличение	павялічэньне
угол	кут
угол внешний	кут знадворны
угол внутренний	кут унутраны
угол вписанный	кут упісаны
угол вспомогательный	кут дапаможны
угол двойной	кут падвойны
угол двугранный	кут двусьценны
угол измеряется дугой	кут мераецца дугой
угол линейный	кут лінейны
угол многогранный	кут многасьценны
угол опирается на дугу	кут апіраецца на дугу
угол острый	кут востры
угол плоский	кут роўнічны
угол полный	кут поўны
угол половинный	кут палавінны
угол при вершине	кут пры вяршыне
угол прилежащий	кут прылеглы
угол примыкает к другому	кут прылягае да другога
угол противолежащий	кут процілежны
угол прямой	кут просты
угол развернутый, выпрямленный	кут выпрастаны
угол трехгранный	кут трохсьценны
угол тупой	кут тупы
угол центральный	кут асяродкавы, цэнтральны
углы вертикальные	куты крыжавыя
углы дополнительные	куты дапаўняючыя
углы двугранные	куты двусьценныя
углы двугранные острые	куты двусьценныя вострыя
углы двугранные прямые	куты двусьценныя простыя
углы многогранные вогнутые	куты многасьценныя ўгнутыя
углы многогранные выпуклые	куты многасьценныя выгнутыя
углы накрест-лежащие внутренние	куты наўскасьлежныя ўнутраныя
углы накрест лежащие внешние	куты наўскасьлежныя знадворныя
углы несовместимые	куты несумяшчальныя
углы односторонние внешние	куты аднабочныя знадворныя
углы односторонние внутренние	куты аднабочныя ўнутраныя
углы подобно расположенные	куты падобна разьмешчаныя
углы попарно равные	куты парамі роўныя
углы смежные	куты сумежныя
углы совместимые	куты сумяшчальныя
углы соответственные (при параллельных)	куты аднабочна-адпаведныя
углы соответственные (в подобных фигурах)	куты куты адпаведныя
углы с соответственно параллельными сторонами	куты з адпаведна роўналежнымі бакамі
углы с соответственно перпендикулярными сторонами	куты з адпаведна простастаўнымі бакамі
удвоение	падваеньне
уменьшаемое	зьменшыва
умножение	множаньне
упражнения	практыкаваньні
упрощение	упрошчаньне
уравнение	раўнаньне
уравнение нормальное	раўнанне нормальнае
уравнение общее	раўнанне агульнае
уравнение прямой	раўнанне простай
уравнение тригонометрическое	раўнанне трыгономэтрычнае
уравнение коэффициентов	зраўнаньне коэфіцыэнтаў
усеченный	сьцяты
условие (задачи)	умова (задачы)
устный счет	вуснае лічэньне
учет векселей	адлічэньне з вэксаля (дысконт)
учет векселей коммерческий	адлічэнне з вэксаля гандлёвае (купецкае)
учет векселей математический	адлічэнне з вэксаля матэматычнае
факториал	факторыял
фигуры	фігуры
фигуры геометрические	фігуры геомэтрычныя
фигуры подобно расположенные	фігуры падобна разьмешчаныя
фигуры равновеликие	фігуры роўнавялікія
фигуры равные	фігуры роўныя
фокус	вогнішча
форма фигуры	форма фігуры
формула (удвоения)	формула, узор (падваеньня)
формулы приведения	формулы зьвядзеньня
функция	функцыя
функция аналитическая	функцыя аналітычная
функция возрастающая	функцыя узрастаючая
функция второго порядка	функцыя другога парадку
функция высшего порядка	функцыя вышэйшага парадку
функция гомографическая	функцыя гомографічная
функция дробная	функцыя дробавая
функция иррациональная	функцыя нявымерная, ірацыональная
функция круговая	функцыя кругавая
функция линейная	функцыя лінейная
функция многозначная	функцыя многазначная
функция непрерывная	функцыя неперарыўная
функция нечетная	функцыя няцотная
функция неявная	функцыя няяўная
функция обратная	функцыя адваротная
функция однозначная	функцыя адназначная
функция первого порядка	функцыя першага парадку
функция первообразная	функцыя першапачатковая
функция подинтегральная	функцыя пад'інтэгральная
функция показательная	функцыя паказальнікавая
функция прерывная	функцыя перарыўная
функция прямая	функцыя простая
функция радикальная	функцыя радыкальная
функция рациональная	функцыя вымерная, рацыональная
функция сложная	функцыя складаная
функция трансцендентная	функцыя пераступная, трансцэндэнтная
функция тригонометрическая	функцыя трыгономэтрычная
функция убывающая	функцыя убываючая
функция целая	функцыя цэлая
функция четная	функцыя цотная
функция эмпирическая	функцыя эмпірычная
функция явная	функцыя яўная
характеристика (знак)	знак, сымболь
характеристика логарифма	азнака лёгарытму, цэлая частка лёгарытму
хорда	струна, хорда
целое число	цэлы лік
центр	асяродак, цэнтр
центр симметрии	асяродак, цэнтр сымэтрыі, суразьмернасьці
цепь землемерная	ланцуг каморніцкі
цилиндр	валец, цыліндр
цилиндр прямой круговой	валец, цыліндр просты кругавы
циркуль	цыркуль
цифра	цыфра, лічбіна
частное (<i>от деления</i>)	дзель
частные числа	паасобныя лікі
чертеж	рысунак
черчение	красьленьне
четный	цотны
четыреугольник	чатырохкутнік
четырехгранник правильный, тетраэдр	чатырохсьценьнік правільны, тэтраэдр
численный пример	лікавы прыклад
числитель дроби	лічнік дробу
число	лік
члены дроби	члены дробу
шар	куля
шаровой пояс или зона	кулісты пояс або зона
шаровой сегмент	адрэзак, сэгмэнт кулі
шаровой сектор	вырэзак, сэктор кулі
шаровой сектор полый	вырэзак, сэктор кулі дупляны
шаровой слой	пласт кулі
шестигранник правильный, гексаэдр	шасьцёхсьценьнік правільны, гэксаэдр
эксцентриситет	мімасяроднік
эксцентрические окружности	рознаасяродкавыя акружыны
элементы (треугольника)	складнікі, элемэнты (трыкутніка)
эллипс	эліпса
