##Title: Географічныя й космографічныя тэрміны і назовы нябесных цел (БНТ)
##HTMLDescription_BEGIN
<div>
	<p class="dictdesc-st">Створана на падставе:</p>
	<p><b>Географічныя й космографічныя тэрміны і назовы нябесных цел</b>. Менск: Інбелкульт, 1923.</p>
</div>
<div>
	<p class="spoiler">Прадмова</p>
	<p>Гэты выпуск «Беларускае навуковае тэрмінолёгіі» зьмяшчае ў сабе географічныя і космографічныя тэрміны і назовы нябесных цел. <i>Апрацаваньне беларускіх географічных тэрмінаў належыць М. В. Азбукіну, а апрацаваньне беларускіх космографічных тэрмінаў і назоваў нябесных цел (космографічнае тэрмінолёгіі і номэнклятуры) − Л. Л. Більдзюкевічу</i>. Увесь гэты матар‘ял разглядаўся на пасяджэньнях Прыродазнаўчага Аддзелу Інстытуту Беларускае Культуры і на пленарных яго сходах.</p>
</div>
##HTMLDescription_END
##ArticleLang: ru/be

аберрация	абэрацыя
абляция	абляцыя
абориген	тубылец
абразия	абразiя
август	жнiвень
Аврора (малая планета)	Аўрора
автономия	самаўрад
Агата (малая планета)	Агата
азимут	азiмут
айсберг	гара лёдавая
акклиматизация	аклiматызацыя
аккумуляция	акумуляцыя, награмаджэньне
аллювий	алювi
Альгениб (в созвездии Пегаса)	Альгенiб
Альдебаран (альфа Тельца)	Альдэбаран, Вока Быка
Алькор	(гл. Наездник)
Альтаир или Атаир (альфа Орла)	Альтаiр
Алтарь (созвездие)	Аўтар
Альцион (эта Тельца)	Альцыон
амплитуда колебаний	размах вiханьняў
Андромеда (созвездие)	Андромэда
андромедиды (поток падающих звезд)	андромэдыды
Анна (малая планета)	Ганна
аномалии термические	аномалi або адхiленьнi цеплавыя
Антарес (альфа Скорпиона)	Антарэс
Антарктида или Антарктика	Паўдзеньне
антиклинали	выгiны, антыклiналi
Антиной (созвездие)	Антыной
антиподы	антыподы
антициклон	антыцыклён
антропогеография	антропогеографiя
апекс (пункт неба, к которому земля приближается в своем беге)	апэкс
апогей	пункт адземны, апогей
апрель	красавiк
апсиды луны	апсiды месяца
Ариадна (малая планета)	Арыядна
Ариель (спутник Урана)	Арыель
Арктида или Арктика	Паўночча
Арктур (альфа Боотеса или Волопаса)	Арктур
артерия водная	артэрыя вадзяная
Арфа Георгия (созвездие)	Арфа Юрыя
архипелаг	архiпэляг, згуртаваньне вастравоў
астероиды	плянэтоiды або плянэты малыя
Астрея (малая планета)	Астрэя
астрогнозия	астрогнозiя
астрономия наблюдательная	астрономiя наглядальная або зорказнаўства наглядальнае
астрономия описательная	астрономiя апiсовая або зорказнаўства апiсовае
астрономия сферическая	астрономiя сфэрычная або зорказнаўства кулiстае
астрономия теоретическая	астрономiя тэорэтычная або зорказнаўства тэорэтычнае
астрономия физическая	астрономiя фiзычная або зорказнаўства фiзычнае
астрофизика	астрофiзыка
астрофотометры	сьветламеры зоркавыя або астрофотомэтры
Атаир	(гл. Альтаир)
атлас	атляс
атмосфера	атмосфэра
атолл	атоль
афелий	афэль
Ахернар (альфа Реки Эридана)	Ахэрнар
Ахиллес (малая планета)	Ахiлес
аэролиты	аэролiты
базис триангуляции	аснова трыкутнiкаваньня, базiс трыангуляцыi
балка	роў
Баллон	(гл. Шар Воздушный)
банка	мялiзна падморская
барисфера	барысфэра
барометр	баромэтр
бархан	(гл. дюна пустынная)
бассейн	вадазбор
бассейн бессточный	вадазбор бясстокавы
Беллатрикс (в созв. Ориона)	Бэлятрыкс
бентос	бэнтос, паўздоньне
берег	бераг
берег внешний	бераг знадворны
берег внутренний	бераг унутраны
берег дискордантный	бераг нязгодны
берег конкордантный	бераг згодны
берег левый	бераг левы
берег нейтральный	бераг нэўтральны
берег правый	бераг правы
берег расчлененный	бераг парэзаны
Бетейгейзе (альфа Ориона)	Бэтэйгейзэ
биогеография	бiогеографiя
бифуркация рек	бiфуркацыя або разьвiленьне рэк
Близнецы (созвездие Зодиака)	Блiзьняты, Блiзьнюкi
блеск звезд	блiск зорак
болиды	болiды, кулi агнiстыя
болото	балота, багна
болото моховое	імшара
большак	(гл. дорога почтовая)
бомба вулканическая	гуля вульканiчная
Боотес или Волопас (созвездие)	Валапас
бора	бора´
борозды лунные	барозны месяцавыя
брахицефалы	брахiцэфалi, кароткагаловы
бриз	брыза
бугор	груд, горб
бугры песчаные	груды пескавыя
буран	завiруха
бурлак	аснач
буря	бура
буря магнитная	бура магнэсавая
буря равноденственная	бура роўнадзенная
Буссоль или Компас (созвездие)	Компас
бухта	букта
быт	быт
быт пастушеский	быт пастырскi
вади	вадзi
валёжник	пава´л
валун	камень ледавiковы
ванна	(гл. котловина)
вариация в движении луны	варыяцыя або зьменка ў руху месяца
ввоз	прывоз
Вега (альфа Лиры)	Вэга
вёдро	(гл. погода хорошая)
величины звездные	вялiчынi зоркавыя
Венера	Вэнэра
Венец Северный, Корона Северная (созвездие)	Вянец Паўночны
Венец Южный, Корона Южная (созвездие)	Вянец Паўднёвы
венцы вокруг луны	вянкi навакол месяца
вертикал или круг вертикальный	круг проставесны або старчавы
верфь	майстэрня караблёў
верховье реки	вышнявiна ракi
вершина горы	верх гары
вес земли	вага зямлi
весна	вясна
Веста (малая планета)	Вэста
Весы (созвездие Зодиака)	Шалi
ветер	вецер
вечер	вечар
взморье	узмор'е
вид викарирующий	вiд заменны
Виктория (малая планета)	Вiкторыя
виноградник	вiнаградня
винокурение	браварніцтва, вiньнiцтва
вихрь	вiхор
владение	уладаньне
влажность	вiльготнасьць
влажность абсолютная	вiльготнасьць абсолютная або безадносная
влажность относительная	вiльготнасьць адносная або параўнаўчая
вода горько-соленая	вада горка-салоная
вода грунтовая или почвенная	вада грунтавая
вода пресная	вада прэсная або салодкая
водоворот	вiр
Водолей (созвездие Зодиака)	Вадалiў
водопад	вадаспад
водораздел	вадападзел, вададзел
водоскат	вадасьцёк
возвышенность	узвышша
возгорание метеоритов	узгараньне нябесных каменьняў
воздух	паветра
воздух насыщенный	паветра насякнутае
воздух разреженный	паветра рэдкае
возмущение магнитное	абурэньне магнэсавае
возмущения в движении планет	збачэньнi або пэртурбацыi ў руху плянэт
Возничий (созвездие)	Возьнiк
возраст планеты	век або ўзрост плянэты
Волк (созвездие)	Воўк
волна	хваля
волна бентоническая	хваля аддонная або бэнтонiчная
волна внутренняя	хваля ўнутраная
волна стоячая, сейша	хваля стаячая, сэйша
волнение	хваляваньне
волок	волак
Волопас	(гл. Боотес)
волосы кометы	воласы комэты
Волосы Вероники (созвездие и звездная куча)	Воласы Бэрэнiкi
Ворон (созвездие)	Груган
воскресение	нядзеля
восток	усход
восхождение прямое	узьняцьцё простае
впадение реки	упад або ўток ракi
впадина, депрессия	западзiна
вращение земли суточное	вярчэньне зямлi сутачнае
вращение планет	вярчэньне плянэт
время года	пара году
время гражданское	час грамадзкi
время звездное	час зоркавы
время истинное	час запраўдны
время солнечное	час сонцавы
время среднее	час сярэднi
времяисчисление	часалiчэньне
вселенная	сусьвет
вскрытие реки	узьнiманьне ракi
Вулкан (планета)	Вулькан
вулкан гомогенный	вулькан аднародны
вулкан грязевой	крынiца гразявая
вулкан действующий	вулькан дзейны
вулкан потухший	вулькан згаслы
вторник	аўторак
выветривание	выпятрэньне
вывоз	вываз
выдувание	выдмуханьне
вымерзание	вымярзаньне
вымирание	вымiраньне
выпахивание ледниковое	выворваньне ледавiковае
выпуклина	выпуклiна, гарбавiна
выпуклость земли	выгнутасьць зямлi
высота	вышыня, высачыня
высота абсолютная	вышыня абсолютная, безадносная
высота относительная	вышыня адносная, параўнаўчая
высота светила	вышыня сьвяцiла
выступы солнечные, протуберансы	выступы сонцавыя, протубэранцы
высыхание рек	усыханьне рэк
выход горной долины	выйсьце горнай далiны
выход горной породы	выступаньне земнай пароды
гавань	прыстань
газ закритический	газ надкрытычны
Галатея (малая планета)	Галятэя
гало, круги около солнца и луны	кругi навокал сонца цi месяца
галофиты	расьлiны-солялюбы
галька	галачка, аточак
гаммада	гамада, пустыня камянiстая
гать	грэбля, гаць
гаф	гаф
Геба (малая планета)	Геба
гейзер	гейзар
Гемма или Жемчужина (альфа Северной Короны или Северного Венца)	Гема
география	географiя
география астрономическая, математическая	географiя астрономiчная, матэматычная
география физическая	географiя фiзычная
геодезия	геодэзiя
геоид	геоiд
геокороний	геокоронь
геоморфология	геоморфолёгiя
Геркулес (созвездие)	Геркулес
Гиады (звездное скопление в созвездии Тельца)	Гіады, Дажджавiкi
Гигея (малая планета)	Гігея
гигрометр	гігромэтр, вiльгамер
Гидра или Змея Водяная (созвездие)	Гiдра
Гидра Малая или Водяная Змея Малая (созвездие)	Гiдра Малая
гидрография	гідрографiя
гидрология	гiдролёгiя
гидросфера	гідросфэра
гидрофаты	расьлiны-вадалюбы
Гильда (малая планета)	Гiльда
гирло	гарлавiна
гирлянда островов	(гл. цепь островов)
глетчер	ледавiк
глина	глiна
глина сланцеватая	глiна лупнякаватая
глина сланцевая	глiна лупняковая
глобус земной	глёбус земны
глобус небесный	глёбус нябесны
глубина	глыбiня
глыба вулканическая	камлыга вульканiчная
гнейс	гнэйс
гномон	гномон
говор	гаворка
год високосный	год пераступны
год гражданский	год грамадзкi
год звездный или сидерический	год зоркавы або сiдэрычны
год обыкновенный или простой	год звычайны
год световой	год сьветлавы
год тропический или астрономический	год зваротнiкавы, астрономiчны (зорказнаўчы)
голова кометы	галава комэты
гололедица	воблiў, галалёд
Голубь (созвездие)	Голуб
гора	гара
гора вулканическая	гара вульканiчная
гора Меналуса	гара Мэналюса
гора столовая	гара-стол
Гора Столовая (созвездие)	Гара-Стол (сузор'е)
горизонт	кругавiд, пазем
горизонт астрономический	пазем астрономiчны
горизонт видимый или физический	пазем вiдочны або фiзычны
горизонт истинный	пазем запраўдны
горизонт математический	пазем матэматычны
горизонталь	паземнiк
город	горад, места
горообразование	гораўтварэньне
горст	горст
горы сбросовые	горы скiдавыя
горы свидетели	горы сьведкi
горы складчатые	горы зморшчавыя
горы эрозионные	горы адмытыя, эрозiйныя
государство	дзяржава
грабен	грабэн
гравий	жвiр, жарства
град	град
градиент	градыент
градус	градус, ступень
гранит гнилой	гранiт выпятрэлы
граница	мяжа, гранiца, рубеж
граница дат или граница смены дней	гранiца дат або гранiца зьмены дзён
граница естественная	мяжа прыродная
граница искусственная	мяжа штучная
граница политическая	мяжа полiтычная
гранулы (на поверхности солнца)	гранулi
грануляция солнца	грануляцыя сонца
гребень (волны, горной цепи)	хрыбет (хвалi, горнага ланцуга)
гроза	навальнiца
гром	гром
грот	пячэра
гряда горная	града горная
грязь вулканическая	гразь вульканiчная
гумус	гумус, перагной
густота населения	гушчыня залюдненьня
давление атмосферное	цiск атмосфэрны
дамба	дамба, грэбля
движение звезд суточное	рух зорак сутачны
движение земли вращательное	рух зямлi абаротавы
движение земли поступательное	рух зямлi паступовы
движение населения	зьмена люднасьцi
движение солнца видимое или кажущееся	рух сонца вiдочны
движение солнца собственное	рух сонца ўласьцiвы
движения планет возвратные или попятные	рухi плянэт узваротныя
движения планет прямые	рухi плянэт простыя
дебри	нетры
Дева (созвездие Зодиака)	Дзяўчына
девиация	(гл. отклонение отвеса у гор)
Деймос (спутник Марса)	Жах, Дэймос
декабрь	сьнежань
деление административное	падзел адмiнiстрацыйны
дельта	дэльта
Дельфин (созвездие)	Дэльфiн
Денеб (альфа Лебедя)	Дэнэб
Денебола (бэта Льва)	Дэнэболя
денудация	дэнудацыя, абгаленьне
депрессия	(гл. впадина)
деревня	вёска
дерн	дзярно, дзёран
деспотия	дэспотыя
деструкция	дэструкцыя
дефляция	дэфляцыя
деятельность (геологическая) ветра, моря, воды, льда	дзейнасьць
дилювий	дылювi
Диона (спутник Сатурна)	Дыона
диски планет	дыскi плянэт
дислокация	дысьлёкацыя
дно	дно
дождемер	дажджамер
дожди звездные	дажджы зьнiчкавыя
дождь зенитный	дождж зэнiтны
дождь крупный	дождж буйны
дождь мелкий	дождж дробны
дождь обложный	дождж зацяжны
дождь сильный	дождж вялiкi
док	док
долгота астрономическая	даўжыня астрономiчная
долгота географическая	даўжыня географiчная
долина поперечная	далiна папярочная
долина продольная	далiна прадоўжная
долина прорыва, сквозная	далiна скрозьгорная
долина структурная	далiна адрэчная
долина тектоническая	далiна тэктонiчная
долихоцефалы	долiхоцэфалi, доўгагаловы
Долото Ваятеля	Долата Скульптара
дорога железная	чыгунка
дорога железная подъездная	чыгунка бочная
дорога грунтовая	дарога грунтавая
дорога почтовая, большак	шлях, гасьцiнец
дорога проселочная	дарога вясковая
Дракон (созвездие)	Цмок
дрейф	дрэйф
Дубге (альфа Большой Медведицы)	Дубге
Дуб Карла II (созвездие)	Дуб Кароля II
дюна	выдма
дюна речная	выдма прырэчная
дюна морская	выдма прыморская
дюна пустынная	выдма пустынная, звычайная
Единорог	Адзiнарог
Елена (малая планета)	Галена
Жезл Иакова	(гл. Пояс Ориона)
желоб циклона	папярочына цыклёну
Жемчужина	(гл. Гемма)
животноводство	гадоўля жывёлы
жила (геол.)	жыла
жилище	мяшканьне
Жираф, Жирафа или Камелеопард (созвездие)	Жырафа
житель	насельнiк
жрец	капла´н, ахвярнiк
Журавль (созвездие)	Жораў
завод	гута, фабрыка, завод
завод винокуренный	бровар, вiньнiца
завод дрожжевой	дражджоўня
завод кирпичный	цагельня
завод кожевенный	гарбарня
завод конский	завод конскi
завод лесопильный	пiльня
завод литейный	гiсэрня
завод мукомольный (паровая мельница)	млын паравы
завод мыловаренный	мылаварня
завод пивоваренный	бровар пiваварны, пiваварня
завод сахарный, сахароваренный	цукраварня
завод смолокуренный	смалярня, смалакурня
завод стеклянный	гута шкляная
заводь	плёс
загорание звезд	заясьненьне зорак
закат	заход
залежь, залегание	паклад
залив	затока
замерзание	замярзаньне
заносы снежные	замецi, замёты сьнегавыя
занятия жителей	заняткi насельнiкаў
запад	за´хад
запруда	грэбля
зарница	блiскавiца
заросль	зарасьнiк
заря	золак
заря вечерняя	золак вячэрнi
заря утренняя	золак ранiчны
заселение	засяленьне, залюдненьне
засуха	сухмень
затмение полное	зацьменьне поўнае
затмение солнца кольцеобразное	зацьменьне сонца персьцянёвае
затмение частное или частичное	зацьменьне часткавае
заторы ледяные	заторы лёдавыя
заход солнца	заход
захождение светила	заход сьвяцiла
Заяц (созвездие)	Заяц
Звезда Полярная (альфа Малой Медведицы)	Зорка Паўночная, Канцавосная
Звезда Собачья	(гл. Сириус)
звезды белые	зоркi белыя
звезды блестящие	зоркi блiскучыя
звезды блуждающие или планеты	зоркi бадзяжныя або плянэты
звезды вечерние	зоркi вячэрнiя
звезды волосатые или кометы	зоркi калматыя або комэты
звезды двойные оптические	зоркi вiдочна-падвойныя
звезды двойные физические	зоркi фiзычна-падвойныя
звезды желтые	зоркi жоўтыя
звезды зенитные	зоркi зэнiтавыя
звезды красные	зоркi чырвоныя
звезды кратные или сложные	зоркi складаныя
звезды мерцающие	зоркi мiгацеючыя
звезды невосходящие	зоркi няўсходзячыя
звезды незаходящие	зоркi незаходзячыя
звезды неподвижные	зоркi нярухомыя
звезды новые или временные	зоркi новыя або тымчасовыя
звезды околополярные	зоркi прыканцавосныя
звезды падающие или падучие периодические	зьнiчкi пэрыодычныя, зоркi падучыя пэрыодычныя
звезды падающие (падучие) спорадические	зоркi падучыя, выпадкова зьяўныя або спорадычныя, зьнiчкi выпадкова зьяўныя
звезды переменные	зоркi зьменныя
звезды полярные	зоркi канцавосныя
звезды потухшие или угасшие	зоркi згаслыя
звезды телескопические	зоркi тэлескопiчныя
звезды темные	зоркi цёмныя
звезды тройные	зоркi патройныя
звезды туманные	зоркi туманныя
звезды утренние	зоркi заранкi
звезды цветные	зоркi каляровыя
звезды яркие	зоркi яскравыя
звероловство	зьвералоўства
зверь пушной	зьвер хутровы
землевладение	землеўладаньне
земледелие	земляробства
землетрясение	землетрасеньне
землетрясение волнообразное	землетрасеньне зыбiстае
землетрясение вулканическое	землетрасеньне вульканiчнае
землетрясение нептуническое	землетрасеньне западовае
землетрясение тектоническое	землетрасеньне тэктонiчнае
землетрясение толчкообразное	землетрасеньне штурхальнае
земля	зямля
земля пахотная	зямля ворная
зенит	зэнiт
зеркальность воздуха	люстранасьць паветра
зима	зiма
Змееносец, Змеедержец или Офиух (созвездие)	Зьмеядзержнiк
Змей, Змея (созвездие)	Вуж
Змея Водяная	(гл. Гидра)
Змея Водяная Малая	(гл. Гидра Малая)
знаки зодиака	знакi зодыяку
зной	сьпякота
зодиак	зодыяк
зона	пас
зыбь	зыбаньне
зыбь мертвая	зыбаньне бязьветранае
извержение вулкана	выбух вулькану
извержение вулкана в виде взрыва	выбух вулькану разрыўны
извержение вулкана смешанное	выбух вулькану мяшаны
извержение вулкана лавовое	выбух вулькану лявавы
извержение вулкана периодическое	выбух вулькану пэрыодычны
извержение вулкана центрального типа	выбух вулькану асяродкавы
извержение вулкана лабиальное	выбух вулькану лябiальны
известняк	вапняк
извилина, излучина	зьвiлiна, лукавiна
изделия	вырабы
излияние лавы	вылiў лявы
изменения адиабатические	зьмены адыябатычныя
измерения градусные	памеры градусныя
изоаномалы	iзаномалi
изобары	iзобары, лiнii роўнацiскавыя
изобаты	iзобаты, лiнii роўнаглыбiнёвыя
изогипсы	iзогiпсы, лiнii роўнавышынёвыя
изогнутость пластов	пагнутасьць пластоў
изотермы	iзотэрмы, лiнii роўнацеплавыя
ил	глей
ил глобигериновый	глей глёбігерынавы
ил диатомовый	глей дыятомавы
ил птероподовый	глей птэроподавы
ил радиоляриевый	глей радыёлярыевы
ильмени (озера между песчаными буграми)	азяркi, iльменi
иммиграция	усяленьне, iмiграцыя
империя	iмпэрыя
импорт	прывоз
Индус (созвездие)	Iндус
иней	шэрань, iней
инсоляция	iнсоляцыя
инструмент пасажный	прылада пасажная
инструмент универсальный	прылада унiвэрсальная
Ирида (малая планета)	Iрыда
иррадиация серпа луны	iрадыяцыя або краясьветласьць сярпа месяца
ископаемые	выкапнi
иссякание рек	зьнiканьне рэк
исток или начало реки	пачатак ракі, вытак або выплынь ракi
источник	крынiца
источник вадозный	крынiца вадозная
источник восходящий	крынiца ўсходзячая
источник горячий	крынiца гарачая
источник железистый	крынiца жалезiстая
источник лечебный	крынiца лекавая
источник минеральный	крынiца мiнэральная
источник нисходящий	крынiца спадаючая
источник перемежающийся	крынiца перарыўчастая
источник серный	крынiца серкавая
источник соленый	крынiца салоная
источник теплый	крынiца цёплая
источник холодный	крынiца сьцюдзёная
источник ювенильный	крынiца ювэнiльная
июль	лiпень
июнь	чэрвень
калема	калема
календарь астрономический	каляндар астрономiчны
календарь грегорианский	каляндар грыгорыянскi
календарь звездный	каляндар зоркавы
календарь лунный	каляндар месяцавы
календарь солнечный	каляндар сонцавы
календарь юлианский	каляндар юлiянскi
Камелеопард	(гл. Жирафа)
камень драгоценный	камень дарагi
камни полублагородные	каменьнi паўшляхэтныя
кампосы	кампосы
канава	канава
канал морской	канал морскi
канал обходный	канал абходны
канал оросительный	канал абвадняльны
канал речной	канал рэчны
канал соединительный	канал злучальны
канал судоходный	канал суднаходны
каналы Марса	каналы Марса
каннибализм	людаедзтва
Канопус (альфа Корабля Аргонавтов)	Канопус
каньон	каньён
каолин	белаглiньне, каолiн
капля	кропля, капка
Капелла (альфа Возничего)	Капэля або Каза
караван	караван
карры или шраты	кары
карта географическая	карта географiчная
карта звездная	карта зоркавая
карта климатическая	карта клiматычная
карта Меркаторская	карта Мэркатарская
карта политическая	карта полiтычная
карта физическая	карта фiзычная
карта этнографическая	карта этнографiчная
картография	картографiя
каскад	каскада, вадаспад прыступкавы
Кассиопея (созвездие)	Касiопэя
Кастор (альфа Близнецов)	Кастар
каталоги звезд	каталёгi зорак
каяк	каяк
Квадрант Стенной (созвездие)	Квадрант Сьценны
квадратуры луны	квадратуры месяца
Кентавр или Центавр (созвездие)	Цэнтаўр
Кербер или Цербер (созвездие)	Цэрбэр
кибитка	кiбiтка
Кит (созвездие)	Рыбазьвер
климат влажный, сырой	клiмат вiльготны
климат жаркий	клiмат гарачы
климат континентальный	клiмат сухаземны
климат морской	клiмат морскi
климат подтропический	клiмат падзваротнiкавы
климат сухой	клiмат сухi
климат умеренный	клiмат мерны
климат холодный	клiмат халодны
климатология	клiматолёгiя
ключ	(гл. источник)
ключ грязевой	(гл. вулкан грязевой)
Козерог (созвездие Зодиака)	Казларог
колебание почвы	ваганьне грунту
колебания вековые	рухi земнай кары векавыя
колебания земной оси или нутация	вiханьне земнай восi або нутацыя
колебания температуры годовые	ваганьнi тэмпэратуры гадавыя
колебания температуры суточные	ваганьнi тэмпэратуры сутачныя
колодезь	калодзеж
колодезь артезианский	калодзеж артэзыйскi
колодезь естественный	калодзеж прыродны
колонизация	асаднiцтва, колёнiзацыя
колония земледельческая	асада, колёнiя земляробская
колония переселенческая	асада, колёнiя перасяленская
колония плантационная	асада, колёнiя плянтацыйная
колония скотоводческая	асада, колёнiя жывёлагадоўчая
колония торговая	асада, колёнiя гандлёвая
Колос или Спика (альфа Девы)	Колас
колур равноденствий	круг простастаўны роўнадзеньняў
колур солнцестояний	круг сонцаваротаў
кольца Сатурна	абручы Сатурна
кометы внешние	комэты знадворныя
кометы внутренние	комэты ўнутраныя
кометы периодические	комэты пэрыодычныя
кометы спорадические	комэты спорадычныя
компас	компас
Компас (созвездие)	(гл. Буссоль)
конгломерат	зьляпняк
конденсация пара	(гл. сгущение пара)
континент	контынэнт
Конь Малый (созвездие)	Конь Малы
координаты гелиоцентрические	коордынаты гелiоцэнтрычныя
координаты географические	коордынаты географiчныя
координаты геоцентрические	коордынаты геоцэнтрычныя
координаты горизонтальные	коордынаты паземнага ўкладу
координаты небесные	коордынаты нябесныя
координаты полярные	коордынаты канцавосныя
координаты экваториальные	коордынаты раўнiковыя
координаты эклиптические	коордынаты эклiптычныя
копь	капальня
Корабль Арго (созвездие)	Карабель Арго
кора земная	кара зе´мная
коралл	караль
Корона Северная	(гл. Венец Северный)
корона солнечная	карона сонцавая
Корона Южная	(гл. Венец Южный)
корразия	коразыя, сьцiраньне
коррозия	корозыя, разьяданьне
коса, пересыпь	гак, пярэспа
космогония	космогонiя
космография	космографiя
космос	сусьвет, космос
Кот (созвездие)	Кот
котловина	катлiна
кочевники	вандроўнiкi
кочевье	вандроўе
край	край
краснозем	чырвоназем
кратер	жарало, кратэр
кратеры лунные	кратэры месяцавыя
крепость	крэпасьць
Крест Южный (созвездие)	Крыж Паўднёвы
кривая гипсографическая	крывая гiпсографiчная
кристалл ледяной	крышталь лёдавы
круг вертикальный	(гл. вертикал)
круги поворотные или тропики	зваротнiкi
круги склонения	кругi збачэньня
круги часовые	кругi гадзiнавыя
круг меридианный	круг палудзеньнiкавы
круг параллельный	роўналежнiк
круг полярный	круг падканцавосны
круговорот воды	кругазварот вады
крупа (вид атмосферных осадков)	крупка
кряж горный	вал горны
Кубок или Чаша (созвездие)	Келiх
кульминация верхняя	кульмiнацыя вышняя або верхаваньне
кульминация нижняя	нiзаваньне або кульмiнацыя нiжняя
культ предков	культ дзядоў
культ солнечный	культ сонца
культура духовная	культура разумовая
культура материальная	культура рэчавая або матар'яльная
культура террасовая	культура прыступкавая
курган	курган
курорт	курорт
кустарник колючий	хмызьняк калючы
кустарь	саматужнiк
кучи звездные	раi зоркавыя
лава затвердевшая	лява зацьвярдзелая
лава огненно-жидкая	лява агнёва-цякучая
лавина	сьнегазвал
лавина весенняя или грунтовая	сьнегазвал веснавы
лавина зимняя или пылевая	сьнегазвал зiмовы
лагуна	лягуна
ландшафт	краявiд
ландшафт карстовый	краявiд карставы
ландшафт моренный	краявiд морэнавы
лапилли	каменьчыкi вульканiчныя
латерит	лятэрыт
Лебедь (созвездие)	Лебедзь
Лев, Большой Лев (созвездие зодиака)	Леў
Лев Малый (созвездие)	Леў Малы
лед каменный	лёд грунтавы
лед материковый	ледавiк контынэнтавы
ледник висячий	ледавiк навiслы або вiсячы
ледник долинный	ледавiк далiнавы
ледостав	зьледзяненьне
ледоход	ледаход
ледоход весенний	крыгi
ледоход осенний	сала
лед цветущий	лёд вырастаючы
Леониды или поток I ноябрьский (поток падающих звезд)	Леонiды або Струмень I лістападавы
лес высокоствольный	лес гонкi
лес девственный	лес нечапаны
лес ксерофильный	лес сухалюбны
лес лиственный	лес лiставы
лесоводство	лесагадоўля
лесонасаждение	лесазасеў
лес смешанный	лес мяшаны
лес тропический	лес мiжзваротнiкавы
лес хвойный	лес iгласты
лес экваториальный	лес раўнiковы
лёс или лёсс	лёэс
лёс или лёсс озерный	лёэс вазёрны
лёс или лёсс эоловый	лёэс ветравы
лето	лета
летосчисление	гадалiчэньне
лианы	лiяны
либрация луны	ваганьне або лiбрацыя месяца
ливень	улева, залева
Лидия (малая планета)	Лiдзiя
лиман	лiман
лимнология	лiмнолёгiя
линии визирные к звездам	лiнii вiзоўныя да зорак
линии горизонтальные	лiнii паземныя
линия береговая	лiнiя берагавая
линия демаркационная	лiнiя рубежная
линия железной дороги	лiнiя чыгункi
линия локсодромическая	лiнiя роўнакутасечная або лёксодромная
линия полуденная	лiнiя палудзённая
линия снеговая	мяжа сьнегавая
Лира (созвездие)	Лера
Лис или Лисица (созвездие)	Лiс
литосфера	лiтосфэра
лишайник	лiшай
ложбина	лагчына
ложе реки	(гл. русло реки)
лотлинь	глыбамер, лiн
луга альпийские	лугi альпiйскiя
луг болотный	луг балотны
луг заливной	луг залiўны, пойма
луг сухой	луг мурожны
луна	месяц
луна молодая или луна в первой четверти	маладзiк
луна новая	месяц новы
луна во второй четверти или полная	поўня, падпоўнае
луна в третьей четверти или ущербленная	сход
луна в четвертой четверти	вятох
лучи светил	праменьнi сьвяцiлаў
льдина	крыга
магма	магма
магнетизм земной	магнэтызм земны
магнит	магнэс
май	май або травень
Мария (малая планета)	Марыя
Маркаб (альфа Пегаса)	Маркаб
Марс	Марс
март	сакавiк або марац
марши	маршы
масса светила	маса сьвяцiла
массив	масыў
Мастерская ваятеля (созвездие)	Майстэрня Скульптара
масштаб	маштаб
материал взвешенный	муць
материал обломочный	матар'ял адломкавы
материал растворенный	матар'ял распушчаны
материк	(гл. континент)
Машина пневматическая или Насос воздушный (созвездие)	Помпа Паветраная
Машина типографская (созвездие)	Машына Друкарская
Машина электрическая (созвездие)	Машына Электрычная
маяк	маяк
маятник Фуко	хiстальнiк Фуко
мгла	iмгла
меандр	лука, зьвiлiна
Медведица Большая (созвездие)	Воз Вялiкi або Мядзьведзiха Вялiкая
Медведица Малая (созвездие)	Воз Малы або Мядзьведзiха Малая
Медуза (малая планета)	Мэдуза
междуречье	мiжарэчча
межень	межанiна
мезоцефалы	мэзоцэфалi, сярэднегаловы
мель	мель
мельница паровая	(гл. завод мукомольный)
мергель	маргель
мерзлота вечная	грунт вечнамёрзлы
меридиан	палудзеньнiк
меридиан земной	палудзеньнiк земны
меридиан магнитный	палудзеньнiк магнэсавы
меридиан международный	палудзеньнiк мiжнародны
меридиан начальный, нулевой	палудзеньнiк пачатковы, нулявы
меридиан небесный	палудзеньнiк нябесны
Меркурий	Мэркур
мерцание звезд	мiгаценьне зорак
местечко	мястэчка
местность	мясцовасьць
местность волнистая	мясцовасьць зыбiстая
местность гористая	мясцовасьць гарыстая
местность пересеченная	мясцовасьць пасечаная
местность равнинная	мясцовасьць раўнiнавая
местность холмистая	узгор'е, мясцовасьць узгаркаватая
месяц аномалистический	месяц аномалiстычны
месяцеслов	(гл. календарь)
месяц молодой	(гл. луна молодая)
месяц новый	(гл. луна новая)
месяц полный	(гл. луна полная)
месяц сидерический или звездный	месяц зоркавы або сiдэрычны
месяц синодический	месяц субежны або сынодычны
месяц тропический	месяц зваротнiкавы
месяцы года	месяцы году
метель	мяцелiца
метеор	мэтэор
метеорит	мэтэорыт
Метида (малая планета)	Мэтыда
метод синоптический	мэтод або спосаб сыноптычны
метод хорологический	мэтод, спосаб прасторавы
механика небесная	мэханiка нябесная
Меч-рыба (созвездие)	Рыба-меч
микроскоп	мiкроскоп
Мимас (спутник Сатурна)	Мiмас
минута	мiнута
мир	сьвет
мираж	марава, мiраж
Мирах (в созв. Андромеды)	Мiрах
мироздание	сьветабудова
мистраль	мiстраль
Мицар (озэта Малой медведицы)	Мiцар
мол	хваляспын, мол
молния	маланка
молния зигзагообразная	маланка зiгзагавая
молния плоскостная или расплывчатая	маланка плашчынёвая
молния шаровая	маланка клубкаватая
Мольберт Художника (созвездие)	Шталюгi Маляра
монархия конституционная	монархiя констытуцыйная, устаўная
монархия неограниченная	монархiя неабмяжованая
море	мора
море внутреннее	мора ўнутранае
море-залив	мора-затока
море окраинное	мора ўскрайнае
море открытое	мора адкрытае
море проходное	мора праходнае
море средиземное	мора мiжземнае
морена	морэна, навал ледавiковы
морена боковая	морэна бочная
морена конечная	морэна канцовая
морена основная, поддонная	морэна асноўная, падысподняя
морена срединная	морэна срэдняя
мороз	мароз
мост островов	мост астраўны
мофетты	мофэты, пячоры вуглядвутлёнiстыя
мощность отложений	тоўшча адкладаў
мульда	мульда, угiн
муры	муры
муссон	мусон
Муха (созвездие)	Муха
мыс	рог
наводнение	разводзьдзе
наволок	(гл. шариаж)
нагорье	сугор'е
нагорье глыбовое	сугор'е камлыгавае
нагорье остаточное	сугор'е рэшткавае
надир	надзiр
Наездник, Алькор	Язьдзец або Алькор
наклон	нахiл
наклонение или наклонность экватора к эклиптике	нахiленьне роўнiка да эклiптыкi
накопление моренное	натаўп морэнавы
намывание	намываньне
нанос	нанос
напластование	напластаньне
напластование несогласное	напластаньне нязгоднае
направление	кiрунак
напряжение радиальное	напружаньне прамянiстае
напряжение тангенциальное	напружаньне тангентальнае
наречие	падмова
народ	народ
народоведение	народазнаўства
народы бродячие	народы бадзяжныя
народы кочевые	народы вандроўныя
народы оседлые	народы аселыя
население	люднасьць, насяленьне, насельнiцтва
населенность	залюднёнасьць
Насос Воздушный	(гл. Машина Пневматическая)
наст	шарон
наступание моря на сушу	наступ мора на сухазем'е
национальность	нацыянальнасьць
нация	нацыя
начало реки	(гл. исток реки)
небо звездное	неба зоркавае
небосвод	небаскляпеньне
небосклон	небасхiл
неделя	тыдзень
недра земли	нетры зямлi
нектон	нэктон
Нептун	Нэптун
неравенства в движении планет вековые	няроўнасьцi ў руху плянэт векавыя
неравенства в движении планет периодические	няроўнасьцi ў руху плянэт пэрыодычныя
неравенства в движении планет случайные	няроўнасьцi ў руху плянэт выпадковыя
неравенство двухнедельное	няроўнасьць двухтыднёвая
неравенство суточное	няроўнасьць сутачная
неровность	няроўнасьць
низменность	нiзiна
низовье	нiзавiна
новолуние	маладзiк
номады	номады
ноябрь	лiстапад
нравы	норавы
нутация	(гл. колебание земной оси)
оазис	оаз
обвал	абвал, звал
обелиск (форма вершины)	востраслуп
Оберон (спутник урана)	Обэрон
облако	воблак
Облако Большое (созвездие)	Воблак Вялiкi
облако дождевое	хмара, воблак дажджавы
облако кучевое	воблак клубаваты
Облако Малое (созвездие)	Воблак Малы
облако перистое	воблак перкаваты
облако перисто-кучевое	воблак перкавата-кпубаваты
облако слоистое	воблак пластаваты
область	краiна
область актическая	схiл контынэнтавы, схiл падморскi
область бессточная	краiна бясстокавая
область ледникового выпахивания	край ледавiковага выворваньня
область моренного накопления	край морэнавага натаўпу
область необитаемая	краiна бязьлюдная
область опускания	краiна зьнiжэньня
область питания	краiна жыўленьня
область таяния	краiна раставаньня
облачность	хмарнасьць
обломок (горной породы)	адломак
обнажение	(гл. денудация)
оболочка водная	абалонка вадзяная
оболочка воздушная	абалонка паветраная
оболочка твердая	абалонка цьвёрдая
обработка	апрацоўка
обработка земли	выраб зямлi
образ жизни	спосаб жыцьця
образ жизни бродячий	спосаб жыцьця бадзяжны
образ жизни кочевой	спосаб жыцьця вандроўны
образ жизни оседлый	спосаб жыцьця аселы
обращение земли вокруг своей оси	абарот зямлi навокала сваёй восi
обращения планет вокруг солнца сидерические	абароты плянэт навокала сонца зоркавыя, сідэрычныя
обращения планет вокруг солнца синоптические	абароты плянэт навокала сонца субежныя, або сынодычныя
обращения планет вокруг солнца тропические	абароты плянэт навокала сонца зваротнікавыя
обрыв	зрыў, абрыў
обсерватория	обсэрваторыя, наглядальня
общество	грамадзянства
объемы планет	аб'ёмы плянэт
обычай	звычай
Овен (созвездие Зодиака)	Баран
овраг	раўчак, яр
овцеводство	гадоўля авечак
огородничество	гароднiцтва
озеро	возера
озеро каровое	возера каравае
озеро концевое, непроточное или устьевое	возера бясстокавае
озеро краевое	возера ўскрайнае
озеро кратерное	возера жараловае, кратэрнае
озеро плотинное	возера грэблевае
озеро проточное, речное	возера стокавае, рэчнае
озеро самосадочное	возера самасадкавае
озеро соленое	возера салонае
ойкумена	(гл. экумена)
окаменелость	скамянеласьць
океан	океан
океанология	океанолёгiя
окраина	ускраек
Октант (созвездие)	Октант
октанты луны	октанты месяца
октябрь	кастрычнiк
оледенение	зьледзяненьне
Олень Северный (созвездие)	Алень Паўночны
оползень	апоўзак
оппозиция светила с солнцем	процiстаяньне сьвяцiла з сонцам
опускание земной коры, оседание	зьнiжэньне земнай кары
орбиты светил	орбiты сьвяцiлаў
Орел (созвездие)	Арол
Орион (созвездие)	Орыон
орография	орографiя
орология	горазнаўства
орошение	абвадненьне
орошение искусственное	абвадненьне штучнае
орудия (бронзовые, каменные, железные, земледельческие)	прылады
осадки атмосферные	ападкi атмосфэрныя
оседлость	аселасьць
осень	восень
остров	востраў
остров вулканический	востраў вульканiчны
остров двойной	востраў падвойны
остров исконный	востраў спрадвечны
остров коралловый	востраў каралявы
остров материковый	востраў контынэнтавы
остров одиночный	востраў самотны, адзiнотны
остров плавучий	востраў плывучы
осыпь	асыпка
ось земная	вось земная
ось мира или ось небесная	вось сьвету
ось циклона	вось цыклёну
открытие	вынаходка
отечество, отчизна	бацькаўшчына, айчына
отклонение магнитной стрелки	адхiленьне магнэсавай стрэлкi
отклонение отвеса у гор или девиация	адхiленьне проставесу каля гор
откос	пакат
отлив	адплыў
отложения материковые	адклады сухаземныя
отложения ледниковые, моренные	адклады ледавiковыя, морэнавыя
отложения морские	адклады морскiя
отложения поверхностные	адклады павярхоўныя
отложения озерные	адклады вазёрныя
отложения речные	адклады рэчныя
отмель	(гл. мель) мялiзна
отпечаток	адбiтак
отрог горной цепи	адгор'е
отступание моря	адступ мора
оттепель	адлiга
отчленение	адлучэньне
Отшельник или Пустынник (созвездие)	Пустэльнiк
Офиух	(гл. Змееносец)
охота	паляўніцтва, паляваньне
очаг землетрясения	асяродак землетрасеньня
очаг лавы	гарно лявы
очертание	абрыс
Павлин (созвездие)	Пава
падение реки	спад ракi, нахiл ракi
палетка	сетачка памеравая
Паллада (малая планета)	Паляда
параллакс годичный звезд	паралякса гадавая зорак
параллакс горизонтальный светил	паралякса паземная сьвяцiлаў
параллели земные	роўналежнiкi земныя
параллели небесные	роўналежнiкi нябесныя
параллели суточные звезд	роўналежнiкi сутачныя зорак
пар	(гл. поле паровое)
пар водяной	пара вадзяная
пароход буксирный	параход-цягун
пароходство	параходзтва
Партенопа (малая планета)	Партэнопа
пассат	пасат
пастбище	паша
пахота	(гл. земля пахотная)
Пегас (созвездие)	Пэгас
пепел вулканический	попел вульканiчны
переброс	перакiд
перевал	перацяг
перегиб	перахiл
перегной	(гл. гумус)
перекат	перакат
перекресток дарог	раздарожжа, скрыжаваньне дарог
перенаселение	пералюдненьне
переселение	перасяленьне
пересыпь	(гл. коса)
перешеек	пярэсмык
перигей	прыземнiк, перыгей
перигелий	пэрыгель, прысонцавiк
период	пэрыод
Персеиды или Слезы св. Лаврентия (августовский или Лаврентьевский поток падающих звезд)	Пэрсэiды або Струмень зьнiчак жнiвеньскi
Персей (созвездие)	Пэрсэй
Пес Большой (созвездие)	Пёс Вялiкi
Пес Малый (созвездие)	Пёс Малы
песок вулканический	пясок вульканiчны
песок золотоносный	пясок золатародны
песок крупнозернистый	пясок буйны
песок летучий	пясок лёткi
песок мелкозернистый	пясок дробны
песчаник	пескавiк
петли планетных путей	петлi плянэтных шляхаў
Печь Химическая (созвездие)	Печка Хiмiчная
пещера	пячора
пирамида земляная	стажок земляны
план	плян
планетарий	плянэтар
планетоиды	(гл. астероиды)
планеты	плянэты
планеты большие	плянэты вялiкiя
планеты верхние	плянэты вышнiя
планеты внешние	плянэты знадворныя
планеты внутренние	плянэты ўнутраныя
планеты интермеркуриальные	плянэты дамэркуравыя
планеты малые	(гл. астероиды)
планеты нижние	плянэты нiжнiя
планктон	плянктон
плантация	плянтацыя
пласт земной коры	пласт земнай кары
плато	плято
племя	племя
Плеяды или Стожар (звездное скопление в созв. Тельца)	Плеяды або Стажар'е
плоскогорье	плоскаўзвышша
плоскошария	карта паўкуляў, плянiглёбы
плотина	грэбля
плотность земли	шчыльнасьць зямлi
плотность населения	(гл. густота населения)
площадка мелководная, шельф	мелкамор'е
площадь	плошча, пляц
площадь радиации	плошча праменяваньня
побережье	узьбярэжжа
поверхность	паверхня
погода	надвор'е
погода дождливая	надвор'е дажджыстае
погода пасмурная	надвор'е хмарнае
погода переменчивая	надвор'е зьменнае
погода хорошая, ведро	надвор'е яснае, пагода
пограничный	паўзьмежны
подножие горы	падгор'е
поднятие суши	узьняцьце сухазем'я
подошва горы	падстава гары
подпочва	падглеб'е, грунт
подтропический	падзваротнiкавы
покров ледяной	насьцiл лёдавы
покров снежный	насьцiл сьнегавы
покров растительный	шата расьлiнная
покрытие звезд луною	засланеньне зорак месяцам
полдень	палудзень
поле ледяное	поле лёдавае
поле паровое, пар	папар
поле фирновое	поле зерналёдавае
полеводство	ральнiцтва
полировка ледниковое	палiраваньне ледавiковае
Поллукс (бэта Близнецов)	Полюкс
полнолуние	поўня
полночь	поўнач, палунач
половодье	паводка
положение астрономическое	палажэньне астрономiчнае
положение географическое	палажэньне географiчнае
положение уединенное	палажэньне самотнае
полуостров	паўвостраў
полуостров комбинированный	паўвостраў зьмяшаны
полуостров отчлененный	паўвостраў адлучаны
полуостров причлененный	паўвостраў прылучаны
полушарие	паўкуля, паўкульле
полынья	процеч
полюс	полюс, канцавосьсе
Полюс Антарктический или южный	канцавосьсе паўднёвае
Полюс Арктический или северный	канцавосьсе паўночнае
полюсы мира или небесные полюсы	канцавосьсi нябесныя або сьвету
полярный	полярны, канцавосны, падканцавосны
помоха	смуга
понедельник	панядзелак
понижение видимого горизонта	панiжэньне пазему
порог	парог
порода	парода, гатунак
порода вулканическая	парода вульканiчная
порода горная	парода земная
порода изверженная	парода выбуховая
порода кристалличеекая	парода крышталёвая
порода массивная	парода масыўная
порода осадочная, слоистая	парода пластовая
поророка	поророка
порт	прыстань, порт
поры солнечной поверхности	сiтавiны сонцавай паверхнi
посад	пасад
поселение	паселiшча
Посох Иакова	(гл. Пояс Ориона)
поток	струмень
поток августовский или Лаврентьевский	(гл. персеиды)
поток ноябрьский	(гл. леониды)
поток падающих звезд	струмень зьнiчак або струмень зорак падучых
потухание звезд	згасаньне зорак
почва	грунт, глеба
почва аллювиальная	грунт нанесены
почва бурая	глеба бурая
почва дерново-подзолистая	глеба дзярнова-падзольная
почва каштановая	глеба каштанавая
почва пористая	глеба сiткаватая
почва рыхлая	глеба пухкая
почва солончаковая	саланчак
почва черноземная, чернозем	чарназем
почва элювиальная	грунт мясцовы
почти-равнина	амаль-раўнiна
Пояс Зодиака	Пас Зодыяку
пояс излома	пас разлому
пояс климатический	пас клiматычны
пояс Ориона или Жезл Иакова (в созв. Ориона)	Тры Каралi
пояс растительный	пас расьлiнны
предварение равноденствий	папярэджаньне роўнадзеньняў
предгорье	прыгор'е
предел атмосферы абсолютный	гранiца атмосфэры абсолютная, безадносная
предел атмосферы физический	гранiца атмосфэры фiзычная
прецессия	прэцэсiя
прибой волн	напад хваляў, хваляваньне паўзьбярэжнае
приведение к уровню моря	дапасаваньне да роўня мора
прилив	прыплыў
прирост населения действительный	прырост насяленьня запраўдны
прирост населения естественный	прырост насяленьня натуральны
пристань	прыстань
приток	прытока
притяжение взаимное небесных тел	прыцяганьне ўзаемнае нябесных цел
притяжение земное	прыцяганьне земнае, прыцяг земны
провал	правальле
проекция горизонтальная	проэкцыя паземная
проекция коническая	проэкцыя стажковая
проекция меркаторская	проэкцыя мэркатарская
проекция ортографическая или перпендикулярная	проэкцыя простарысоўная або ортографічная
проекция полярная	проэкцыя канцавосная
проекция стереографическая	проэкцыя стэрэографiчная
проекция цилиндрическая	проэкцыя вальцовая, цылiндрычная
производительность	продукцыйнасьць
производство	продукцыя
Прокион	(гл. Процион)
пролив	пратока
промысел гончарный	промысел ганчарны
промысел извозный	промысел возны
промысел лесной	промысел лясны
промысел отхожий	промысел адходны
промыслы сельские	промыслы вясковыя
промышленность горная	прамысловасьць нетракапальная
промышленность горнозаводская	прамысловасьць гiсэрневая
промышленность добывающая	прамысловасьць здабывальная
промышленность домашняя	прамысловасьць хатняя
промышленность кустарная	прамысловасьць саматужная
промышленность обрабатывающая	прамысловасьць апрацоўчая
промышленность фабрично-заводская	прамысловасьць фабрычная
проницаемость породы	прапушчальнасьць пароды
простирание пластов	працяжнасьць пластоў
пространство	прастора
пространство мировое или небесное	прастора сусьветная, нябесная
противостояния луны с солнцем	процiстаяньнi месяца з сонцам
противотечение экваториальное	цячэньне морскае раўнiковае супрацiўнае
проток	пратока
протуберанцы	(гл. выступы солнечные)
профиль местности	перарэз, профiль мясцовасьцi
проход горный	праход горны
процесс геологический	процэс геолёгiчны
Процион (альфа Малого Пса)	Процыён
пруд	саджалка
психрометр	псыхромэтр
Птица Райская (созвездие)	Птушка Райская
пустошь	пустка
Пустынник	(гл. Отшельник)
пустыня	пустыня
путешествие	падарожжа
пути сообщения	дарогi, шляхi комунiкацыi
путь	шлях
Путь Млечный	Шлях Млечны, Дарога Птушыная
пучина	прорва
Пчела (созвездие)	Пчала
пчеловодство	пчалярства
пыль	пыл
пятна солнечные	плямы сонцавыя
пятна туманные	плямы туманныя
пятница	пятнiца
равнина	раўнiна
равноденствие весеннее	роўнадзеньне веснавое
равноденствие осеннее	роўнадзеньне восеннае
радиант	праменьнiк, радыянт
радиация	праменяваньне, радыяцыя
радиус земли	прамень зямлі
радиусы-векторы планет	радыусы-вэктары плянэт
радуга	вясёлка
разлив реки	(гл. половодие)
размывание	размываньне
разрушение горных пород	распад земных парод
Рак (созвездие)	Рак
раковина	чарапашына
Рас Альгети (альфа Геркулеса)	Рас Альгеты
раса	раса, парода
распределение	разьмеркаваньне
распространение географическое	разьмяшчэньне географiчнае
рассвет	сьвiтаньне
расстояние	адлегласьць
растения вьющиеся	расьлiны ўюнцовыя
растения технические	расьлiны тэхнiчныя
растительность	расьлiннасьць
расчленение суши	расчляненьне сухазем'я
расчленение суши вертикальное	расчляненьне сухазем'я старчавое
расчленение суши горизонталькое	расчляненьне сухазем'я паземнае
регрессия	(гл. отступание моря)
Регул или Сердце Львиное (альфа Большого Льва)	Рэгул або Сэрца Львiнае
резиденция	гаспода
река главная	рака галоўная
река исчезающая	рака зьнiкаючая
река порожистая	рака парогавая
река сплавная	рака сплаўная
река судоходная	рака суднаходная
религия	рэлiгiя
рельеф	рэльеф
рельеф барический	рэльеф цiскавы
ремесло	рамясло
республика	рэспублiка, Рэч Паспалiтая
республика демократическая	рэспублiка дэмократычная
республика социалистическая	рэспублiка соцыялiстычная
республика федеративная	рэспублiка фэдэрацыйная
рефлектор	рэфлектар, адбiвальнік
рефрактор	рэфрактар
рефракция	пераламленьне, рэфракцыя
Рея (спутник Сатурна)	Рэя
Ригель (бэта Ориона)	Рыгель
риф барьерный	рыф застаўны
риф береговой	рыф паўзьбярэжны
риф коралловый	рыф каралявы
риф кольцевой	рыф персьцянёвы
риф коровой, панцирный	рыф панцырны
родина	радзiма
родиноведение	радзiмазнаўства
рождаемость	нараджальнасьць
Роза (малая планета)	Рожа
роса	раса
россыпь золотая	пяскi золатародныя
рост	уросласьць, узрастаньне, рост
рубка леса	валка лесу
руда	руда
рудник	рудня
рукав реки	адтока, рамя ракi
русло реки	рэчышча
русло старое	старарэчча
ручей	ручай
Рыба Летучая (созвездие)	Рыба Лятучая
Рыба Южная (созвездие)	Рыба Паўднёвая
рыбоводство	гадоўля рыбы
рыболовство	рыбацтва
Рыбы (созвездие Зодиака)	Рыбы
рынок мировой	рынак сусьветны
Рысь (созвездие)	Рысь
рябь	рабiзна
садоводство	садоўнiцтва
сальзы	сальзы, крынiцы гразявыя халодныя
самородок	самародак
самум	самум
санаторий	здароўнiца
Сатурн	Сатурн
сброс	скiд
сброс котлообразный	скiд катлiнавы
сброс ступенчатый	скiд прыступкавы
свет зодиакальный	сьвятло зодыякальнае
светило	сьвяцiла
свет пепельный луны	сьвятло попелавае месяца
свод небесный	(гл. небосвод)
своды пещеры	скляпеньне пячоры
сгущение пара, конденсация пара	згушчэньне пары
сдвиг	зрушша
сдувание	здмуханьне
север	поўнач
северо-восток	паўночны-ўсход
северо-запад	паўночны-захад
седла	(гл. антиклинали)
сейсмограф	сэйсмограф
сейсмология	сэйсмолёгiя
сейсмометр	сэйсмомэтр
сейша	(гл. волна стоячая)
секстант	сэкстант, шасьцёрнiк
Секстант (созвездие)	Сэкстант
секунда	сэкунда
селение	селiшча
селенография	сэленографiя
сентябрь	верасень
Сердце Карла II	Сэрца Кароля II
Сердце Львиное	(гл. Регул)
серир	сэрыр, пустыня крамняватая
серп луны	серп месяца
сеть градусная	сетка градусная
сеть железнодорожная	сетка чыгункавая
Сеть Ромбоидальная (созвездие)	Сетка Ромбоідальная
сжатие земли	сьцiснутасьць зямлi
сизигии луны	сізыгii месяца
сила центробежная	сiла адасяродкавая
сила тяготения	сiла цяжэньня
силы экзогенные	сiлы знадворныя
силы эндогенные	сiлы нутраземныя
синклиналь	сынклiналь, угiн
Сириус (альфа Большого Пса)	Сiрыус
сирокко	сiроко
система горная	уклад горны
система земледелия	спосаб земляробства
система земледелия залежная	спосаб земляробства дзiрванны або аблогавы
система земледелия лядинная или подсечная	спосаб земляробства лядавы
система земледелия многопольная	шматпалёўка
система земледелия трехпольная	трохпалёўка
система речная	уклад ракi
система солнечная	уклад сонцавы
системы звездные	уклады зоркавыя
системы планетные	уклады плянэтныя
сияние полярное	зьзяньне канцавоснае
сияние полярное лентообразное	зьзяньне канцавоснае стужкаватае
сияние полярное лучистое	зьзяньне канцавоснае прамянiстае
скала	скала
скалы сглаженные	скалы згладжаныя
скважина буровая	шчылiна сьвiдраваная
Скипетр Бранденбургский (созвездие)	Скiпэтр Брандэнбурскі
складка веерообразная	зморшч прамянiсты
складка косая	зморшч ускосны, косы
складка лежащая	зморшч ляжачы
складка переброшенная	зморшч перакiнуты
складка прямая	зморшч просты
складки дугообразные	зморшчы дугавыя
складки прямолинейные	зморшчы просталiнейныя
склонение светил	схiленьне сьвяцiл
склон	схiл, спад
склон крутой	схiл стромкi
склон материковый	(гл. область актическая)
склон обрывистый	схiл зрывісты
склон отлогий	схiл адхонны
скопления звездные	скупнасьцi зорак
Скорпион (созвездие зодиака)	Скорпiён
скот мелкий	скацiна дробная
скот племенной	скацiна заводная
скот породистый	скацiна заводзкая
скот рогатый	быдла
скотоводство	гадоўля жывёлы
Слезы св. Лаврентия	(гл. Персенды)
сланец	лупняк
слияние рек	сутока
слой водонепроницаемый	пласт, непрапушчаючы вады
слой водоносный	пласт, зьмяшчаючы ваду
слой водопроницаемый	пласт, прапушчаючы ваду
слоистость	пластаватасьць
слюда	лушчак
смерзание	зьмярзаньне
смертность	сьмяротнасьць
смерч	вiхраслуп
смещения параллактические звезд	збачэньнi, зьмяшчэньнi параляктычныя зорак
снег вечный	сьнег вечны
снег кающийся	сьнег пакутуючых
Собаки Гончие или Собаки Охотничьи (созвездие)	Ганчакi
соединение верхнее	злучэньне вышняе
соединение нижнее	злучэньне нiжняе
созвездие	сузор'е
созвездия зодиакальные	сузор'i  зодыякальныя
созвездия околополярные	сузор'i прыканцавосныя, каляполярныя
созвездия экваториальные	сузор'i раўнiковыя
соленость морской воды	салонасьць морскай вады
солнце	сонца
солнцестояние зимнее	сонцаварот зiмовы
солнцестояние летнее	сонцаварот летнi
солончак	(гл. почва солончаковая)
соль выварочная	соль выварная
соль каменная	соль каменная
соль поваренная	соль кухенная
соль самосадочная	соль самасадка
сольфатара	сольфатара
сообщение железнодорожное	зносiны чыгункавыя
сообщение пароходное	зносiны параходныя
сообщество растительное	згуртаваньне расьлiннае
спектр газовый	спэктр газавы
спектр линейный, линейчатый	спэктр лiнейны
спектр непрерывный, сплошной	спэктр неперарыўны
спектр поглощения	спэктр паглытаньня
спектроскоп	спэктроскоп
Спика	(гл. Колос)
сплав леса	сплаў лесу
спутник планеты	спадарожнiк плянэты
среда	серада
средства сношений	спосабы зносiн
сталагмит	накапак
сталактит	нацёк
станция	станцыя
стеатопигия	стэатопiгiя
степи сухие	стэпы сухiя
степь	стэп
стиль новый или грегорианский	стыль новы або грыгорыянскi
стиль старый или юлианский	стыль стары або юлiянскi
стирание	(гл. корразия)
сток	сток
Стожар	(гл. Плеяды)
стоянка	стаянка
стражник (созвездие)	Вартаўнiк Палеткаў
страна	старана
страна столовая	раўнiна спрадвечная
страны света, горизонта	бакi кругавiду
стратовулкан	вулькан пластаваты
стрежень	стрыжань
Стрела (созвездие)	Страла
Стрелец (созвездие зодиака)	Стралец
стрелка магнитная	стрэлка магнэсавая
стремнина	страмнiна
строй государственный	лад дзяржаўны
ступень	ступень, прыступка
ступень актическая	(гл. область актическая)
ступень барометрическая	ступень баромэтрычная
ступень геотермическая	ступень цеплаземная, геотэрмiчная
субарктический	падпаўночны
суббота	субота
субтропический	(гл. подтропический)
суглинок	суглiнак
сугробы снега	гурбы сьнегу
суда парусные	судны жаглёвыя
суда плоскодонные	судны плоскадонныя
судоходство	суднаходзтва
султанат	султанат
сумерки вечерние	змрокi, зьмярканьне
сумерки утренние	сьвiтаньне
супесь, супесок	супясок
сутки астрономические	суткi астрономiчныя
сутки гражданские	суткi грамадзянскiя
сутки звездные	суткi зоркавыя
сутки истинные	суткi запраўдныя
сутки солнечные	суткi сонцавыя
сутки средние	суткi сярэднiя
суша	сухазем'е
сфера небесная	сфэра нябесная
сфероид земной	кулявiд, сфэроiд земны
сфероидальность земной поверхности	сфэроiдальнасьць земнай паверхнi
сэтэры	сэтэры
тайга	тайга
тайфун	тайфун
тальвег	тальвэг
таможня	мытнiца
татуировка	татуiраваньне
таяние	раставаньне
тектоника	тэктонiка
тела космические или небесные	целы нябесныя
телескоп	тэлескоп
Телескоп Гершеля (созвездие)	Тэлескоп Гершэля
Телец (созвездие Зодиака)	Бык
Телец Понятовского (созвездие)	Бык Панятоўскага
теллурий	тэлюр
теодолит	тэодолiт
теплота лучистая	цяплыня прамянiстая
термометр	тэрмомэтр
терраса	тэраса, прыступка
террасы выветривания	прыступкi выпятрэньня
террасы морские	прыступкi морскiя
террасы речные	прыступкi рэчныя
течение	плынь, бег, цячэньне
течение морское	плынь, бег, цячэньне морскае
течение морское свободное	плынь, бег, цячэньне морскае вольнае
течение морское вынужденное	плынь, бег, цячэньне морскае прымушанае
течение морское отраженное	плынь, бег, цячэньне морскае адбiтае
течение морское теплое	плынь, бег, цячэньне морскае цёплае
течение морское холодное	плынь, бег, цячэньне морскае халоднае
течение морское экваториальное	плынь, бег, цячэньне морскае раўнiковае
течение реки верхнее	бег ракi верхнi
течение реки нижнее	бег ракi нiжнi
течение реки среднее	бег ракi сярэднi
Титан (спутник Сатурна)	Тытан
Титания (спутник Урана)	Тытанiя
товарообмен	таварамен
топография	топографiя
торговля внешняя	гандаль замежны
торговля внутренняя	гандаль унутраны
торговля временная	гандаль тымчасовы
торговля постоянная	гандаль сталы
торговля ярмарочная	гандаль кiрмашовы
торнадо	торнадо
торосы	лёдаўзгоркi, торосы
торф	торф
торфяник	тарфавiшча
точки равноденствий	пункты роўнадзеньняў
точки солнцестояний	пункты сонцаваротаў
точки востока, запада, севера, юга	пункты ўсходу, захаду, поўначы, поўдня
травы кормовые	травы кармовыя
траектории движений светил	траэкторыi рухаў сьвяцiлаў
трансгрессия	(гл. наступание моря)
Треугольник (созвездие)	Трыкутнiк
Треугольник Малый (созвездие)	Трыкутнiк Малы
Треугольник Южный (созвездие)	Трыкутнiк Паўднёвы
трехполье	(гл. система земледелия трехпольная)
трещина земной коры	шчылiна земнай кары
триангуляция	трыкутнiкаваньне, трыангуляцыя
тропик Козерога	зваротнiк паўднёвы
тропик Рака	зваротнiк паўночны
тростник сахарный	трысьцiна цукровая
Труба Зрительная или Труба Подзорная (созвездие)	Труба Астрономiчная
труба полуденная	труба палудзеньнiкавая
трубы зрительные или трубы подзорные	трубы празорныя
трясина	дрыгва
туземец	тубылец
Тукан (созвездие)	Тукан
туман	туман
туманности газообразные	туманнасьцi газавiдныя
туманности звездные	туманнасьцi зоркавыя
туманности кольцевые	туманнасьцi персьцянёвыя
туманности спиральные	туманнасьцi сьпiральныя
туманности шаровые	туманнасьцi кулiстыя
туманности эллиптические	туманнасьцi элiптычныя
тундра	тундра
тундра бугристая	тундра грудаватая
туннель	тунэль
туф вулканический	туф вульканiчны
туф известковый	туф вапнавы
туча	хмара
тяготение	цяжэньне
убыль населения	зьмяншэньне люднасьцi
увал	грудавiна
увлажнение	абвiльгаценьне
Угломер или Линейка (созвездие)	Кутамер i Лінейка
угол часовой	кут гадзiнавы
уголь белый	вугаль белы
уголь бурый	вугаль буры
уголь древесный	вугаль дрэўны
уголь каменный	вугаль каменны
Удивительная (созвездие Кита)	Дзiўная
удобрение	(материал) гной; (процесс) угнаеньне
узел восходящий	вузел усходзячы
узел нисходящий	вузел спадаючы
узлы планетных путей	вузлы плянэтных шляхаў
уклон дна	нахiл дна
Умбриель (спутник Урана)	Умбрыэль
уравнение времени	раўнаньне часу
уравнение центра	раўнаньне асяродку
ураган	гураган
Уран	Уран
уровень (прибор)	ровень (прылада)
уровень моря	ровень мора
усадьба	сядзiба
уступ	прыступка
устье	вусьце
утварь	спрат
утро	ранiца
ущелье	цясьнiна
ущерб диска планеты	ушчэрбак дыску плянэты
ущерб диска луны	убываньне месяца
фабрика	фабрыка
фабрика писчебумажная	паперня
фазы луны	фазы, адмены месяца
факелы солнечные	паходнi сонцавыя
фарватер	фарватэр
фауна	фаўна, жывёльнасьць
фауна абиссальная	жывёльнасьць глыбокаморская
фауна литоральная	жывёльнасьць паўзьбярэжная
фауна пелагическая	жывёльнасьць пэлягiчная адкрытаморская
фауна придонная	жывёльнасьць паўздонная
фауна реликтовая	жывёльнасьць астачная, рэшткавая
февраль	люты
фён	фёэн
Феникс (созвездие)	Фэнiкс
фёрд	фёрд
ферма	фэрма
Фетида (спутник Сатурна)	Тэтыс
фиорд	фiорд
фирн	зерналёд, фiрн
флексура	згiбiна
флора	флёра, расьлiннасьць
Флора (малая планета)	Флёра
флора альпийская	расьлiннасьць альпiйская
флот	флёт
флюгер	бандзера
Фобос (спутник Марса)	Страх, Фобос
фокусы планетных орбит	фокусы, вогнiшчы плянэтных орбіт
Фомальгаут (альфа Южной Рыбы)	Фомальгаут
формация	формацыя
формы поверхности	формы паверхнi
фотосфера солнца	фотосфэра сонца
фумарола	дымнiца, фумароля
футшток	футшток
фьерд	ф'ёрд
Хамелеон (созвездие)	Хамэлеон
хвосты комет	хвасты комэт
хлебопашество	хлебаробства
хозяйство	гаспадарка
холм	узгорак
хребет горный	сьцяг горны
хромосфера солнца	хромосфэра сонца
хронометры	часамеры, хрономэтры
цвет (морской воды, неба)	колер (морскай вады, неба)
Центавр	(гл. Кентавр)
центр распространения	асяродак пашырэньня
цепь горная	ланцуг горны
цепь островов	ланцуг астраўны
Цербер	(гл. Кербер)
Церера (малая планета)	Цэрэра
Цефей (созвездие)	Цэфэй
цивилизация	цывiлiзацыя
цикл лунный	цыкль месяцавы, круг месяцавы
цикл Метонов	цыкль Мэтона, круг Мэтона
циклон	цыклён
цирки лунные	цыркi месяцавыя
Циркуль (созвездие)	Цыркуль
час прикладной	гадзiна прыкладная
часть света	частка сьвету
Часы с Маятником (созвездие)	Гадзiньнiк з Хістальнiкам
часы солнечные	гадзiньнiк сонцавы
Чаша	(гл. Кубок)
человечество	людзтва
чернозем обыкновенный	чарназем звычайны
чернозем северный	чарназем паўночны
чернозем тучный	чарназем тлусты
чернозем шоколадный	чарназем чакалядавы
Честь Фридрихова (созвездие)	Гонар Фрыдарыка
четверг	чацьвер
четверть луны первая	квадра месяца першая
четверть луны вторая	квадра месяца другая
четверть луны третья	квадра месяца трэцяя
четверть луны четвертая или последняя	квадра месяца чацьвёртая
чум	чум
шагомер	крокамер
Шар Воздушный (Баллон, созвездие)	Бальлён паветраны
шар земной	куля земная
шариаж	навалок
шаровидность или шарообразность земли	кулiстасьць зямлi
шахта	шахта
шелководство	шаўкоўнiцтва
шельф	(гл. площадка мелководная)
широты астрономические	шырынi астрономiчныя
широты гелиоцентрические	шыроты гелiоцэнтрычныя
широты географические	шыроты географiчныя
широты геоцентрические	шыроты геоцэнтрычныя
шлюз	застаўка, шлюз
шпиль (форма вершины)	шпіль
шоссе	шаса, саша
шраты	(гл. карры)
штиль	зацiшша
штольня	штольня
штранд	штранд
шхеры	шхэры
Щит Собеского (созвездие)	Шчыт Сабескага
щебень	груз
эвекция в движении луны	эвэкцыя ў руху месяца
эворзия	эворзiя
экватор земной	роўнiк земны
экватор небесный	роўнiк нябесны
экваториал	экваторыял
экзарация	экзарацыя
эклиптика	эклiптыка
экспорт	вываз, экспорт
эксцентриситеты орбит	эксцэнтрысiтэты або мiмасяроднiк орбiт
эксцентричность орбит	эксцэнтрычнасьць або мiмасяроднасьць орбiт
экумена	ойкумэна
эмиграция	высяленьне, эмiграцыя
эндемизм	эндэмiзм
Энцелад (спутник Сатурна)	Энцэляд
эпакта луны	эпакта месяца
эпицентр	надасяродак
эпициклы	надакружыны, эпiцыклi
эра (геол.)	эра
эра в летосчислении	эра ў годалiчэньнi
Эридан или Река Эридан (созвездие)	Эрыдан
эрозия	эрозiя, выяданьне
эрозия боковая	эрозiя бочная, выяданьне бочнае
эрозия глубинная	эрозiя глыбiнёвая, выяданьне глыбiнёвае
Эрос, Эрот (малая планета)	Эрос
эстуарий	вусьце лейкаватае
этаж	(гл. ярус)
эфемериды планет	эфэмэрыды плянэт
эфир космический или эфир мирового пространства	этар косьмiчны або этар сусьветнай прасторы
Эхо (малая планета)	Эхо
юг	поўдзень
юго-восток	паўднёвы-ўсход
юго-запад	паўднёвы-захад
южный	паўднёвы
Юлия (малая планета)	Юлiя
Юнона	Юнона
Юпитер	Юпітар
юрта	юрта
явления карстовые	зьявы карставыя
явления космические или небесные	зьявы косьмiчныя або нябесныя
ядра комет	ядры комэт
ядро земли	ядро зямлi
язычество	паганства
январь	студзень
Япет (спутник Сатурна)	Япэт
яркость звезд	яскравасьць зорак
ярмарка	кiрмаш
ярус (геол.)	паверх
Ясли (звездное скопление в созвездии Рака)	Ясьлi
Ящерица (созвездие)	Яшчарка
