##Title: Слоўнік лясных тэрмінаў (БНТ)
##HTMLDescription_BEGIN
<div>
	<p class="dictdesc-st">Створана на падставе:</p>
	<p><b>Музычныя тэрміны</b>. Менск: Інбелкульт, 1926.</p>
</div>
<div>
	<p class="spoiler">Прадмова</p>
	<p>Пры складаньні слоўніку лясных тэрмінаў мелі на ўвазе дапамагчы лясным спэцыялістым пры пераходзе іх на беларускую мову, з прычыны чаго ў слоўніку сабраны тэрміны, якія ўжываюцца як у васобных галінах лясное навукі, так і ў канцэлярыі лясьніцтва.</p>
	<p>Слоўнік складаецца з дзьвюх частак: першая – гэта расійска-беларускі слоўнік; другая − альфабэтны сьпіс беларускіх тэрмінаў.</p>
	<p>Слоўнік складзены Тэрмінолёгічнай Камісіяй Лясное Падсэкцыі Інстытуту Беларускае Культуры, у якой працавалі члены Падсэкцыі <i>Язэп Троська, Якуб Шамоль, Амбр. Хацяновіч, Ч. Бялюнас і П. Санько</i>. Большасць тэрмінаў узята з проекту лясной тэрмінолёгіі, які быў зложаны Яз. Троськам, прыняты Камісіяй за аснову. Канчальная рэдакцыя слоўніку зацьверджана Правапісна-Тэрмінолёгічнай Камісіяй Інстытуту Беларускае Культуры.</p>
	<p>З прычыны таго, што пры ўкладаньні гэтага слоўніку нельга было шырака выкарыстаць народныя назовы, слоўнік выдаецца ў дыскусійным парадку.</p>
	<p>Апроч таго, Лясная Падсэкцыя, а таксама Навуковае Таварыства ў Горках па вывучэньні Беларусі, якое працуе на правох сэкцыі Інстытуту Беларускае Культуры, распачалі працу зьбіраньня матар’ялу для поўнай навуковай беларускай лясной тэрмінолёгіі, кіруючыся складзенай для гэтых мэтаў інструкцыяй.</p>
	<p>Падсэкцыя лічыць вельмі патрэбнай далейшую праверку зьмешчаных у слоўніку тэрмінаў, на падставе матар'ялу і народнае мовы і прасіць лясных спэцыялістых сваім удзелам дапамагчы ў зьбіраньні патрэбнага матар’ялу.</p>
	<p> </p>
	<p>Менск, май 1926.</p>
</div>
##HTMLDescription_END
##ArticleLang: ru/be

абрикос — Armeniaca vulgaris lam	абрыкос, морэля
абрис	абрыс, абводак
абсолютная одновозрастность	абсолютная аднаўзроснасьць
абсолютная разновозрастность	абсолютная рознаўзроснасьць
австрийская камеральная такса	аўстрыйская камэральная такса
австрийская сосна — Pinus austriaca hoss	аўстрыйская хвоя
административная единица	адміністрацыйная адзінка
административное деление	адміністрацыйны падзел
администрация лесная	адміністрацыя лясная
азимут истинный	азімут запраўдны
азимут магнитный	азімут магнэсавы
айлант — Ailanthus glandulosa dest	айлянт
академия лесная	акадэмія лясная
акация белая, американская, душистая — Robinia pseudoacacia L.	робінія, белая акацыя
акация желтая, сибирская — Caragana arborescens Lam	карагана, жоўтая акацыя
акклиматизация растений	акліматызацыя расьлін
акт о лесонарушении	акт аб лесапарушэньні
акт свидетельства	акт пасьведчаньня
амбар	сьвіран
анализ ствола	аналіз ствала
анкета	анкета, пытальнік
аноним	анонім, бязіменьнік
аппарат	апарат
арендная плата	арэндная плата, чынш
арест	арышт
артель лесная	арцель лясная
аршинник (сортим.)	аршыновік
ассигновка	асыгноўка
ассистент	асыстэнт
астролябия	астролябія
атаман дубовик (лоцман.)	дубовік
атлас	атляс
аттестат	атэстат
бабочка — Lepidoptera	матыль, мятлік, матылёк
баварские таблицы	баварскія табліцы
багульник — Ledum palustre L.	багун
баклага	біклага
бактерии клубеньковые	корнябародаўкавыя бактэрыі
балка (сортим.)	бэлька, балька
балка бельская круглая	бэлька бельская круглая
балка рыжская	бэлька рыская
балка французская	бэлька француская
барабан для сушки шишек	барабан на сушэньня шышак
барабан сеяльный	барабан для сяўбы
барбарис — Berberis vulgaris	барбарыс
баржа	віціна, бярліна
барка	лайба, дуб
барсук — Meles Taxus Pall.	барсук
бархатное дерево — Philodendron amurensis Rupr.	аксамітнае дрэва
барыш предпринимателя	зыск прадпрыемцы
безвершинники	безьверхавіньнікі
безвершинное хозяйство	безьверхавінная гаспадарка
бессучковый лес (техн.)	бяссучковы лес
бесхозяйственный	негаспадарны
бекас — Scolopax gallinago Briss.	бакас, чэпік, пякур
белая гниль луба от гриба — Polyporus sulfureus	белая гніліна дубу
белка — Sciurus vulgaris L.	вавёрка, белка
беломошник	беламшэньнік
белотал	гл. ива
белоус — Nardus stricta L.	сівец
береза бородавчатая — Betula verrucosa ehr.	гузаватая бяроза
береза карликовая — Betula humilis schrk.	ніцая бяроза
береза корельская — Var. Betula pubescens	чачоткавая бяроза
береза пушистая — Betula pubescens	бяроза пухнатая
березовый заболонник — Eccoptogaster Ratzeburgil Sans)	бярозавы сколіт
березовый лес	бярэзьнік
березовый кап	япа, нарасьць бярозавая
березовый сок	бярозавік, бярозавы сок
березовый трутовик — Pоlуporus betulinus	бярозавы трут
бересклет бородавчатый — Evonymus verrucosus Scop.	брызьліна гузаватая
бересклет европейский — Evonymus Europaeus L.	эўропейская брызьліна
берест — Ulmus suberosa Ehrh. L.	бераст
береста	бяроста
бесплатно	дарма
билет лесорубочный	білет лесасечны
билет на пастьбу скота	білет на пашу жывёлы
бирючина — Ligustrum vulgare L.	біручына
бобр — Castor fiber L.	бабёр
болванка	балванка
болото моховое	балота мохавае, імшара, імшарына
болото непроходимое	немерач
болото с зарослью березы	бель
болото с зарослью ольхи	алёс
болото топкое	дрыгва
больное дерево	хворае дрэва
большой еловый короед, типограф — Ips typographus L.	вялікі яловы караед, друкар
большой ильмовый заболонник — Scolitus destructor Ol.	лёмавы сколіт
большой сосновый долгоносик, слоник — Hylobius abietis L.	вялікі хваёвы доўганосік, слонік
большой сосновый короед, стенограф — Ips stenographus, Ips sexdentatus	вялікі хваёвы караед, шасьцізубчаты
большой сосновый лубоед — Blastopliagus (Myelophilus) piniperda L.	вялікі хваёвы лубаед
бондарка (клёпка)	бандарка
бондарные изделия	бандарныя вырабы
бондарное производство	бандарная вытворчасьць
бонитет	бонітэт
бонитирование	бонітаваньне
бор	бор
бордосская жидкость	бардоская вадкасьць
бороздник	баразёньнік
борона лесная	барана лясная
бортневое пчеловодство	барцёвае пчалярства
бортник	бортнік
борьба с вредителями	зьнішчэньне шкоднікаў, змаганьне са шкоднікамі
бочевка (сортим.)	бачкоўка
боярышник обыкновенный — Crataegus oxacanta L.	глог калючы
браковка леса	бракоўка лесу
браконьер	самапраўны паляўнічы, браконьер
бревно	бервяно, калода
бревно нижнего венца в постройке	падруба
бредина	гл. ива
брикет древесный	цагліна дрэўная
брикет торфяной	цагліна тарфовая
брус восьмигранный	брус васьмікантовік
брус квадратный	брус квадратовы
брус косяковый	шула
брус кубичный	брус кубічны
брус мемельский	брус мэмэльскі
брус обзольный	брус абзаваты
брус острокантный	брус кантовік
брус подвальный	брус падрубавы
брус рамочный	брус білавы
брус стропильный	кроква
брус трехгранный	брус трохкантовік
брусника — Yaccinium vitis Idaea L.	брусьніца
буерак	роў
бузина красная — Sambucus racemosa L.	бузіна чырвоная
бузина черная — Sambucus nigra L.	бузіна чорная
бук — Fagus silvatica L.	бук
бунт (техн.)	бунт
бумажный завод	паперня
бумажное производство	папяровая вытворчасьць
бурав Бирмана	сьвердзел Бірмана
бурав Пресслера	сьвердзел Прэсьлера
бурав сажальный	сьвердзел саджальны
бурелом	буралом
буссоль	бусоль, компас
бюро лесное	бюро лясное
вал мельничный	вал млынавы
вал сеяльный	вал для сяўбы, сявальны вал
валеж	павал
валежник	ламачча
валить	валіць
валка леса	павал лесу
вальдшнеп — Scoloapax rusticola L.	слонка, слука
ванчес (сорт.)	ванчас
ванчес английский	ванчас ангельскі
ванчес голландский	ванчас голяндзкі
варивня	варыўня
василек (сорт.)	паўванчас
вата древесная, шерсть древесная	вата дрэўная
вверенный	даручаны
вдвойне	удвая, удубальт
ведомость оценочная	ведамасьць ацэначная
ведомость перечетная	ведамасьць пералікавая
ведомость рубкам	ведамасьць на высечкі
ведьмина метла	віхрова мятла
век дерева	век дрэва
веник	венік
веник гуменный	мятла
верба	гл. ива
верболоз	гл. ива козья
вереск — Calluna Salisb.	верас
вереск обыкновенный — Calluna vulgaris Salisb.	верас звычайны
верещатник (бор)	верасьняк
верста	вярста
вертун	гак бракарскі
верхний отруб	верхні адрэз
верхушка	вяршок
вершина дерева	верхавіна, вяршына
вершина оврага	верх раўчака
вершинник	верхаўё
вершок	вяршок
вес древесины	вага драўніны
весенняя кампания	веснавая кампанія
ветвление	галінаваньне
ветвление чередующееся	галінаваньне чаргоўнае
ветвление спиральное	галінаваньне пакручастае
ветвление супротивное	галінаваньне процілеглае
ветвление мутовчатое	галінаваньне кальчаковае
ветка	галіна
ветка еловая	лапка
ветреница дубровная — Anemone nemorosa L.	курасьлеп гаевы
ветреница лесная — Anemone silvestris L.	курасьлеп лясны
ветреница желтая — Anemone ranunculoides L.	курасьлеп жоўты
ветровал	вывараць
ветролом	ветралом
ветроупорность	ветратрываласьць
ветроупорная опушка	ветратрывалы ўзьлесак
веха	вяха
вешка	тычка, точка
взрослый	дарослы
взрыхлитель	пухнач
взыскать	сыскаць, спагнаць
видовое число	відавая лічба
виды хозяйства	віды гаспадаркі
визирная линия	візірка, візір
вилка мерная	клюба, шаблон, вілка
виновный	вінавайца
винт закрепительный	шруб замацавальны
винт микрометренный	шруб дробнамерны
винт становой	шруб пастаўны
вица	вітка
вкрапление	укропленасьць
влажность почвы	вільготнасьць глебы
влияние света	уплыў сьвятла
вместимость	зьмяшчальнасьць
водослой	вадаслой
возвышенное место среди болота	груд
возмужалость дерева	даросласьць дрэва
возникновение	узьнікненьне
возобновление леса	аднаўленьне лесу
возобновление леса естественное (отпрысками, поросль, самосевом)	натуральнае аднаўленье лесу (парасткамі, атожылкамі, самасевам)
возобновление леса искусственное (посевом, посадками)	штучнае аднаўленьне лесу (сяўбой, пасадкамі)
возраст	узрост
возраст возмужалости	узрост даросласьці
возраст дерева	узрост дрэва
возраст насаждения	узрост дрэвастану
возраст спелости	узрост дасьпеласьці
возращение	узрашчэньне
волк — Canis lupus L.	воўк
волнушка — Agaricus torminosus L.	ваўнянка
волокуша (трансп.)	каркі, падкаркі
волчье лыко — Daphne mesereum	воўча ягада
воронка сеяльная	лейка сявальная
воспитание насаждения	гадоўля дрэвастану, узгадаваньне
воспретить	забараніць
воспроизводительная способность	здольнасьць аднаўленьня
вредители леса	шкоднікі лесу
вредный	шкадлівы
временное сельско-хозяйственное пользование	часовае сельска-гаспадарчае карыстаньне
всходы	усходы
всхожесть семян	усходнасьць насеньня
второстепенная порода	другарадная парода
втройне	утрая
выборка	выбарка
выборочная рубка (добровольная)	выбарковая высечка (самахвотная)
выборочная рубка (подневольная)	адборная высечка (прымусовая)
вывозка	вывазка
вывозка лесоматериалов	тралёўка лесаматар’ялаў
вывороть	вывараць
выгон	выган
выгоревшее торфяное болото	выжар
выдел насаждений	вылучэньне дрэвастанаў, выдзел дрэвастанаў
выдел участков	выдзел, вылучэньне вучасткаў
выдра — Lutra vilgaris	выдра
выжимание морозом	выцісканьне марозам
выжимание растений	выцісканьне расьлін
выкапывание	выкопваньне
выкур (перед.)	выкур
выпалывание	поліва
выпь обыкновенная — Воtaurus stellaris Steph.	вып звычайная, бугай, бухала
выпь малая — Botaurus minor	малая вып
выращивание леса	гадаваньне лесу
вырубка сплошная	высечка суцэльная, у пень
вырубка хворостяного леса	выцярэбліваньне, выцераб
вырубка (под сельскохозяйственное пользование)	пасека
высадка из гряды	высадка з градкі
высадка на постоянное место	высадка на сталае месца
высев семян	сяўба
высокоствольник	высокаствольны ці насенны дрэвастан
высокоствольное хозяйство	высокаствольная гаспадарка
высота груди	вышыня грудзей
высота дерева	вышыня дрэва
высота насаждения	вышыня дрэвастану
высотомер	вышнямер
вычисление площади	вылічэньне плошчы
вышка пожарная	пажарная вышка
выщелачивание дерева	выпалоскваньне дрэва
выщелачивание почвы	выпалоскваньне глебы
вяз — Ulmus effusa vill.	вяз
вязанка	вязанка, бярэмя
вязовый заболонник — Scolytus multistriatus Fabr.	вязавы сколіт
габитус дерева	постаць дрэва
гарь	пажарышча, смаль
география растений	географія расьлін
геодезія лесная	геодэзія лясная
гербарий	зельнік
гербовой сбор	гэрбавы збор
гибкость	гнуткасьць
гигроскопичность	гігроскопічнасьць, вадаўборлівасьць
главная порода	галоўная парода
главное пользование	галоўнае карыстаньне
главный доход	галоўны даход
глазомер	вокамер
гледичия — Gleditschia triacanthos L.	глядычыя
глинистая почва	гл. почва
глоговина, берека — Sorbus torminalis Crantz.	глогавіна
глухарь — Tetrao urogallus L.	глушэц
гнать лес	сплаўляць, гнаць дрэва
гнездо	гняздо
гниение	гніцьцё
гнилость ствола	трухлявасьць ствала
гнилые сучья (фаут.)	гнілыя сукі
гниль белая	гл. белая гниль
гниль бурая от гриба — Trametes radiciperda	гніліна бурая
гниль вершинная	гніліна верхавінная
гниль корневая хвойных пород от гриба — Polyporus annosus или Trametes radiciperda	каранёвая гніліна
гниль красная березы от гриба — Polyporus betilinus	чырвоная гніліна бярозы
гниль красная дуба от гриба — Polyporus sulfureus	чырвоная гніліна дубу
гниль красная хвойных от гриба — Trametes pini	чырвоная гніліна хваёвых
гниль красная сухая от гриба — Polyporus vaporarius	чырвоная гніліна сухая
год семенной	насенны год
годичная лесосека	гадавая лесасека
годичное кольцо	гадавы персьцень
годичный слой	гадавы слой
голосеменные растения	голанасенныя расьліны
голубика — Vaccinium uliginosum L.	буякі
голубь дикий — Columba oenas Briss.	дзікі галуб
гонка леса	сплаў лесу
гонка смолы	смалярства
гонт шпунтовый	гонта шпаравая
гонтина	ганціна
гончий	ганчак
гонщик плотов	плытнік
горбыль	аполак
гордовина, черная калина — Viburnum lantana L.	чорная каліна
горлица — Tlirtur auritus Gray.	турчык
господствующая порода	пануючая парода
госпотребитель	дзяржаўны спажыўца
граб — Carpinus betulus L.	граб
грабли лесные	граблі лясныя
грабовый лес	грабнік
граница	граніца, мяжа
граничный угол	гранічны рог, вугал
гребенка (2-х рядовый плот)	плыт двохрадовік
грибница	грыбня
грунтовые воды	грунтовыя воды
группа	група
группа возраста	група ўзросту
груша дикая — Pyrus communis L.	дзікая ігруша
гусеница	вусень
гусь дикий — Anser segetum Mey et Wolf.	дзікая гусь
грядка	градка, града
губка	губа
губка на березе серая — Polyporus fomentarius Fries	губа шэрая бярозавая
губка на березе темная — Polyporus laevigatus Fries	губа цьмяная бярозавая
губка на дубе желтая — Polyporus sulfureus Fries	губа жоўтая дубовая
губка на дубе серая — Polyporus igniarius Fries	губа шэрая дубовая скрыпель
губка на дубе темная — Polyporus dryadeus Fries	губа цьмяная дубовая
губка на ели — Trametes radiciperda	губа яловая
губка на ольхе серая	губа шэрая альховая
губка на ольхе серая (с жесткими волосками)— Polyporus hirsutus Schrad.	губа шурпатая альховая
губка на осине — Polyporus salicinus Fries	губа асінавая
губка на сосне — Trametes pini	губа хваёвая
дача лесная	дача лясная
дача неустроенная	дача неўпарадкаваная
дача устроенная	дача ўпарадкаваная
движение песка	рух пяску
двойка (сорт.)	дваяк
двудомные растения	рознапнёвыя расьліны
двузубчатый короед — Ips bidentatus Hbst.	двохзубавы караед
двухъярусное насаждение	двохпаверхавы дрэвастан
девственный лес	пушча
девственная почва	цаліна
дегтярный завод	дзягцярня
дегтярник	дзягцяр
действительный запас	запраўдны запас
деление административное	гл. административное деление
деление на кварталы	падзел на кварталы
деление на хозяйственные части	падзел на гаспадарчыя часткі
деловая древесина	таварная драўніна
деловое дерево	таварнае дрэва
делопроизводитель	дзелавод
делянка	дзялянка
дендрология	дэндролёгія
дендрометр	дрэвамер
дерево безвершинное	гл. безвершинное дерево
дерево вильчатое	дрэва вілаватае
дерево дуплистое	дрэва дуплястае
дерево закомелистое	дрэва захвоставатае
дерево контрольное	дрэва паверачнае
дерево ловчее	дрэва прынаднае
дерево модельное	дрэва модэльнае
дерево оболонистое	дрэва абалоністае
дерево отпускное	дрэва выдачнае
дерево отпущенное	дрэва выданае
дерево перестойное	дрэва перасьпелае
дерево подчиненное	дрэва падлеглае
дерево поделочное	дрэва сталярскае
дерево резервное	дрэва запаснае
дерево рудовое	дрэва стрыжнёвае
дерево с несколькими вершинами	дрэва сахатае
дерево спелое	дрэва дасьпелае
дерево строевое	дрэва будаўлянае
дерево угнетенное	дрэва прыгнечанае
дерево фаутное	дрэва хабатнае
дерево чахлое	дрэва змарнелае
дерн	дзёран
десятина	дзесяціна
десятка (сорт.)	дзясятка
дикий	дзікі
дичь	дзічына
длина	даўжыня
добротность насаждения	дабрыня дрэвастану
добывание	дабываньне
договор	дагавор, умова, контракт
дознание	дазнаньне
долгоносик белоточечный — Pissodes notatus L.	белакропчаты слонік
домашний скот	свойская жывёла, хатняя жывёла
домовой гриб — Merullius lacrymans Fr.	хатні грыб
донесение	паведамленьне
дорога	дарога, шлях
доска	дошка
доска дюймовка	дошка цалёўка
доска полудюймовка	дошка шалёўка
доска сеяльная	дошка сявальная
доска тарандская (высотомер)	дошка тарандзкая
доход	даход, прыбытак (зыск)
дрань	дор, лучына
дрань штукатурная	лучына тынкавальная
древесина	драўніна
древесина косослойная	драўніна косая
древесина оболоневая	драўніна забалоневая
древесина прямослойная	драўніна правая
древесина ядровая	драўніна стрыжнёвая
древесная школка	дрэўная школка
древесница въедливая — Zeuzera руrinа L.	заедлівая драўніца
древоточец — Cossus	шашаль
древоточец пахучий — Cossus ligniperda	сьмярдзючы шашаль
дробь	шрот
дрова	дровы
дровяной лес	дрывяны лес
дровяной склад	дрывяны склад
дрозд певчиий — Turdus musicus L.	дрозд-пявун
дрозд черный — Merula merula L.	дрозд чорны, косік
дручек (сорт.)	дручок
дуб зимний — Quercus pedunculata Ehrh.	дуб раньні, зімні
дуб летний — Quercus sessiliflora Sm.	дуб позьні, летні
дуб пробковый — Quercus sliber L.	дуб коркавы
дуб пушистый — Quercus pubescens Willd.	дуб пухнаты
дубильная кора	дубільная, гарбоўная кара
дубликат	дублікат
дубовый гнездовьюн — Tortrix viridana Ehrh.	дубовы кублароб
дубовый шелкопряд — Bombyx processionea L.	дубовы ядвабнік
дыхание растений	дыханьне расьлін
дюйм	цаля
дятел	дзяцел
дятел большой пестрый — Dendrocopus major Koch.	дзяцел вялікі пярэсты
дятел малый пестрый — Dendrocopus minor Koch.	дзяцел малы
дятел зеленый — Gecinus viridis L.	зялёная жаўна
единица хозяйственная	адзінка гаспадарчая
единично (таксац.)	адзінкамі
еж — Erinaceus europaeus L.	вожык
ежевика — Rubus caesius L.	ажына
ежегодный доход	штогодны даход
еловый лубоед, полиграф — Tomicus polygraphus	яловы лубаед
ель восточная — Рісеа orientalis Carr.	елка ўсходняя
ель обыкновенная — Рісеа excelsa Lamark.	елка звычайная
ель сибирская — Picea obovata Ledeb.	елка сібірская
естественное возобновление леса	гл. возобновление леса
жасмин — Jasminum fruticans L. Jasm. officinale	ясьмін
железная дорога	чыгунка
желудь	жолуд
женский цветок	жаночая кветка
жерди	жэрдкі
жердневый лес	жардняк
живая изгородь	жываплот
живица	жывіца
животное	жывёла
живучесть пня	жывучасьць пня
жижа для обмакивания корней	жыжка для мачаньня карэньняў
жимолость обыкновенная — Lonicera Xylosteum L.	бружмень звычайны
жимолость татарская — Lonicera tatarica L.	бружмень татарскі
жуки — Coleoptera	жукі
журавль — Grus сіnеrеа Bechlast	жораў
заболонь	абалона
заболонник	абалоньнік, шашаль
загнивание корней	загніваньне карэньня
загонщики (при облаве)	заганятыя
загородка	загарадка
заготовка	загатоўка
заготовка леса	загатоўка лесу
заготовка хозяйственная	загатоўка гаспадарчая
загромождение	заваленасьць
заделка семян (на грядках)	засыпка насеньня
задерневшая лесосека	зьдзірванелая пасека
задичание почвы	зьдзічэньне глебы
заказник (охотничий)	заказьнік
закладка лесосек	закладзіны лесасек, дзялянак
заключение комиссии	погляд камісіі
закон	закон
закорина	зачос
закрепление сыпучих песков	замацаваньне выдмаў
залог	заклад
залогодатель	закладаўца
замена древесных пород	замена дрэўных парод
занумерованный	занумараваны
запас	запас
запись	запіс
заповедник	зарочнік
запрещенный	забаронены
запруда живая	гаць жывая
запруда хворостяная	гаць хварасьцяная
заруб (начало рубки)	засечка
засуха	суша, сухмень
засушить	засушыць
захламленность	заваленасьць ламаччам
защитное значение	заслоннае значэньне
защитная опушка	заслонны узьлесак
защитный лес	заслонны лес
защитная покрышка	заслонны насьціл
заяц (белый, серый) — Lepus europaeus	заяц (бяляк, шарак)
звездчатка злачная, пьяная трава — Stellaria graminea	зоркаўка травяністая
звездчатка лесная — Stellaria holostea L.	зоркаўка вялікакветная
звено	зьвяно
зверь	зьвер
земельный фонд	зямельны фонд, фундуш
землемер	каморнік
землепользователь	зямлякарыстальнік
земляника — Fragaria vesca L.	суніца, паземка
зимняя лесная дорога	зімнік
злоумышленность	зламыснасьць
злоупотребление	злоўжываньне
змеи — Ophidia	зьмеі
зола	попел
зоологический сад	зоолёгічны сад
ива белая (верба, ветла) — Salix alba L.	вярба звычайная
ива белотал — Salix viminalis L.	лаза прырэчная (паўзрэчная)
ива желтая, тальник, лозник — Salix purpurea L.	жоўтая лаза
ива козья, бредина — Salix caprea L.	вярба-брэднік
ива ломкая — Salix fragilis L.	вярба крохкая
ива ушастая — Salix aurita L.	лаза вушастая
иван-да-марья — Melampyrum nemorosum L.	братаўка гаёвая
иванов побег	іванаў парастак
избраники будущего насаждения	аблюбаванцы будучага дрэвастану
извлечение семян	дабываньне насеньня
изгородь	загарадзь, плот
изменение	зьмена
измерение диаметра	памер дыямэтру
изреженность	прарэджанасьць
изреживание	прарэджваньне
изыскание	вышукваньне
ильм — Ulmus montana	лём
ильм пробчатый — Ulmus suberosa Ehrh.	лём коркаваты
имущество движимое	маёмасьць рухомая
имущество недвижимое	маёмасьць нярухомая
инвалид	інвалід
инвентарь	інвэнтар
инвентарная опись	інвэнтарны сьпіс
иней	шэрань, іней
институт	інстытут
инструкция	інструкцыя
интенсивность хозяйства	інтэнсыўнасьць гаспадаркі
интерес	інтэрас
ирга, мушмула — Amelanchier ovalis D. С.	мушмула
искусственное лесоразведение	штучная лесагадоўля
исполнить	выканаць
исполнение	выкананьне, спаўненьне
использовать	скарыстаць
испытание добротности	выпрабоўка дабрыні
исследование	дасьледваньне
истребление	зьнішчэньне
июльский хрущ — Polyphylla fullo L.	хрушч малы кропчаты
кабан дикий — Sus scrofa L.	дзік
казенный	скарбовы
казна	скарб
кайма	шляк
калина — Viburnum Oplilus L.	каліна
камбиальный слой	мязга
камедь	клей, смала
камера сушильная	камора сушильная
камыш — Scirpus Z.	міліца
канал	канал
канифоль	каліфоня
кап	япа, наплыў
капитал культурный	капітал культурны
капитал оборотный	капітал зваротны
капитал основной	капітал асноўны
капитальный ремонт	капітальны рамонт, грунтоўны рамонт
капкан	пастка
карта	карта
картонное производство	картонавая вытворчасьць
касса	каса
катище (место склада)	рум
каштан благородный — Саstаnеа vulgaris Lam	каштан праўдзівы
качество почвы	якасьць глебы
квадратная сажень	квадратовы сажань
квартал	квартал
квитанция	квіток
кедр сибирский — Pinus Cembra L.	кедр сібірскі
кизил — Cornus mas L.	кізіл, дрон
кислица — Oxalis acetosella L.	кісьліца звычайная
кисть	гронка
класс возраста	кляса ўзросту
клеймение дерева	адбіваньне дрэва
клеймить	адбіваць, клеймаваць
клеймо	адбой, кляймо
клен американский — Acer Negundo	клён амэрыканскі
клен белый, явор — Acer Pseudoplatanus L.	явар
клен остролистый — Acer platanoides L.	клён звычайны
клен полевой, паклен, черноклен — Acer campestre L.	клён палявы
клен татарский — Acer tataricum L.	клён татарскі
клепки изготовление	кляпчарства
клетка (складочн.)	клетка
клюква — Vaccinium Oхусосcus L.	журавіна
кобчик — Falco vespertinus	сакол-жулёнак
кодекс	кодэкс
кодекс о труде	кодэкс аб працы
кожица на коре	скурка
козлы (при разработке)	казлы, сталюга
кол сажальный	кол пасадкавы
количество	колькасьць
колимость древесины	колкасьць драўніны
колода	калода
колоссальный	вялізарны
колышек сотенный	соценны калочак
комель	камель
коммерческий	камэрцыйны
компост	нагной, кампост
кондовая (рудовая) сосна	асмолавая (стрыжнёвая) хвоя
контроль	контроль
контрольная семенная станция	контрольная насенная станцыя
конфискация	конфіскацыя
конфисковать	конфіскаваць
кооперация	коопэрацыя
копа	капа
копия	копія
кора	кара
кора с молодого лилового ствола	луцьце
корельская береза	чачотка
корневой чехлик	каранёвы каптурок
корень	корань
корень боковой	корань бакавы
корень главный	корань асноўны, стрыжнёвы
корень придаточный	корань дадатковы
корешок	карэньчык
корневые мочки	каранёвыя махрачыкі
коробочка (плодовая)	пушачка
короеды	караеды
коростель — Crex pratensis Bechst.	драч, дзяркач
корчевание пней	карчаваньне пнёў
корявый	каравы
косослой	касаслой
костер курный	касьцёр курны
костяника — Rubus saxatilis L.	касьцянка
косуля, дикая коза — Cervus capreolus L.	дзікая каза
косяк	вушак
котловина	катліна
коэффициент	коэфіцыент
кража	крадзеж
крайний	крайні
красная гниль (на старых елях) — Nyctomyces	чырвоная гніліна
кратчайший	найкарацейшы
кредит	крэдыт
кредитование	крэдытаваньне
крепость древесины	моц драўніны
крестьянин	селянін
кривое дерево	крывое дрэва
кроква (сортимент)	кроква
крона	карона
крот — Talpa europaea L.	крот
круглый год	увесь год
кругляк	кругляк
крупная древесина (сортим.)	буйная драўніна
крупномерное дерево	тоўстае дрэва
крупнослойность	буйнаслойнасьць
крупный (сортимент)	вялікі
крушина ломкая — Rhamnus frangula L.	крушына крохкая
крушина слабительная — Rhamnus cathartica	крушына звычайная
крыжовник — Ribes grossularia L.	аграст
крышка	века
кряж (сортимент)	каржак
ксилометр	ксілёмэтр
куколка	лялечка
кукушка — Cuculus саnоrus L.	зязюля
кулик	кулік, грыцук
кулиса	куліса
кулисная рубка	высечка прамежкамі
культура (леса)	культура (лесу)
культура лесная	культура лясная
куница — Mustela martes L.	куна, куніца
куропатка белая — Tetrae Lagopus	пардва
куропатка серая — Perdrix сіnеrеа Briss.	курапатва шэрая
кустарь	саматужнік
кустарник	хмызьняк
кустарныя породы	кустовыя пароды
куча древесного хлама	лоўж
лава (трансп.)	лава
ландыш майский — Convallaria majalis L.	лантуш майскі
ласка — Putorius vulgaris Briss.	ласіца
лата (сортимент)	лата
лебедь — Cyguus musicus Brechst	лебедзь
лента мерная	каморніцкая істужка
лепесток	кветкалісьцік, пялёстка
лес деловой	лес таварны
лес дровяной	лес дрывяны
лес высокоствольный	лес насенны
лес низкоствольный	лес ніскаствольны(нізкаствольны), парасткавы
лес строевой	лес будаўляны
лес экспортный	лес экспортны (вывазны лес)
лесистый	лясісты
лесистость	лясістасьць
лесное урочище	лясное зьдзечышча
лесная дача	лясная дача
лесная подстилка	лясны насьціл
лесная такса	лясная такса
лесная таксация	лясная таксацыя
лесная опытная станция	лясная дасьледчая станцыя
лесничий	лясьнічы
лесное управление	лясное кіраўніцтва
лесное хозяйство	лясная гаспадарка
лесной кодекс	лясны кодэкс
лесной назем	лясны насьціл
лесной сторож, лесник	лясьнік, палясоўшчык
лесной фонд	лясны фонд, [былы] фундуш
лесовод	лесавод
лесоводство	лесаводзтва
лесовозобновление естественное	узнаўленьне лесу натуральнае
лесовозобновление искусственное	узнаўленьне лесу штучнае
лесовозращение	лесаўзрашчэньне
лесозаготовительная организация	лесазагатоўчая організацыя
лесозаготовительный отдел	лесазагатоўчы аддзел
лесоматериал	лясны матар’ял
лесонарушение	лесанарушэньне
лесоохранительный закон	лесаабаронны закон
лесопокупатель	лесапакупнік
лесопользователь	лесакарыстальнік
лесопольная система	лесапольная сыстэма
лесопотребитель	лесаспажывец
лесопромышленник	лесапрамысловец, лясны купец
лесопромышленность	лесапрамысловасьць
лесоразведение	загадаваньне лесу
лесорубочный (билет)	лесасечны (білет)
лесосека	лесасека
лесосека нормальная	лесасека нормальная
лесосека обсеменительная	лесасека насенная
лесосека очистная	лесасека пад ачыстку
лесосека светлая	лесасека працярэбная
лесосека защитная (светлая)	лесасека заслонная
лесосека сплошная	лесасека для высечкі ў пень
лесосека темная	лесасека цёмная
лесосека чересполосная	лесасека цераспалосная
лесосечная рубка	лесасечная высечка
лесосечный ряд	лесасечны рад
лесостатистический	лесастатыстычны
лесоупотребление	лесаўжываньне
лесоуправление	лесакіраваньне
лесоустройство	лесаўпарадкаваньне
летняя лесная дорога	летнік
летучая мышь — Vesperugo noctula	кажан
летучие пески	лятучыя пяскі
лещина, орешник — Corylus Avellana L.	ляшчына, арэшнік
линия	лінія
линия визирная	лінія візірная
липа крупнолистная — Tilia grandifolia Ehrh.	ліпа буйналісная
липа мелколистная — Tilіа parvifolia L.	ліпа дробналісная
лисица — Canis vulpes L.	ліс, лісіца
лисичка (грыб) — Cantharellus cibarius Fr.	лісічка, лісіца
лист планшетный	аркуш пляншэтны
лиственница европейская — Lагіх europaea D. С	мадрына эўропейская
лиственница сибирская — Larix sibirica	мадрына сібірская
лиственный лес	чорналесіца, лісьцяны лес
листовертка дубовая — Tortrix viridana L.	лістакрут дубовы
листапад	лістапад
листорасположение (чередующееся, спиральное, супротивное)	лісталад (чарговы, пакручасты, процілеглы)
листья	лісьцё
личинка (жука)	лярва
лишай исландский — Cetraria islandica	лішай ісьляндзкі
лишай коралловый — Сlаdonia pleurata	лішай каралевы
лишай мутовчатый — Сlаdonia verticillata	лішай кальчаковы
лишай олений — Cladonia rangiferina	лішай аленевы
лишай узловатый — Васоmyces roseus	лішай вузлаваты
лов	уловы
ловчие деревья	прынадныя дрэвы
логовище	лагво
лопата сажальная	рыдлёўка пасадкавая
лось — Alces Machilis Og.	лось
луб (ботан.)	луб
лучина	лучына
лыко	лыка, луцьце
льгота	ільгота
лютик золотистый — Ranunculus auricomus L.	казелец залацісты
лягавая	выжла
магнитная стрелка	магнэсавая стрэлка
майский жук или хрущ — Melolontha vulgaris Fabr.	хрушч
максимальный	максымальны, найбольшы
макушка	макаўка
малина обыкновенная — Rubus idaeus L.	маліна звычайная
малый еловый короед-гравер — Tomicus chalcognaphus	малы яловы караед
манжетка обыкновенная — Alchemilla vulgaris L.	гусялапка
манка	вабеньне
масляник (гриб) — Boletus granulatus	масьляк, казьляк
масло кедровое	алей кедравы
масса древесины	маса драўніны
масштаб	маштаб
материальное положение	матар’яльны стан
мауэрлат (сортимент)	мурлат
мауэрлат острокантный	мурлат востракантовы
мауэрлат тупокантный	мурлат тупакантовы
мачта	машта, шчогла
мачтовый лес	маштавы лес
машина корчевальная	карчавалка
маяк	маяк
медведь — Ursus arctos L.	мядзьведзь
межевание	межаваньне
мелкая древесина (сортим.)	дробная драўніна
мелкий	дробны
мелкослойность	дробнаслойнасьць
мензула	мэнзуля, каморніцкі столік
мерная вилка	клюба, мерная вілка
мероприятие	мерапрыемства
мертвый	мёртвы
мертвый лес	мёртвы лес
меры	заходы, меры
место рубки	месца высечкі
место склада	месца складкі
местный сбор (налог)	мясцовы падатак
месяц и число	месяц і чысло
метод лесоустройства	мэтод лесаўпарадкаваньня
метр	мэтр
микориза (на корнях хвойных)	корнягрыб, мікарыдза
минимальный	мінімальны, найменшы
модель	модэль
можжевельник казацкий — Juniperus Sabina L.	ялавец ніцы
можжевельник обыкновенный — Junipenis communis L.	ялавец звычайны
молодняк	маладняк, маладнік
монашенка шелкопряд — Oсnеrіа monacha L.	чарнічка звычайная
морозобоины	марозная шчыліна, марозіна
мост	мост
мотыга	матыка
моховик, коровик, козляк — Boletus bovinus	махавік, імшэньнік
моховое болото	імшара, імховае балота
мочки	гл. корневые мочки
мужской цветок	мужчынская пылковая кветка
мутовка	кальчак
мутовчатое ветвление	кальчакавае галінаваньне
мухомор обыкновенный — Amanita muscaria L.	мухамора звычайная
мухомор пятнистый — Amаnita pantherina D. С.	мухамора плямістая
мухомор серый — Amanita rubescens Fr.	мухамора шэрая
мышь полевая — Musagrarius Pall.	мыш палёўка
мягкая порода	мяккая парода
мяндовая сосна (древесина — Pinus silvestris — рыхлая, крупнослойная, белая слабосмолистая)	луціца, абалоністая хвоя
мятлик однолетний — Poa annua L.	мятлюжок адналетні
набухание семян	набраканьне насеньня
надбавка на усушку	набаўка на ўсыханьне
надел	надзел
надел служебный	надзел службовы
надзор	нагляд
надкожица — Citicula	надскурка, кутыкуля
надобность	патрэба
надруб	надсечка
наем	наймы
накат	покат
накатник	покатнік
налет семян	налёт насеньня
наличность (денег)	гатоўка
наличный запас	гатовы запас
направление просек	кірунак прасек, ліній,
направление рубки	кірунак высечкі
нарост	нарасьць
насаждение густое	дрэвастан густы
насаждение двухъярусное	дрэвастан двохпаверхавы
насаждение материнское	дрэвастан матчын
насаждение многоэтажное	дрэвастан шматпаверхавы
насаждение низкоствольное	дрэвастан нізкаствольны, парасткавы
насаждение одновозрастное	дрэвастан аднаўзросны
насаждение полное	дрэвастан поўны
насаждение почвозащитное	дрэвастан глебазаслонны, глебаабаронны
насаждение разновозрастное	дрэвастан рознаўзросны
насаждение редкое	дрэвастан рэдкі
насаждение смешенное(смешеное)	дрэвастан мяшаны
насекомые — Insecta	шасьціножкі, жамяра
научное исследование	навуковае дасьледваньне
начало рубки	пачатак, аснова высечкі
начет	налічэньне
неделя	тыдзень
недеятельный	бязьдзейны, нядзейны
недостаток	недахоп, недахват
недоруб	недавыруб, недаруб
неиспользованная делянка	нескарыстаная дзялянка
несоблюдение	невыкананьне
нетронутый	нячэпаны
неудобная земля	няўжытак, няўдобіца
неустойка	няўстойка
низкоствольное хозяйство	парасткавая, нізкаствольная гаспадарка
ницелоз, тальник — Salix repens L., Salix rosmarinifolia L., Salix angustifolia Wulf	ніцая лаза
ножніцы для прочистки	ножніцы для працярэбу
нора	нара
норка (животное) — Lutreola lutreola L.	норыца
обеспечение	забесьпячэньне
обзол (необрезанная часть бруса доски)	абза
облава	аблава
облесение гор	залясеньне гор
облесение оврагов	залясеньне равоў, яраў
облесение солончаковых почв	залясеньне салянковых глеб
облесение степей	залясеньне стэпаў
облесение сыпучих песков	залясеньне пераносных пяскоў
обложение налоговое	ападаткаваньне
обнажение	абгаленьне
обод	вобад
ободья	абады
оболонь	абалона
оборот рубки	зварот вырубу
оборот хозяйства	зварот гаспадаркі
оборудование	абсталяваньне
обработка почвы	выраб глебы
образец	узор
образование леса посадкой	пасадка лесу
образование леса посевом	засеў лесу
обрезка сучьев	абрэзка сучча
оброчная статья	чыншовая стацьця
обруб	вобруб, абруб
обрубить	абсеч
обруч	абруч
обсеменительная лесосека	насенная дзялянка, насенная лесасека
обследование леса	дасьледваньне лесу
общество "Друзей леса"	таварыства "Прыхільнікаў лесу"
общественный	грамадзкі
объедание коры	аб’яданьне кары
объездчик	аб’езчык
объем	аб’ём
объяснение	тлумачэньне, аб’ясьненьне
обязательство	абавязак
объяснительная записка	аб’ясьняльная запіска
овин	ёўня, асець
овраг	роў, яр
овсяница луговая — Fesliuса pratensis Huds	мурожніца луговая
оглобли	аглоблі
огнестрельное оружие	пальная зброя
однодомные растения	аднапнёвыя расьліны
однополые цветы	аднародавыя кветкі
одуванчик — Taraxacum offiсіnаlе Wigg.	дмухавец
ожидаемая стоимость леса	спадзяваны кошт лесу
ожеледь	галалёдзіца, галалёд, аблівака
окорка	акорка
олень — Cervus elaphus L.	алень
олений лишай	гл. лишай
ольха белая — Alnus incana Willd.	вольха белая, баравая
ольха черная — Alnus glutinosa Gärtn. 	вольха звычайная
ольховая трясина	алёс
омела — Viscum album	вяха, амяла
опадение листвы	лістапад
опадение семян	апад насеньня
опадение хвои — нем. Schütte	апад ігліцы
опенок — Agarius melleus L.	апенька
операция лесная	опэрацыя лясная
опилки	пілавіны
опись имущества	сьпіс маемасьці
описание насаждения	апісаньне дрэвастану
оплоченный лес	аплачаны лес
определение	азначэньне
определение возраста	азначэньне ўзросту
определение запаса	азначэньне запасу
опушка ветроупорная	узьлесак заслонны
опушка леса	узьлесьсе
опытные таблицы	дасьледчыя табліцы
опытное учреждение	дасьледчая ўстанова
организация лесного хозяйства	організацыя лясной гаспадаркі
орел — Aquila	арол
орех	арэх
орех волошский-грецкий — Juglaus regia L.	арэх валоскі
орех вылущившийся	лузганец, лузгун
ореховый наплыв	арэхавая нарасьць
орешки (галлы, цецидии) — galla quercina	бародаўкі (яблычкі)
орешник	гл. лещина
ортштейн	рудзяк, ортштэйн
орудия (для культур)	прылады, снасьць
осадки (атмосфера)	ападкі
осветление	асьвятленьне
освещение дома	асьвятленьне дому
осина — Populus Tremula L.	асіна
осиновое насаждение	асіньнік
осколок	аскялёнак
осмол	смаляк
основание дерева	аснова дрэва
основная уплата	асноўная выплата
особого назначения лес	асаблівага прызначэньня лес
осокорь	гл. тополь
осушительный канал	канал для асушкі, асушальны канал
отвод лесосек	адбіўка дзялянак
отводок	адводак
отдел	аддзел
отделение хвойных семян от крылышек	адлучэньне насеньняў іглястых парод ад крылцаў
отенение почвы	зацяненьне глебы
отклонение магнитной стрелки	адхіленьне магнэсавае стрэлкі
отлуп	пазушка
отопление	апал
отпрыски от корней	атожылкі ад карэньня
отпуск леса	выдача лесу
отпуск лесоматериалов	выдача дрэва
отрез дерева	адрэз дрэва
отруб нижний	ніжні адрэз, адрэз у камлі
отсрочка	адсрочка
отчет лесоустроительный	справаздача лесаўпарадкаваньня
отчет месячный, годовой	справаздача месячная, гадавая
отчуждение	адчужэньне
охват, загон (при облаве)	воступ
охлестывание ветвей	ашалёставаньне гальля
охота	паляваньне
охотник	паляўнічы
охотничий сбор	збор паляўнічых
охрана леса	ахова лесу
охранный лес	абаронны, ахоўны лес
оценка	ацэнка
оценка дачи	ацэнка дачы
оценка леса	ацэнка лесу
оценочная ведомость	ацэначная ведамасьць
очередование кварталов	чаргаваньне кварталаў
очистка места рубки	падчыстка месца высечкі
очистка дерев от сучьев	агаленьне дрэў ад сукоў
ошкуривание	абдзіраньне кары
паз (в гонте)	паз
пазовать гонт	пазаваць гонты, шпараваць, фугаваць
папоротник	папараць
папоротник кочедыжник — Asplenium L.	папараць буйная
папоротник орляк — Pteris aquilina	арляк
паразиты растительные	чужаеды расьлінныя
парк	парк
парня	парня
порода леса	парода лесу
партия лесоустроительная	лесаўпарадчая партыя
пасека пчелиная	пчольнік
пастбище, выгон	паша, выган
пасти скот	пасьвіць (пасьціць) быдла, скаціну
пастьба	пасьба
пастьба скота	пасьба скаціны
пашня, пахота	ворная зямля, ральля
пень	пень
пенек	пнёк
пеня	пеня
пепел	попел
перевозка	перавозка
первоцвет лекарственный — Primula officinalis Jacq.	ключыкі лекавыя
перепел — Coturnix comnunis Bonnat	перапёлка
переруб	пераруб
пересадка сеянцев	перасадка сеянцаў, расады
перестой	перастой
перечет	пералік
перечет деревьев	пералік дрэў
период возобновительный	пэрыод лесааднаўленьня
период ревизионный	пэрыод рэвізыйны
период рубки	пэрыод высечкі
пернатая дичь	дзічына перная
перспектива	пэрспэктыва
письмоводитель	пісьмавод
питомник лесной	гадавальнік лясны
пихта европейская — Abies pectinata D. C.	ельніца эўропейская
пихта кавказкая — Abies normanniana	ельніца каўказкая
пихта сибирская — Abies sibirica Ledeb.	ельніца сібірская
план	плян
план лесонасаждений	плян дрэвастанаў
план очередования рубки	плян чаргаваньня вырубу
план хозяйства	плян гаспадаркі
плата	плата, выплата
платежная ведомость	выплатная ведамасць
плаха	плаха
плашка	плашка
плетень	пляцень
плод	плод
плот (транспорт.)	плыт
плотная кубическая сажень	шчытны кубічны сажань
площадка	пляцок
площадь	плошча, пляц
площадь древесного полога	плошча шчыта
площадь эксплоатации(эксплуатации)	плошча эксплёатацыі
плуг	плуг
пневой осмол	асмолак, смаляк пнёвы
побег годичный (отпрыск, поросль)	паростак гадовы (пасынак гадовы)
побег водяной	паростак вадзяны
побег вторичный	паростак паўторны
побегопроизводительная способность	парасткатворчая здольнасць
побивание побегов морозом	ушкаджэньне паросткаў марозам
побочный пользования	пабочныя карыстаньні
поверхность возвышенно-ровная	паверхня плоскаўзвышная
поверхность волнистая	паверхня ваўнаватая
поверхность низменная	паверхня нізінная
поверхность обрывистая	паверхня зрывістая
поверхность покатая	паверхня адхоная
поверхность поемно-котловинная	паверхня поплаўна-катліністая
поверхность пологая	паверхня палогая
повреждение морозом	ушкаджэньне марозам, ад марозу
поганка бледная — Amanita phalloides Fr.	паганка
поглощение	паглынаньне, убіраньне
погорельцы	пагарэльцы
подбел (на торфяниках) — Andromeda polifolia L.	імшарніца
подгон (быстрорастущая порода)	падгон
поделочный	вырабны
поджог	падпал
подземный пожар	падземны пажар
подлесок	падлесак
подмесь	дамешка
подрезка корней	падрэзка карэньняў
подлинник	аўтэнтык, першатвор
подрост	падрост, памаладзь
подсадка	падсадка
подсев	падсеў
подснежник — Galanthus nivalis L.	падсьнежнік
подсочка сосны	падсочка
подчистка леса	падчыстка лесу
пожар	пажар
пожар верховой	пажар верхавінны
пожар низовой	пажар нізавы
поземельный сбор	падаткі за зямлю
показательный	паказальны
покров живой	акрыцьцё жывое
покров мертвый	акрыцьцё мёртвае
покров почвенный	акрыцьцё глебавае
покрытосемянные растения	акрытанасенныя расьліны
покрышка защитная	насьціл заслонны
покупать лес	купляць лес
поленица	паленіца
полено	палена
поливка гряд	паліўка градак
полка (сорняков)	поліва
полнодревесность дерева	гонкасьць, поўнадрэўнасьць дрэва
полнодревесность ствола	гонкасьць ствала
полнодревесность поленицы	поўнадрэўнасьць паленіцы
полнота насаждения	паўната дрэвастану
полог вершины	палог верхавіны
положение	палажэньне
положение насаждения	стан, палажэньне дрэвастану
полоз	полаз
полоть грядки	палоць градкі
полуделовой	поўвырабны
полукроква (сортимент)	поўкроква
полустроевой	напоўбудаўляны
полутес	ачосак
полуторка	паўтарачка
пользование	карыстаньне
пользование побочное	карыстаньне пабочнае
пользование промежуточное	карыстаньне прамежнае
поляна	паляна
помощник лесничего	памоцнік лясьнічага
понижение таксы	зьніжэньне таксы
попенная плата	плата ад пня
поползень — Sitta europae L.	паўзунчык
пополнение культур	папаўненьне культур
порода	парода
порода быстрорастущая	парода борздарослая
порода вкрапленная	парода ўкропленая
порода второстепенная	парода другарадная
порода господствующая	парода пераважная
порода лиственная	парода лісьцяная
порода долговечная	парода доўгавечная
порода медленнорастущая	парода паволірослая
порода недолговечная	парода нядоўгавечная
порода почвоулучшающая	парода глебапаляпшальная
порода почвоухудшающая	парода глебапагаршальная
порода подчиненная	парода падлеглая
порода подмешаная(подмешанная)	парода дамешаная
порода светолюбивая	парода сьвятлолюбная
порода тенелюбивая	парода ценялюбная
порода теневыносливая	парода ценятрывалая
порода хвойная	парода іглястая
пороки древесины	хібы драўніны
поросль (пневая, стволовая)	парасьць (пнёвая, стваловая)
порубка	парубка лесу, поруб лесу
порубщик	парубшчык
порох	порах
порча древесины	псаваньне драўніны
посадка вдоль дорог	прысады
посадка в квадрат	пасадка ў квадрат
посадка в ямки	пасадка ў ямкі
посадка леса	пасадка лесу
посадка на бугорках	пасадка на грудкох
посадка на пень	пасадка на пень
посадка пеньками	пасадка пянькамі
посадка под кол	пасадка пад кол
посадка под меч	пасадка пад нож
посадка под шнур	пасадка пад шнур
посадка пучками	пасадка жмуткамі
посадка со стулом	пасадка з гняздом
посев семян	сяўба насеньня
постепенная рубка	паступенная высечка
постоянный доход	сталы даход, прыбытак
постоянство пользования	сталасьць карыстаньня
потрава	патрава
почва	глеба
почва абсолютно лесная	абсалютна лясная глеба
почва болотная луговая	глеба балотная лугавая
почва болотная торфяная	глеба балотная тарфяная
почва влажная	глеба вільготная
почва известковая	глеба вапельная
почва истощенная	глеба спустошаная
почва глинистая	глеба гліністая
почва гумозная	глеба перагнойная
почва лесная серая	глеба лясная шэрая
почва мокрая	глеба мокрая
почва неудобная	глеба нягодная
почва песчаная	глеба пяшчаная
почва подзолистая	глеба падзольная
почва с глеевым горизонтом	глеба з глеевым паземам
почва свежая	глеба сьвежая
почва солонцеватая	глеба саланчаковая
почва сухая	глеба сухая
почва черноземная	глеба чорназемная
почва щебнистая	глеба грантаватая
почвенный покров	глебавае акрыцьцё
почвенный покров живой	глебавае акрыцьцё жывое
почвенный покров мертвый	глебавае акрыцьцё мёртвае
почвозащитный подлесок	глебазаслонны падлесак
почка (древесная)	пучок
практикант	практыкант
преимущество исскуственного и естественного возобновления	перавага штучнага, ці натуральнага ўзнаўленьня
прекращение роста	спыненьне росту
приведение в известность леса	падлічэньне лесу
прививка	прышчэпка
приговор	прыгавар
приготовление семян к посеву	падрыхтоўка насеньня да сяўбы
признаки пригодности семян	прыметы прыдатнасьці насеньня
приказ	загад
примесь	дамешка
приморская сосна — Pinus maritima Lamb.	прыморская хвоя
прирост	прыраст
прирост дачи	прыраст дачы
прирост в высоту	прыраст у вышыню
прирост в толщину	прыраст у таўшчыню
прирост годичный	прыраст гадавы
прирост качественный	прыраст якасны
прирост количественный	прыраст колькасны
прирост периодический	прыраст пэрыодычны
прирост средний	прыраст сярэдні
прирост текущий	прыраст сучасны
прирост по дороговизне	прыраст па дарагоўлі
прирост массовый	прыраст масавы
прирост световой	прыраст сьветляны
приспевающее насаждение	дасьпяваючы дрэвастан
пристань	прыстань
притуга	гнёт, покат
притужить	прытужыць
прицветник	прыкветак
проба семян	спроба насеньня
пробная площадь	спробная плошча
прогалина	прагаліна
продажа леса (с торгов, без торгов)	прадажа лесу (з таргоў, без таргоў)
продажная стоимость насаждения	прадажны кошт дрэвастану
продолжительность жизни дерева	век дрэва
производительность леса	продукцыйнасьць, вытворчасьць лесу
происхождение насаждения	пахаджэньне дрэвастану
промежуток	прамежак
промежуточный (доход)	прамежны
промежуточное пользование	прамежнае карыстаньне
промежуточная рубка	прамежная высечка
проращивание семян	прарошчваньне насеньня
прореживание насаждения	зрэджваньне дрэвастану
проталина	праталіна
протил (обр. древ.)	рэз
просвет	прасьвець
просека	просек, лінія
просека квартальная	квартальная лінія
прострел (сон-трава) — Pulsatilla patens Mill.	сон звычайны
проходная рубка	праходная высечка
процент всхожести	процант усходжасьці
процент прироста	процант прыросту
прочистка	працярэбліваньне
прочность древесины	трываласьць драўніны
пузырчатая ржавчина — Aecidium pini corticola Pers.	пузыркавая іржа
пустошь	пустоша
пустырь	пустка
пушнина	пушніна
пчелинье гнездо в дупле дерева	пчалінае гняздо у дупле
пыж	клак, пыж
пыльца	пылок
пырей — Triticum repens L.	пырнік
пятерик (сортимен.)	пяцярык
равномерный (доход)	роўнамерны
разведение деревьев	загадаваньне дрэў
разделение дачи	падзел дачы
раздельнополые деревья	падзельнародавыя дрэвы
различие насаждений	адрозьненьне дрэвастанаў
размер	разьмер
разметка культурной площади	разьбіўка культурнае плошчы
размещение саженцев	разьмяшчэньне саджанцоў
разрабатывать лес	распрацоўваць лес
разрез поперечный	разрэз папярочны
разрез продольный	разрэз падоўжны
разрушение древесины	руйнаваньне драўніны
разрыхление почвы	пухленьне глебы
разряд такс	разрад такс
рак ели	рак елкі
ракитник обыкновенный — Cytisus biflorus	зяновец
раковая гниль	ракавая гніліна
рама посевная	сявальная рама
распашка	ворыва
распашка вырубок	выраб пасекі
распашка лесной почвы (с корчеванием)	ляда
распиловка леса	пілоўка лесу
распределение деревьев	разьмеркаваньне дрэў
расстройство леса	лясная безгаспадарнасьць
распускание почек	распусканьне пучкоў
расход на администрацию	выдаткі на адміністрацыю
расход на культуры	выдаткі на культуры
расход на эксплоатацию(эксплуатацию)	выдаткі на эксплёатацыю
расцветать	зацьвітаць, закрасаваць
расчистка	поцераб
растение	расьліна
ревизия	рэвізія
револьвер	рэвольвэр
редина	рэдкалесьсе
редуцированная площадь	рэдукаваная плошча
результат	вынік
рейка	рэйка
рельеф	рэльеф
ремонт строений	рамонт, папраўка будоўлі
рента лесная	рэнта лясная
рента почвенная	рэнта глебавая
решетник (сортимент)	латняк
решето для сушки шишек	рэшата для сушкі шышак
рогожа	рагожа
рост	рост
росток	адростак
росянка круглолистная — Drosera rotundifolia G.	расіца круглалістая
роща	гай
роща заказная	гай заказаны
рубка	высечка
рубка выборочная (добровольная)	высечка выбарковая (самахвотная)
рубка выборочная (подневольная)	высечка адборная (прымусовая)
рубка группами	высечка груповая
рубка полосами	высечка паласамі
рубка приготовительная	высечка падрыхтоўчая
рубка семено-лесосечная	высечка насенналесасечная
рубка сплошная	высечка ў пень
ружье	стрэльба
рулетка	рулетка
рыжик — Agaricus deliciosus Lustr.	рыжок
рысь — Lunx vulgaris	рысь
рычаг	падважнік
рыхлость почвы	пухкасьць глебы
рябина мучнистая — Sorbus aria Cr.	рабіна мучністая
рябина обыкновенная — Sorbus aucuparia	рабіна звычайная
рябчик — Bonasa canescens Sparrm	рабок
ряд лесосечный	лесасечны рад
сажальный молоток	пасадковы малаток
сажальная машина Стретона	пасадковая машына Стрэтона
саженец	саджанец
сажень таксационная	таксацыйны сажань
самец	самец
самка	саміца
самовольная вырубка	самапраўная высечка
самовольная пастьба	самапраўная пасьба
самовольная пастьба скота	самапраўная пасьба скаціны
самовольная порубка	самапраўная парубка
самосев	самасеў
самшит обыкновенный — Buxus sempervirens L.	самшыт, буксус
сантиметр	сантымэтр
сарай	хлеў, пуня
сбег ствола	зьбег ствала
сбежистый ствол	захвоставаты, зарывісты ствол
сбор семян	збор насеньня
сборно-счетная ведомость	зборна-рахунковая ведамасьць
сведения	зьвесткі
сверхсметно	зьверх каштарысу
световой прирост	сьвятляны прирост
светолюбивость	сьветлалюбнасьць
свилеватость	сьвілеватасьць, задорыстасьць
свинушка (гриб) — Agaricus involutus Fr.	сьвінарка
сводка	падвядзеньне
сводка леса	зьнішчэньне лесу
съемка	здымка
съемка леса	здымка лесу
съемка инструментальная	здымка інструмантам
съемка рекогносцировочная	здымка рэкогносцыйная
секвестр	сэквэстар
секция лесная	лясная сэкцыя
селезень	качар
селение	паселішча
сельхозналог	сельска-гаспадарчы падатак
семена	насеньне
семенная лесосека	насенная лесасека
семенники, семенные деревья	насеньнікі
семеносушилка	насенная сушня
семени всхожесть	насеньня ўсходжасьць
сенокос	сенажаць
сенокос заливной	сенажаць поплаўная
сенокосная полянка (в лесу)	сенажаць у лесе
сенокошение	касьба
сердцевина	асяродак
сердцевинный луч	асяродкавы прамень
сердцевидная трубка	асяродкавая трубка
сережка (сережки)	каткі
серянка	смолка
сеялка (машина)	сявалка
сеянец	сеянец
сизоворонка, сивоворонка — Coraclas garrula L.	сіваваронка
синева	сінь
синица — Parus major Briss.	сініца
синица долгохвостая — Acredula caudata L.	сінюха доўгахвостая
сирень — Syringa vulgaris	бэз
система лесного хозяйста	сыстэма лясной гаспадаркі
скворец — Sturnus vulgaris	шпак
скипидар	шпігінар
складочная мера	складальная мерка
складочная сажень	куб
склюд	склют
склад леса	лясны склад
скобель конный	скобля конная
скорлупа — гл. чешуйка	лупіна, луска
скорость рубки	скорасьць высечкі
слива — Prunus domestica L.	сьліва
служебный лесной надел	службовы лясны надзел
смена древесных пород	зьмена дрэўных парод
смесь	мешаніна
смета	каштарыс
сметная лесосека	каштарысная лесасека, чарговая лесасека
смешанное насаждение	мяшаны дрэвастан
смола (на дереве)	смала, жывіца
смолокурение	смалярства
смолокуренный завод	смалярня
смолокуренный мастер	смаляр
смоляные ходы	смаляныя хады
смородина красная — Ribes rubrum L.	парэчкі чырвоныя
смородина черная — Ribes nigrum L.	смуродзіна
сморчек — Morchella Dill.	смаршчок, асялок, храпач
смыкание посадки	стыканьне пасадкі
снегирь — Pyrrhula соccinea R.	гіль
снеговой налет	шэрань
снеговой покров	сьнегавы насьціл
сова ушастая — Asio otus L.	сава
сок кленовый	кляновы сок
солнечный припек	сонцапёк
соловей — Luscinia luscinia L.	салавей
сомкнутость насаждения	стычнасьць дрэвастану
соответственный	адпаведны
соревнование на лес	спаборніцтва на лес
сорняки, сорные травы	пустазельле
сорт	гатунак
сортимент	сартымэнт
сосна Веймутова — Pinus Strobus L.	хвоя Вэймутава
сосна горная — Pinus montana Dur.	хвоя горная
сосна крымская — Pinus taurica Hor.	хвоя крымская
сосна обыкновенная — Pinus silvestris L.	хвоя звычайная
сосна черная — Pinus Laricio Poir.	хвоя чорная
сосновая пяденица	хваёвы каморнік
сосновая совиноголовка — Nосіuа piniperda Esp.	хваёвая савінагалоўка
сосновый долгоносик — Pissodes notatus	хваёвы слонік
сосновый лубоед — Hylesinus piniperda L.	хваёвы лубаед
сосновый ствол с крупным ядром	стрыжнёвы ствол
сосновый ствол с широкой заболонью	абалоністы
сосновый шелкопряд — Gastropacha pini L.	хваёвы прадзільнік
состав насаждения	склад дрэвастану
состояние дачи	стан дачы
состояние насаждения	стан дрэвастану
сохранение семян	захаваньне насеньня
спелость	сьпеласьць
спелость возобновительная	даросласьць дрэва
спелость естественная	сьпеласьць натуральная
спелость качественная	сьпеласьць якасная
спелость количественная	сьпеласьць колькасная
спелость техническая	сьпеласьць тэхнічная
спелость финансовая	сьпеласьць грашовая
спелый лес	сьпелы лес
специальный	спэцыяльны
спичечная фабрика	сярніковая фабрыка
сплав	сплаў
сплавная рэка	сплаўная рака
сплошная рубка	высечка ў пень, суцэльная высечка
сравнение	параўнаньне
средний возраст	сярэдні ўзрост
средневозрастный лес	сярэдняўзросны лес, лес сярэдняга ўзросту
среднее дерево	сярэдняе дрэва
средняя древесина (сорт.)	сярэдняя драўніна
средства для устройства дачи	сродкі для ўпарадкаваньня дачы
срок вырубки леса	тэрмін высечкі лесу
срок примыкания	тэрмін стыканьня
срубить (дерево)	сьсекці, паваліць
срубить (постройку)	паставіць зруб
срубленный лес	высечаны лес
стадо	стадак
стандарт (англ. учет досок)	стандарта
статистика лесная	статыстыка лясная
ствол	ствол
ствол полнодревесный	ствол гонкі, уносісты
ствол сбежистый	ствол захвоставаты, зарывісты
стебель растения	сьцябло
степное лесоразведение	стэпавая лесагадоўля
стержневой корень	стрыжнёвы корань
стоимость дачи	кошт дачы
стоимость древесины	кошт драўніны
стоимость насаждения	кошт дрэвастану
стойка рудничная (copт.)	шахтавы слупок
столб визирный	палік (слуп) візірачны
столб в постройке	шула
столб квартальный, межевой	слуп квартальны, гранічны
стратификация	стратыфікацыя (насеньня)
стража лесная	варта лясная
строевой	будаўляны
строевой лес	будаўляны лес
стропила	кроквы
струк, стручок	струк, лускаўка
ступень толщины	ступень таўшчыні
судебный	судовы
сук	сук
суковатость (фаут.)	сукаватасьць
сурепица прямая, сурепица обыкновенная — Ваrbагеа strikta andr., Barbarea vulgaris Br.	сьвірэпка
суховершинник	сухавяршыньнік
сухостой	сухастой
сучья	сучча, сукі
сушильная камера	сушыльная камора
счета	рахункі
сыроежка (разные виды) — Russula. Agaricus ruber	сыраежка
сырорастущий лес	сырарослы лес
сычь	сыч
таблица	табліца
таблица классов возраста	табліца клясаў узросту
таблица сортиментов	табліца сартымэнтаў
такса	такса
таксовый	таксавы
таксатор	таксатар
таксационное описание	таксацыйнае апісаньне
таксационная сажень	таксацыйны сажань
тальник — Salix rosmarinifolia L.	лаза ніцая
таяние снега	раставаньне сьнегу
твердая порода	цьвёрдая парода
твердость древесины	цьвёрдасьць драўніны
температура семеносушилки	тэмпэратура насеннае сушарні
теневыносливость	ценятрываласьць
теодолит	тэодоліт
теплотворность древесины	цеплатворнасьць драўніны
термометр	тэрмомэтр, градусьнік
терновник, терн — Prunus spinosa L.	цярніна
терпентин	тарпатына
территория лесных площадей	абшар лясное плошчы
тес	цёс
тетерев — Tetrao  tetrix L.	цецярук
тетерка — Tetrao tetrix L.	цяцёрка, цяцера
техническая спелость	тэхнічная дасьпеласьць
технология	тэхнолёгія
типы насаждений	тыпы дрэвастанаў
типовой договор	тыповы дагавор, тыповая ўмова
тисс — Taxus baccata L.	нягной-дрэва, ціс
тление	тленьне
толщина	таўшчыня
тонкомерное дерево	тонкае дрэва
топливо	паліва
тополь пирамидальный — Populus pyramidalis	таполя пірамідальная
тополь серебристый — Populus alba	таполя белая
тополь черный, осокорь — Populus nigra	таполя цьмяная, ясакар
топор	тапор, сякера
торговля лесом	гандаль лесам
торф	торф
точность съемки	дакладнасьць здымкі
травяное болото	травяное балота
транспортир	транспортыр
транспорт леса	транспорт лесу
требовательная ведомость	выплатная ведамасьць
тропинка (напр.) в лесу, проложенная скотом	сьцежка
трут (из губок)	цыр
трясина	дрыгва
трясогузка — Motacilla alba L.	пліска (сітаўка, падманка)
трясунка — Briza media L.	дрыжнік сярэдні (сьлёзкі)
тутовое дерево — Morus alba L.	морва
туйя восточная — Tuja orientalis	туя ўсходняя
туйя обыкновенная — Tuja occidentalis	туя звычайная
углежжение	выпал вугальля
угодие	ужыткоўнасьць, угодзьдзе
угол астролябический	кут астролябічны
угол внутренный	кут унутраны
угол леса	рог лесу
угол румбический	кут румбічны
удлинение	падаўжэньне
удостоверение	пасьведчаньне
удот — Upupa epops	удод
уж обыкновенный — Trodidonotus	вуж
указательный процент	паказны процант
укрепление горных склонов	замацаваньне горных схілаў
укрепление оврагов	замацаваньне яроў, равоў
укрепление песков	замацаваньне пяскоў
уксус	воцат
уксусное дерево — Rhus typhina L.	воцатнае дрэва
уксусное производство	воцатны выраб
улитка — Нelіх	сьлімак, смоўж
улучшение насаждений	паляпшэньне дрэвастанаў
управление лесами	гл. лесное управление
урегулирование	урэгуляваньне
урожай семян	ураджай насеньня
урочище	мясьціна, зьдзечышча
условие	умова
условные знаки	умоўныя знакі
устав	статут
устроенный лес	упарадкаваны лес
усушка древесины	усушка драўніны
утка	качка
утка кряковая — Anas boschas L.	качка крыжанка
утка чирок — Anas circia L.	качка чырка
утренник	прымаразак
уход за насаждением	дагляд дрэвастану
уход за лесом	дагляд лесу
участок	вучастак
участок леса	вучастак лесу
участок лесной	вучастак лясны
фанера	фанера
фаут	фаут, хабат
фаутное дерево	фаутнае дрэва, хабатнае дрэва
фашина	фашына
фиалка лесная — Viola саnіnа L.	браткі лесавыя
фут	фут, локаць
хвойный лес	іглясты лес, бор
хворост	гальлё, ламачча, хворает
хвощ лесной	хвошч лесавы
хвоя	ігліца
хищник	драпежнік
хлам	ламачча
хлыст	хлыст
хмыз	сучча, ламачча
холмистость	узгаркаватасьць
хозяйство лесное	гаспадарка лясная
хорек — Putorius foetidus Gr.	тхор
хранение семян	перахоў насеньня
хрупкость древесины	крохкасьць драўніны
цапля — Ardea	чапля
цветки	кветкі, краскі
цветок неполный	кветка няпоўная
цветок полный	кветка поўная
цена корневая	пнёвая цана
ценность	цэннасьць
ценный лес	цэнны лес
цепь мерная	каморніцкі ланцуг
циркуль	цыркуль
частновладельческий	прыватнаўласьніцкі
часть хозяйственная	гаспадарчая часьць
чаща (молодого леса)	гушчар, гушчарнік
червоточина	чарваточына
черемуха — Prunus Padus L.	чарэмха, калакалуха
черенок	зразок
черешня дикая — Prunus avium L.	чарэшня лясная
черника — Vaccinium Murtillus L.	чарніца
чернильные орешки	земляная сажа
четверик (сортим.)	чацьвярык
четверть куб. сажени (дров)	шурка
чехлик корневой	каптурок карнёвы
чешуйка	луска
чистотел — Chelidonium majus L.	падтыньнік вялікі
чорт(чёрт) лесной (машина)	дрэвавал
чурбан	цялеш, чурбак
шагомер	крокамер
шелковица — Morus alba	гл. тутовое дерево
шелкопряд златогузка — Gastropacha Neustria	прадзільнік златагузка
шелкопряд ивовый — Leucoma Salicis	прадзільнік лазовы
шелкопряд кольчатый — Gastropacha Neustria L.	прадзільнік персьцянёвы
шелкопряд непарный — Ocneria dispar	прадзільнік няпарны
шелкопряд походный — Cnetocampa processinea L.	прадзільнік паходны
шелкопряд сосновый	гл. сосновый шелкопряд
шелуха	лушпайка
шерсть древесная	вата дрэўная
шип	калючка
шиповник — Rosa canina L.	шыпшына
широколиственный лес	шырокаліставы лес
шишка	шышка
шпанка, шпанская мушка — Littiа visicatoria L.	шпанская мушка
штабель (дров)	штабель, пагон (дроў)
щегол — Сarduelis cardu	шчыгел
щель	шчэлка, шчыліна
щепка	трэска, шчэпка
щит	шчыт
эквивалент	эквівалент, роўназначнік
экземпляр растения	каліва, паасобнік
эксплоатация(эксплуатация)	эксплёатацыя
экстирпатор	драпач
яблоня лесная - Pyrus malus L.	дзікая яблыня
ягода крушины	крушынная ягада
ядро древесины	стрыжань
ярус насаждения	паверх дрэвастану
ясень американский — Fraxinus americana L.	ясен амэрыканскі
ясень обыкновенный — Fraxinus excelsior L.	ясен звычайны.
ясень остроплодный — Fraxinus oxyphylla M. В., Fraxinus охусагра Willd.	ясен востраплодавы
ясеневый лубоед — Нуlеsinus Fraxini	ясянёвы лубаед
ятрышник — Orchis L.	зязюлька
ящик	скрынка
