##Title: Тэрмінолёгія лёгікі і псыхолёгіі (БНТ)
##HTMLDescription_BEGIN
<div>
	<p class="dictdesc-st">Створана на падставе:</p>
	<p><b>Тэрмінолёгія лёгікі і псыхолёгіі</b>. Менск: Інбелкульт, 1923.</p>
</div>
<div>
	<p class="spoiler">Прадмова</p>
	<p>Лёгічна-псыхолёгічная тэрмінолёгія, якая зьяўляецца ў друку ў гэтым выпуску Беларускае навуковае тэрмінолёгіі, прадстаўляе сабою злучэньне разгледжаных паасобку на сходах б. Навукова-Тэрмінолёгічнай Комісіі пры Н.К.А.Б. і Інстытуту Беларускае Культуры тэрмінолёгій лёгікі і псыхолёгіі.</p>
	<p>Як першая, так і другая тэрмінолёгіі разглядаліся подлуг дакладу члена Навукова-Тэрмінолёгічнай комісіі і навуковага супрацоўніка Інстытуту Беларускае Культуры М.Байкова.</p>
	<p>Тэрмінолёгія Лёгікі ў першы раз была надрукавана ў часопісе «Весьнік Нар. Ком. Асьветы С.С.Р.Б.», 1922 г., №1, стр. 11-20.</p>
	<p>Пры апрацаваньні лёгічна-псыхолёгічных тэрмінаў мелася на ўвазе зацьвердзіць у сьцісла азначаным сэнсе для навуковага ўжываньня словы, якія ўжываюцца ў жыцьцёвай беларускай мове і зарэгістраваны ў істнуючых слоўніках беларускай мовы І.Насовіча, Я.Ціхінскага, М.Гарэцкага і Ў.Дабравольскага, а таксама ў творах найвыдатнейшых беларускіх пісьменьнікаў новага часу. У частковасьці, дзеля згоды з народным ужываньнем прыняты для навуковага ўжываньня тэрмін «мазгі» ў множным ліку.</p>
	<p>Таксама ў згоднасьці з народным ужываньнем і з законамі беларускай мовы ўтвораны і нэолёгізмы, якія зьяўляюцца патрэбнымі для перадачы навуковых паняцьцяў.</p>
	<p>У першы раз зьяўляюцца ў друку гэткія новатворы: адцягненьне (№3 слоўніка), адцягнены (2), самарух (5), зваротнаспадчыннасьць (42), зваротнаспадчынны (43), нізкавокасьць (65), наданьне (103), наданы (104), узбуджлівасьць (105), зьлішвольле (151), зьлішпамяць (152), разгалосьсе (199), жыцьцёчыннасьць (241), самазахаваньне (303 і 784), унутранагляданьне (310), унутранаглядальны (309), сугалосьсе (340), асерадкаваньне (342), прамежак (409), мозачкі (432), прычэпная думка (444), даасяродкавы (492), назвазбор (496), абвяржэньне (542), восевальцавы адростак (551), кравазваротны (581), цёпластан (578), прыстасаванасьць (681), прасторавы (697), працяжальнасьць (708), працяжальны (709), саманездавальненьне (781), самаздавальненьне (785), сеткавіца (794), агульна-зацьвярджальны (874), агульна-адмоўны (875), часткова-зацьвярджальны (884), часткова-адмоўны (885), часамер (999), часагляд (1000), крышталёк (1001), чатырохпагор'е (1037), адчувальны, пачувальны (1034 і 1065), чуламер (1087).</p>
	<p>З тэрмінаў, увайшоўшых у склад расійскай лёгічна-псыхолёгічнай тэрмінолёгіі з іншых моваў, перакладзены на беларускую мову тыя тэрміны, якія захавалі ў навуковым ужываньні свой першастковы сэнс, напр., «ассоциация», «активность» і інш.</p>
	<p>Тэрміны, якія атрымалі штучны навуковы сэнс, як, напр., «ганглий», «рефлекс», «силлогизм» і інш., ці азначаюць паняцьці, у тлумачэньні якіх няма згоднасьці паміж прадстаўнікамі навукі, як, напр., «апперцепция», «аффект» і інш., застаўлены без перакладу і толькі пераданы ў беларускай транскрыпцыі.</p>
	<p>Тэрмінолёгія апрацавана ў аб'ёме курсу лёгікі і псыхолёгіі ў школах сярэдняга тыпу.</p>
	<p><i>Дакладчык М.Байкоў</i></p>
	<p>г. Менск 1923-V-19</p>
</div>
##HTMLDescription_END
##ArticleLang: ru/be

абсолютный	абсолютны
абстрактный	абстрактны, адцягнены
абстракция	абстракцыя, адцягненьне
абулия	абулія, бязвольле
автоматизм	аўтоматызм, самарух
автоматическое восприятие	аўтоматычнае ўспрыйманьне
аграфия	аграфія
адаптация	адаптацыя, прызвычаенасьць
аккомодация	акомодацыя, прыстасаваньне
аккорд	акорд
аксиома	аксіома, пэўнік
активность	актыўнасьць, дзейнасьць
актуальность	актуальнасьць, здольнадзейнасьць
алексия	алексія
альтернатива	альтэрнатыва
альтруизм	альтруізм
альтруистический	альтруістычны
амнезия	амнэзія, бяспамяцьце
анализ	аналіз, расклад
аналитический	аналітычны, раскладовы
аналогический	аналёгічны
аналогия	аналёгія
анкетный метод	анкетны, запытальны мэтод
анальгезия	анальгэзія, бязбольле
антагонистический цвет	супраціўны, або дадатковы колер
антитезис	антытэзіс, проціпалажэньне
анестезия	анэстэзія, нячуласьць
апатия	апатыя, апешаласьць
аподосис	аподосіс, вынік
апперцептивный	апэрцэпцыйны
апперцептивное внимание	апэрцэпцыйная ўвага
апперцепция	апэрцэпцыя
аргумент	аргумэнт, довад
ассимиляция	асіміляцыя, упадабленьне
ассоциация представлений	злучэньне прадстаўленьняў
ассоциация несвободная	злучэньне несвабоднае
ассоциация свободная	злучэньне свабоднае
ассоциация по смежности	злучэньне па сумежнасьці
ассоциация по сходству	злучэньне па падобнасьці
ассоциация по контрасту	злучэньне па супраціўнасьці
ассоциативный	злучальны
атавизм	зваротнаспадчыннасьць
атавистический	зваротнаспадчынны
атаксия	атаксія
атрибут	атрыбут, прыналежнасьць
афазия	афазія
аффект	афэкт
аффекты астенические	афэкты прыгнятаючыя
аффекты стенические	афэкты ўзбуджаючыя
аффективный	афэктыўны
безвкусность	нясмачнасьць
безобразие	брыдота
безумие	шаленства
беспорядок	непарадак
бессилие	нязмога
бессознательный	бесьсьвядомы, няпрытомны
бесстыдство	бессаромнасьць
биение (<i>d. Schwebung</i>)	біцьцё
бинокулярное зрение	двухвочны зрок
бинокулярный контраст	двухвочны контраст
биология	біолёгія
биологический	біолёгічны
благозвучие	мілагучнасьць
блеск	блеск
близорукость	нізкавокасьць
боковое поле зрения	бочнае поле зроку
боль	боль
большой мозг (<i>cerebrum</i>)	вялікія мазгі
боязнь	боязьнь
бред	брэд
бредовые идеи	брэдавыя думкі
вдохновение	натхненьне
вера	вера
вероятность	праўдападобнасьць
веселость	вясёласьць
вещь (категория)	рэч
взаимность	узаемнасьць
взгляд	пагляд
вид (<i>species</i>)	від
видовой	відавы
видовое различие (<i>differentia specifica</i>)	відавая розьніца
вкус	смак
вкус горький	смак горкі
вкус кислый	смак квасны
вкус металлический	смак мэталічны
вкус пресный	смак прэсны
вкус сладкий	смак салодкі
вкус соленый	смак салоны
вкус щелочной	смак лужны
вкусовые клетки	смакавыя каморкі
вкусовые почки (луковицы)	смакавыя пупашкі
влечение	пацяга
внимание	увага
внимание внешнее	увага знадворная
внимание внутреннее	увага ўнутраная
внимание непроизвольное	увага мімавольная
внимание произвольное	увага адвольная
внешний мир	знадворны сьвет
внешний опыт	знадворнае дасьведчаньне
внутреннее ухо (<i>labirinthus</i>)	унутранае вуха
внутренний опыт	унутранае дасьведчаньне
внушение	наданьне
внушенный	наданы
возбудимость	узбуджлівасьць
возбуждение (<i>d. Erregung</i>)	узбуджэньне
возбуждение периферическое	узбуджэньне павярхоўнае
возбуждение центральное	узбуджэньне асяродкавае
возвышенное (<i>sublime, erhabene</i>)	узноснае
воззрение (<i>d. Anschauung</i>)	погляд
возможность	магчымасьць
возможный	магчымы
возражение	пярэчаньне
волевой акт	валявы акт
волевой акт простой	валявы акт просты
волевой акт сложный	валявы акт складаны
волнение	узбурэньне
волокно нервное	валакно нэрвовае
волюнтаризм	волюнтарызм
волюнтаристический	волюнтарыстычны
воля (<i>voluntas</i>)	воля
воображение	выабражэньне
воображение воспроизводящее	выабражэньне аднаўляючае
воображение построительное творческое	выабражэньне будаўнічае творчае
воспоминание	успамінаньне
восприятие (<i>perceptio</i>)	успрыйманьне
воспроизведение (<i>reproductio</i>)	аднаўленьне
восстановление нервного вещества	адбудова нэрвовай матэрыі
восторг	захапленьне
впечатление (<i>d. Eindruck</i>)	уражаньне
впечатлительность	уражлівасьць
время	час
время объективное	час сапраўдны
время субъективное	час уяўны
всеобщность	агульнасьць
вспомогательный	дапаможны
выбор мотивов	выбар матываў
вывод	вывад
выражение чувств	выраз пачуцьцяў
высший род (<i>summum genus</i>)	найвышэйшы род
вычисление вероятности	вылічэньне праўдападобнасьці
галлюцинация	здань
ганглий (<i>ganglium</i>)	ганглі
ганглиозная клетка	ганглійная каморка
гармония	суладзьдзе
генезис	гэнэзіс, узьнікненьне
генетический	гэнэтычны
гениальность	гэніяльнасьць
гений	гэні
гетеронимные изображения	непадобныя вобразы
гипербулия	гіпэрбулія, зьлішвольле
гипермнезия	гіпэрмнэзія, зьлішпамяць
гипноз	гіпноз
гипотеза	гіпотэза, дапушчэньне
гипотетический	гіпотэтычны, дапушчальны
глаз	вока
глаз близорукий	вока нізкае
глаз дальнозоркий	вока далёказрочнае
глаз нормальный	вока звычайнае
глухота психическая	глухата псыхічная
гнев	гнеў
голод	голад
гомонимные изображения	падобныя вобразы
гордость	гардасьць
горе	гора
графический образ	пісоўны, графічны вобраз
графическое измерение времени	графічны вымер часу
графическое изображение функций	графічны нарыс функцый
графическая регистрация движений	графічны запіс рухаў
грусть	журба
давление	ціск
дальнозоркость	далёказрочнасьць
дальтонизм	дальтонізм
движение	рух
движения автоматические	рухі аўтоматычныя
движения импульсивные	рухі імпульсіўныя
движения инстинктивные	рухі інстынктыўныя
движения непроизвольные	рухі мімавольныя
движения произвольные	рухі адвольныя
движения рефлективные	рухі рэфлексіўныя
двойное сознание	падвойная сьвядомасьць
двойственное изображение	падвойны вобраз
дедукция	дэдукцыя, вывядзеньне
дедуктивный	дэдукцыйны, выводны
действие	дзеяньне
действительность	рэчавістасьць
действительный	рэчавісты
деление (<i>divisio</i>)	падзел
деление адекватное, соразмерное	падзел прыроўнены
деление исчерпывающее	падзел вычэрпываючы
деление непрерывное	падзел неперарыўны
деление перекрестное	падзел крыжавы
деление последовательное	падзел пасьлядовы
делимое (<i>totum dividendum</i>)	падзельнае
детерминизм	дэтэрмінізм
дилемма	дылема
дискурсивный	дыскурсіўны
диссимиляция	дысіміляцыя
диссонанс	разгалосьсе
дифференциация	дыфэрэнцыяцыя, разрозьненьне
дихотомия	дыхотомія, двохчленны падзел
длительность	працягласьць
добро	дабро
добродетель	цнота
доброта	дабрата
доверие	давераньне
доказательство	довад
доказательство прямое	довад просты
доказательство от противного	довад ад супраціўнага
долг	абавязак
долженствование	абавязковасьць
должное	абавязковае
доля мозга	доля мазгоў
доля мозга височная	доля мазгоў скроневая
доля мозга затылочная	доля мазгоў патылічная
доля мозга лобная	доля мазгоў лобная
доля мозга темянная	доля мазгоў цемянная
досада	дакука
достоверность	пэўнасьць
достоверный	пэўны
дружба	сяброўства
дуализм	дуалізм
дума	дума
дух (<i>spiritus, pneuma</i>)	дух
духовный	духоўны
душа (<i>anima, psyche</i>)	душа
душевный	душэўны
душевная болезнь	душэўная хвароба
душевная деятельность	душэўная дзеяльнасьць
душевная жизнь	душэўнае жыцьцё
душевное переживание	душэўнае перажываньне
душевное состояние	душэўны стан
душевное явление	душэўная зьява
едва заметное ощущение	ледзь прыметнае адчуваньне
единство	адзінства
естественный	натуральны, прыродны
жажда	смага
жалость	літасьць
желание	жаданьне
желтое пятно (<i>macula lutea</i>)	жоўтая плямка
жизнедеятельность	жыцьцёчыннасьць
жизненность	жыцьцёвасьць
жизнь	жыцьцё
забвение	забыцьцё
заблуждение	аблуда
забота	клопат
забывание	забываньне
забывчивость	забыўчасьць
зависть	завісьць, зайздрасьць
заключение (<i>conclusio</i>)	заключэньне
закон достаточного основания	закон выстарчаючай асновы
закон исключенного третьего	закон выключанага трэцяга
закон противоречия	закон супярэчнасьці
закон тождества	закон тожсамасьці
закон специфической энергии	закон спэцыфічнай энэргіі
законы мышления	законы мысьленьня
законы природы	законы прыроды
заместитель понятия	падмяняльнік паняцьця
замещение (<i>substitutio</i>)	замяшчэньне
запах	пах
запахи неприятные	пахі няпрыемныя
запахи приятные	пахі прыемныя
запоминание	запамінаньне
звук (<i>d. Laut</i>)	зык, гук
звуковой	зыкавы, гукавы
звуковой анализ	расклад зыкаў, гукаў
зловоние	смурод
злорадство	злорадасьць
знание	веда
зрение	зрок
зрение непрямое	зрок няпросты
зрение прямое	зрок просты
зрительный (<i>nervus opticus</i>)	зрокавы
зрительный нерв	зрокавы нэрв
зрительный пурпур (эритропсин)	зрокавая багра
идеализм	ідэалізм
идея	ідэя, думка
идиотизм	ідыётызм
измерение психических процессов	вымер псыхічных процэсаў
изумление	зьдзіўленьне
иллюзия	ілюзія
импульс	імпульс
имя (<i>nomen</i>)	імя
имя нарицательное (<i>apellativum</i>)	імя назоўнае, звычайнае
имя собственное (<i>proprium</i>)	імя ўласнае
индетерминизм	індэтэрмінізм
индивидуальность	асабовасьць, асабістасьць
индивидуальный	асабовы, асабісты
индивидуум	асоба, індывідуум
индуктивный	індукцыйны, наводны
индукция	індукцыя, навядзеньне
индукция научная	індукцыя навуковая
индукция неполная  (<i>incompleta</i>)	індукцыя няпоўная, незакончаная
индукция полная  (<i>completa</i>)	індукцыя поўная, закончаная
индукция популярная	індукцыя папулярная
индукция чрез простое перечисление  (<i>per enumerationem simplicem</i>)	індукцыя праз простае пералічэньне
индукция цветовая	індукцыя каляровая
индуцируемый цвет	індуцыяваны колер
индуцирующий цвет	індуцыючы колер
инстинкт	інстынкт
инстинкты воспроизведения	інстынкты вытварэньня
инстинкты питания	інстынкты кармленьня
инстинкты самосохранения	інстынкты самазахаваньня
интеллект	інтэлект, розум
интеллектуализм	інтэлектуалізм
интеллектуальный	разумовы, інтэлектуальны
интенсивность	напруджанасьць, сіла
интерес	інтарэс, цікавасьць
интроспективный	інтроспэкцыйны, унутранаглядальны
интроспекция	інтроспэкцыя, унутранагляданьне
интуитивный	інтуіцыйны
интуиция	інтуіцыя
исполнение	выкананьне, спаўненьне
испуг	сполах
исследование	дасьледваньне
истина	праўда, ісьціна
истинность	сапраўднасьць
истинный	сапраўдны
категория	катэгорыя
категорический	бязумоўны
качественный	якасны
качество	якасьць
качество ощущения	якасьць або зьмест адчуваньня
класс	кляса
классификация	клясыфікацыя
классификация естественная	клясыфікацыя натуральная
классификация искусственная	клясыфікацыя штучная
колбочка	коўбачка
колебание	віханьне
количественный	колькасны
количество	колькасьць
коллективный предмет	зборны прадмет
колющая боль	колючы боль
комбинаторная деятельность	сукладальная дзеяльнасьць
комбинация	сукладаньне
комическое	камічнае
комочки Ниссля  (<i>Nissl-Schollen</i>)	камачкі Нісьля
компликация	спляценьне
конкретный	прадметны
консонанс	сугалосьсе
контраст	контраст, супраціўнасьць
концентрация сознания	асярадкаваньне сьвядомасьці
концептуализм	концэптуалізм
концепция	концэпцыя, паняцьце
координация движений	узгадненьне рухаў
кора головного мозга	кара галаўных мазгоў
кортиев орган	орган або прыладзьдзе Корці
кортиева перепонка	корціева перапонка
кортиевы дуги	корціевы дужкі
коэффициент внимания	паказальнік увагі
коэффициент запоминания	паказальнік запамінаньня
красота	хараство
критерий	крытэрыум
критический	крытычны
круг в доказательстве  (<i>circulus in demonstrando</i>)	круг у довадзе
круг в определении  (<i>circulus in definiendo</i>)	круг у азначэньні
лемма	лема
лемматический	лематычны
личность	асоба
личный	асабовы
логика	лёгіка
логический	лёгічны
логическая точка зрения	лёгічны погляд
ложность	непраўдзівасьць
локализация психических процессов	умяшчэньне псыхічных процэсаў
локальный знак  (<i>Lokalzeichen</i>)	мясцовы знак
любовь	любоў, каханьне
любознательность	цікавасьць
мания	манія
мания преследования	манія прасьледаваньня
материализм	матэрыялізм
материя	матэрыя
материя суждения	істота суджэньня
мегаломания	манія вялікасьці
медиум	мэдыум, пасрэднік
меланхолия	мэлянхолія
место (категория)	месца
метод научный	мэтод навуковы
метод аналитический	мэтод аналітычны
метод дедуктивный	мэтод дэдукцыйны
метод индуктивный	мэтод індукцыйны
метод синтетический	мэтод сынтэтычны
метод психологический	мэтод псыхолёгічны
метод биогенетический	мэтод біогенэтычны
метод эмпирический	мэтод эмпірычны, дасьвядчальны
метод экспериментальный	мэтод экспэрымэнтальны, спробны
методический	мэтодычны
методология	мэтодолёгія
методология общая	мэтодолёгія агульная
методология специальная	мэтодолёгія спэцыяльная
методы индуктивного исследования	мэтоды індукцыйнага дасьледаваньня
метод согласия	мэтод згоднасьці
метод разницы	мэтод розьніцы
метод остатков	мэтод астач
метод сопутствующих изменений	мэтод наступных зьмен
методы исследования памяти	мэтоды дасьледаваньня памяці
метод выучивания  (<i>Erlernungsmethode</i>)	мэтод вывучваньня
метод удачных случаев  (<i>Treffermethode</i>)	мэтод удалых выпадкаў
метод помощи  (<i>M. d. Hilfe</i>)	мэтод дапамогі
метод размещения  (<i>M. d. Ordnung</i>)	мэтод разьмяшчэньня
метод сбережения	мэтод ашчаднасьці
метод тожественных рядов  (<i>M. d. identischen Reihe</i>)	мэтод тожсамых радоў
метод удержанных членов  (<i>M. d. behaltenen glieder</i>)	мэтод захаваных членаў
методы психофизические	мэтоды псыхофізычныя
методы верных и неверных случаев	мэтоды пэўных-няпэўных выпадкаў
методы минимальных изменений	мэтоды найменшых зьмен
методы постоянных раздражений	мэтоды сталых узбуджэньняў
методы пределов	мэтоды граніц
методы равных интервалов	мэтоды роўных прамежкаў
методы сверхзаметных различий	мэтоды надпрыметных розьніц
методы средних градаций	мэтоды сярэдніх ступяней
методы средних ошибок	мэтоды сярэдніх памылак
мимика	міганьне, міміка
мимический	мігоўны, мімічны
миросозерцание	сьветапогляд
мнемоника	мнэмоніка
мнемонический	мнэмонічны
мнение	зданьне
мнимый	зданьнёвы, уяўны
множество	мноства
модус силлогизма	модус, від сылёгізму
модус деструктивный	модус руйнуючы
модус конструктивный	модус будоўны
мозг  (<i>cerebrum</i>)	мазгі
мозг головной  (<i>cerebrum cephalis</i>)	галаўныя мазгі
мозг продолговатый  (<i>cerebrum medulla oblongata</i>)	прадоўжныя мазгі
мозг спинной  (<i>cerebrum spinalis</i>)	хрыбтовыя мазгі
мозговая борозда  (<i>fiscura cerebrum</i>)	мазгавая баразна
мозговая извилина  (<i>gyrus cerebrum</i>)	мазгавая зьвіліна
мозговые ножки  (<i>crara s. pedunculi cerebri</i>)	мазгавыя ножкі
мозговые полушария	паўкульлі мазгоў
мозжечок  (<i>cerebellum</i>)	мозачкі
монизм	монізм
монокулярное зрение	аднавочны зрок
моральный	моральны
мост Варолиев  (<i>pons Varolii</i>)	мост Вароліеў
мотив	мотыў
моторный	рухавы
мысль	думка, мысьль
мыслительный процесс	мысьлёвы процэс
мышление	мысьленьне
наблюдение  (<i>observatio</i>)	нагляданьне, спасьцярога
наведение  (<i>inductio</i>)	навядзеньне
навязчивая идея  (<i>ideefixe</i>)	прычэпная думка
надежда	надзея
надменность	пагарднасьць
название	назва
наивность	наіўнасьць
наивный	наіўны
наклонность	нахіл
намерение	намер
напряжение	напруджаньне
наслаждение	асалода
наследственность	спадчыннасьць
настроение  (<i>d. Verfassung</i>)	настрой
насыщенность цвета	згушчаннасьць колеру
нативизм	натывізм
нативистический	натывістычны
наука	навука
научный	навуковы
неверие	нявера
невинность	нявіннасьць
негодование	абурэньне
недоброжелательство	нязычлівасьць
недоверие	недавера
недостаток	недахват, недастача
недостоверность	няпэўнасьць
недостоверный	няпэўны
недоумение	неўразуменьне
нейрон	нэўрон
нейрофибрилла	нэўрофібрыла
ненависть	ненавісьць
необходимость	канечнасьць, неабходнасьць
необходимый	канечны, неабходны
неопределенный	неазначаны
неочевидный	невідавочны
непосредственный	беспасрэдні
непостоянство	нясталасьць
неприятность	няпрыемнасьць, прыкрасьць
неприятный	няпрыемны, прыкры
нерв  (<i>nervus</i>)	нэрв
нервная клетка	нэрвовая каморка
нервная система	нэрвовая сыстэма
нервное вещество	нэрвовая матэрыя
нервное окончание	нэрвовы канчатак
нервный отросток	нэрвовы адростак
нервный пучок	нэрвовы пучок
невроз	нэрвоз
нервы двигательные	нэрвы рухавыя
нервы чувствительные	нэрвы адчувальныя
нервы центробежные	нэрвы адсяродкавыя
нервы центростремительные	нэрвы даасяродкавыя
несогласие	нязгода
нечаянность	неспадзеўнасьць
нечувствительность	нячуласьць
номенклатура	назвазбор
номинализм	номіналізм
норма	норма
нормативный	норматыўны
нрав	абычай
нравственность	абычайнасьць
нравственный	абычайны
нюанс	адценьне
обертон	обэртон, дадатковы тон
объект	об'ект
объективный	об'ектыўны
объективное наблюдение	знадворнае нагляданьне, знадворная спасьцярога
объектирование ощущений	об'ектаваньне адчуваньняў
объем внимания	аб'ём увагі
объем понятия	аб'ём паняцьця
объем сознания	аб'ём сьвядомасьці
обида	крыўда
обобщение	абагульненьне
обоняние	нюх
обонятельные клетки	нюхальныя каморкі
обонятельный нерв  (<i>nervus olfactorius</i>)	нюхальны нэрв
образ	вобраз
образ родовой	вобраз радавы
обращение  (<i>conversio</i>)	зьвярненьне паняцьцяў
обращение чистое  (<i>conversio simplex</i>)	зьвярненьне простае
обращение через ограничение  (<i>conversio per limitationem</i>)	зьвярненьне праз агранічэньне
обстоятельство	акалічнасьць
обсуждение	меркаваньне
обычай  (<i>mos</i>)	звычай
общее представление	агульнае прадстаўленьне
общее чувство  (<i>coenaestesia</i>)	агульнае пачуцьцё
обязанность	абавязак
ограничение  (<i>determinatio</i>)	агранічэньне
одновременность	адначаснасьць
одновременный контраст	адначасны контраст
однообразие	аднастайнасьць
однообразие природы	аднастайнасьць прыроды
онтогенез	онтогэнэзіс
онтогенетический	онтогэнэтычны
опасение	небясьпечнасьць
определение понятий  (<i>definitio notionum</i>)	азначэньне паняцьцяў
определение понятий адэкватное	азначэньне паняццяў прыроўненае
определение понятий точное	азначэньне паняццяў дакладнае
определение понятий ясное	азначэньне паняццяў яснае
определяемое  (<i>definiendum</i>)	азначальнае
определяющее  (<i>definiens</i>)	азначаючае
опровержение	абвяржэньне
опыт — empiria	дасьведчаньне
опыт — experimentum	спроба, экспэрымэнт
орган	орган або прыладзьдзе
организм	організм
организованная материя	організаваная матэрыя
органический	органічны
органы внешних ощущений	органы або прыладзьдзі знадворных адчуваньняў
осевой цилиндр	восевы валец
осевоцилиндрический отросток	восевальцовы адростак
основание деления  (<i>fundamentum divisionis</i>)	аснова або падстава падзелу
основная ошибка  (<i>error fundamentalis</i>)	аснаўная абмылка
осязание	дотык
осязательная клетка	датыкальная каморка
осязательное тельце	датыкальнае цяльцо
осязательный нерв	датыкальны нэрв
отвращение	агіда
отвратительный	агідны
отношение	адносіны, стасунак
относительный	адносны
отолиты	отоліты
отрицание  (<i>negatio</i>)	адмова
отрицательный	адмоўны
отчаяние	роспач
очевидный	відавочны
ошибка	абмылка, памылка
ошибка мнимой всеобщности	абмылка (памылка) зданьнёвай або ўяўнай агульнасьці
ошибка поспешного обобщения	абмылка (памылка) пасьпешнага абагульненьня
ошибочность	абмылковасьць, памылковасьць
ощущение  (<i>d. Empfindung</i>)	адчуваньне
ощущения внешние	адчуваньні знадворныя
ощущения вкусовые	адчуваньні смакавыя або смаку
ощущения зрительные	адчуваньні зрокавыя або зроку
ощущения обонятельные	адчуваньні нюхальныя або нюху
ощущения осязательные, кожные	адчуваньні датыкальныя або дотыку, скурныя
ощущения слуховые	адчуваньні слухавыя або слуху
ощущения температурные	адчуваньні тэмпэратуры або цёпластану
ощущения внутренние	адчуваньні ўнутраныя
ощущения дыхательные	адчуваньні дыхальныя
ощущения кровообращения	адчуваньні кравазваротныя
ощущения мускульнодвигательные (моторные)	адчуваньні мускульныя, рухавыя або руху
ощущения питания	адчуваньні кармленьня
ощущения половые	адчуваньні родавыя
ощущения равновесия (статические)	адчуваньні раўнавагі
ощущения суставные	адчуваньні сустаўныя
ощущения сухожильные	адчуваньні сухажыльныя
ощущения органические	адчуваньні органічныя
память  (<i>memoria</i>)	памяць
память механическая	памяць мэханічная
память рассудочная	памяць рассудкавая
память специальная	памяць спэцыяльная
пантомимика	пантоміміка
пантомимическое движение	пантомімічны рух
паралогизм	паралёгізм
переменное раздражение	зьменнае раздражненьне
перестановка внимания	перастаноўка ўвагі
перестановка положительная	перастаноўка простая
перестановка отрицательная	перастаноўка адмоўная
перестановка посылок	перастаноўка пасылак
печаль	смутак
плюрализм	плюралізм
побуждение  (<i>d. Antrieb</i>)	пабудка
поведение  (<i>a conduct</i>)	трыманьне
подвижность	рухавасьць
подзаметное ощущение	падпрыметнае адчуваньне
подозрительность	падазрэнасьць
подражание	пасьледаваньне, перайманьне
подсознательный	падсьвядомы
подчинение понятий  (<i>ordinatio notionum</i>)	падлегласьць паняцьцяў
познавательный процесс	пазнавальны процэс
познание	пазнаньне
поле зрения	поле зроку
поле сознания	поле сьвядомасьці
полисиллогизм	полісылёгізм
полисиллогизм прогрессивный	полісылёгізм паступовы
полисиллогизм регрессивный	полісылёгізм адступовы
положение (научное)	палажэньне
положение  (<i>positio</i>)	становішча
положительный	станоўчы, дадатні
полукружные каналы  (<i>canales semicirculares</i>)	паўкружныя каналы
полутон	паўтон
помешательство	шаленства
понимание	разуменьне
понятие  (<i>conceptus</i>)	паняцьце
понятие видовое	паняцьце відавое
понятие родовое	паняцьце радавое
понятие подпротивное	паняцьце падсупраціўнае
понятие подчиненное	паняцьце падлеглае
понятие противное	паняцьце супраціўнае
понятие противоречащее	паняцьце супярэчнае
понятие равнозначащее	паняцьце раўназначнае
понятие соподчиненное	паняцьце супадлеглае
понятия несравнимые	паняцьці непараўнаныя
понятия скрещивающиеся  (<i>inter se convenientes</i>)	паняцьці зьбежныя
порог ощущения  (<i>d. Schwelle d. Empfindung</i>)	парог адчуваньня
порог абсолютный	парог абсолютны
порог разностный	парог розьнічны
порог верхний  (<i>d. Ober-Schwelle</i>)	парог верхні
порог нижний  (<i>d. Unterschieds-Schwelle</i>)	парог ніжні
порог средний	парог сярэдні
последовательное изображение	пасьлядовы вобраз
последующий	наступны
посредственный	пасрэдні
постоянство	сталасьць
посылка  (<i>missa</i>)	пасылка
посылка большая  (<i>missa major</i>)	пасылка большая
посылка меньшая  (<i>missa minor</i>)	пасылка меншая
потребность  (<i>d. Bedurfniss</i>)	патрэба
правило	правіла
правильный	правільны
превращение  (<i>obversio</i>)	перавярненьне
предикат	сказоўнік, прэдыкат
предложение	сказ
предмет	прадмет
предрасположение	нахільнасьць
представление  (<i>d. Vorstellung</i>)	прадстаўленьне
представление единичное	прадстаўленьне адзіночнае
представление общее	прадстаўленьне агульнае
представление простое	прадстаўленьне простае
представление составное	прадстаўленьне складанае
предчувствие	прадчуцьцё
предыдущий	папярэдні
приблизительное обобщение	прыблізнае абагульненьне
привычка	прывычка
привычный	прывычны
признак понятия	азнака паняцьця
признак видовой	азнака відавая
признак родовой	азнака радавая
признак существенный	азнака істотная
признак несущественный	азнака няістотная
признак собственный	азнака ўласная
признак случайный  (<i>accidens</i>)	азнака выпадковая
признак отделимый	азнака разлучная
признак неотделимый	азнака неразлучная
призрак	здань, мара
прикосновение	датыканьне, дотык
принадлежность	прыналежнасьць
припоминание	прыпамін
приспособление	прыстасаваньне
приспособляемость	прыстасаванасьць
причина	прычына
причинность	прычыннасьць
причинное отношение	прычынны стасунак
приязнь	спрыяньне
приятность	прыемнасьць
приятный	прыемны
проблема	проблема
проблематический	проблематычны
проверка гипотезы	паверка гіпотэзы, дапушчэньня
проводимость нерва	праводнасьць нэрва
продолжительность	працягласьць
производные законы	вывадныя законы
произвольный	адвольны
просиллогизм	папярэдні сылёгізм
пространство	прастора
пространственный	прасторавы
пространственное восприятие	прасторавае ўспрыйманьне
пространственное отношение	прасторавы стасунак
протасис	протасіс, умова
противность	супраціўнасьць
противный  (<i>contrarius</i>)	супраціўны
противоречащий  (<i>contradictorius</i>)	супярэчны
противоречие	супярэчнасьць
противоположность	процілежнасьць
противоположный	процілежны
противопоставление	процістаўленьне
протяженность	працяжальнасьць
протяженный	працяжальны
психическая дефективность	псыхічная дэфэктыўнасьць
психический акт	псыхічны акт
психический процесс	псыхічны процэс
психоанализ	псыхоаналіз
психологический закон	псыхолёгічны закон
психологический эксперимент	псыхолёгічны экспэрымэнт
психология	псыхолёгія
психология генетическая	псыхолёгія гэнэтычная
психология животных	псыхолёгія жывёлаў
психология измерительная	псыхолёгія вымерная
психология индивидуальная	псыхолёгія асабовая
психология коллективная	псыхолёгія колектыўная
психология народов	псыхолёгія народаў
психология объективная	псыхолёгія об'ектыўная
психология общая	псыхолёгія агульная
психология ребенка	псыхолёгія дзіцяці
психология рациональная	псыхолёгія рацыянальная
психология сравнительная	псыхолёгія параўнаўчая
психология субъективная	псыхолёгія суб'ектыўная
психология физиологическая	псыхолёгія фізыолёгічная
психология функциональная	псыхолёгія функцыянальная
психология экспериментальная	псыхолёгія экспэрымэнтальная
психология эмпирическая	псыхолёгія эмпірычная, або дасьвядчальная
психометрия	псыхомэтрыя
психопатология	псыхопатолёгія
психотехника	псыхотэхніка
психофизика	псыхофізыка
психофизический закон	псыхофізычны закон
психофизический параллелизм	псыхофізычная раўналежнасьць
радость	радасьць
развитие	разьвіцьцё
раздвоение личности	дваеньне асобы
раздвоение внимания	дваеньне ўвагі
раздражение  (<i>d. Reiz</i>)	раздражненьне
раздражение нормальное	раздражненьне нормальнае
раздражение ошибочное  (<i>Fehlreiz</i>)	раздражненьне абмылковае
раздражимость	раздражлівасьць
раздражитель	раздражальнік
раздражитель звуковой	раздражальнік гукавы
раздражитель зрительный	раздражальнік зрокавы
раздражитель губной	раздражальнік губны
раздражитель реактивный	раздражальнік рэакцыйны
различение	адрозьненьне
размышление	размысьленьне
разум	розум
расположение	падабаньне
расположение духа	настрой духу
распределение объемов S и P	разьмеркаваньне аб'ёмаў S i P
распределение повторений	разьмеркаваньне паўтарэньняў
рассеянность	раскіданасьць
рассудок	рассудак, развага
рассуждение	разважаньне
реакция	рэакцыя
реакция простая	рэакцыя простая
реакция сложная	рэакцыя складаная
реакция ассоциативная	рэакцыя злучальная
реакция выбора	рэакцыя выбару
реакция различения	рэакцыя адрозьненьня
реакция узнавания	рэакцыя пазнаваньня
реализм	рэалізм
реализм критический	рэалізм крытычны
реализм наивный	рэалізм наіўны
ревность  (<i>d. Eifer</i>)	зайздрасьць, рупнасьць
режущая боль	рэжучы боль
рефлекс	рэфлекс
рефлексивный	рэфлексіўны
рефлексология	рэфлексолёгія
род  (<i>genus</i>)	род
самонаблюдение	саманагляданьне, самаспасьцярога
самонаблюдение непосредственное	саманагляданьне беспасрэдняе, самаспасьцярога беспасрэдняя
самонаблюдение опосредствованное	саманагляданьне пасрэдняе, самаспасьцярога пасрэдняя
самонеудовлетворение	саманездавальненьне
самопознание	самапазнаньне
самосознание	самасьвядомасьць
самосохранение	самазахаваньне
самоудовлетворение	самаздавальненьне
самочувствие	самачуцьце
сведение силлогизмов	зьвядзеньне сылёгізмаў
свет	сьвятло
свобода	вольнасьць, свабода
свобода воли	свабода волі
свободное дыхание	вольнае дыханьне
связка  (<i>copula</i>)	злучнік
сенсуализм	сэнсуалізм
сетчатка  (<i>retina</i>)	сеткавіца
сила	моц, сіла
сила ощущения	сіла адчуваньня
силлогизация	сылёгізацыя, складаньне сылёгізмаў
силлогизм	сылёгізм
силлогизм категорический	сылёгізм бязумоўны
силлогизм разделительный	сылёгізм падзельны
силлогизм сложный	сылёгізм складаны
силлогизм сокращенный	сылёгізм скарочаны
силлогизм условно-разделительный	сылёгізм умоўна-падзельны
силлогизм условный	сылёгізм умоўны
силлогистика	сылёгістыка
силлогистический	сылёгістычны
симпатия	спагада
симпатический	спагадны
симпатический нерв  (<i>nervus sympathicus</i>)	сымпатычны нэрв
симпатическое подражание	спагаднае перайманьне
синтез	сынтэз, склад
синтетический	сынтэтычны, складовы
система	сыстэма, уклад
систематический	сыстэматычны, укладовы
склонность  (<i>d. Trieb</i>)	нахіл
скорость	хуткасьць
скука	нуда
скупость	скупасьць
слабость	кволасьць
след впечатления	сьлед уражаньня
следствие	вынік
слепое пятно	сьляпая плямка
случай	выпадак
случайный	выпадковы
слух	слух
слуховой нерв  (<i>nervus acusticus</i>)	слухавы нэрв
смех	сьмех
смешение цветов	зьмяшэньне колераў
смирение	пакора
смотрение	глядзеньне
смысл  (<i>sensus</i>)	сэнс
смысл разделительный  (<i>sensus divisus</i>)	сэнс падзельны
смысл собирательный  (<i>sensus compositus</i>)	сэнс зборны
сновидение	сон
совесть  (<i>d. Gewissen</i>)	сумленьне
содержание понятия	зьмест паняцьця
сожаление	шкадаваньне
созвучие  (<i>d. Mittonen</i>)	сугучнасьць
сознание	сьвядомасьць, прытомнасьць
сознательный	сьвядомы, прытомны
сомнамбулизм	сомнабулізм
сомнение  (<i>d. Zweifel</i>)	сумненьне
сон	сон
соображение	меркаваньне
сопротивление	супраціўленьне
состояние	стан
состояние сознания	стан сьвядомасьці
сострадание	спагаданьне
сочувствие	спачуцьце, спачуваньне
софизм	софізм
спесь	пыха
способность	здольнасьць, здатнасьць
сравнение	параўнаньне
средний мозг  (<i>mesocephalon</i>)	сярэднія мазгі
страдание	цярпеньне
страсть	пал
страх	страх
стремление  (<i>d. Bestreben</i>)	імкненьне, парываньне
стыд	сорам
стыдливость	саромлівасьць
субъект	суб'ект, дзейнік
субъективный	суб'ектыўны
субстанция	субстанцыя
суеверие	забабоны
суждение  (<i>judicium</i>)	суджэньне
суждение аналитическое	суджэньне аналітычнае
суждение аподиктическое	суджэньне аподыктычнае, або неабходнасьці
суждение ассерторическое	суджэньне асэрторычнае, або рэчавістасьці
суждение безличное	суджэньне безасабовае
суждение категорическое	суджэньне бязумоўнае
суждение общее	суджэньне агульнае
суждение общеотрицательное	суджэньне агульна-адмоўнае
суждение общеутвердительное	суджэньне агульна-зацьвярджальнае
суждение отрицательное	суджэньне адмоўнае
суждение проблематическое	суджэньне проблематычнае, або праўдападобнасьці
суждение разделительное	суджэньне падзельнае
суждение реальное	суджэньне рэальнае
суждение синтетическое	суджэньне сынтэтычнае
суждение словесное	суджэньне слоўнае
суждение существования (эксистенциальное)	суджэньне істнаваньня
суждение условное	суджэньне ўмоўнае
суждение частное	суджэньне частковае
суждение частно-отрицательное	суджэньне часткова-адмоўнае
суждение частно-утвердительное	суджэньне часткова-зацьвярджальнае
существенный	істотны
существо	істота
существование	істнаваньне
сущность	істнасьць
сытость	сыць
тавтология  (<i>idem per idem</i>)	тожслоўе
талант	талент
талантливость	талентнасьць
тахистоскоп	тахістоскоп
твердость	цьвёрдасьць
творчество	творчасьць
тезис	тэзіс, палажэньне
тембр	тэмбр
темперамент	тэмпэрамэнт
темперамент меланхолический	тэмпэрамэнт мэлянхолічны
темперамент сангвинический	тэмпэрамэнт сангвінічны
темперамент флегматический	тэмпэрамэнт флегматычны
темперамент холерический	тэмпэрамэнт холерычны
тень	цень
теория	тэорыя
теория движений	тэорыя рухаў
теория предрасположения	тэорыя нахільнасьці
теория следов	тэорыя сьлядоў
тепло	цяпло
термин	тэрмін
термин абсолютный	тэрмін абсолютны
термин абстрактный	тэрмін адцягнены
термин больший  (<i>major</i>)	тэрмін большы
термин единичный (индивидуальный)	тэрмін адзіночны
термин конкретный	тэрмін прадметны
термин меньший  (<i>minor</i>)	тэрмін меншы
термин общий	тэрмін агульны
термин относительный	тэрмін адносны
термин отрицательный	тэрмін адмоўны
термин положительный	тэрмін станоўчы
термин собирательный	тэрмін зборны
термин средний  (<i>medius</i>)	тэрмін сярэдні
терминология	тэрмінолёгія
тест	тэст, выпыт
тип памяти	тып памяці
тип памяти безразличный	тып памяці абаякі
тип памяти зрительный	тып памяці зрокавы
тип памяти моторный	тып памяці рухавы
тип памяти слуховой	тып памяці слухавы
тождество	тожсамасьць
тон	тон
тон дифференциальный	тон розьнічны
тон дополнительный	тон дадатковы
тон комбинационный	тон сукладальны
тон музыкальный	тон музычны
тон основной	тон аснаўны
тон парциальный	тон пачасьцінны
тон суммационный	тон злучальны
тоны высокие	тоны высокія
тоны низкие	тоны нізкія
точки сетчатки	пункты сеткавіцы
точки сетчатки диспаратные	пункты сеткавіцы разьбежныя
точки сетчатки соответствующие	пункты сеткавіцы адпаведныя
точки сетчатки тожественные	пункты сеткавіцы тожсамыя
точки тепла	пункты цяпла
точки холода	пункты холаду
тошнота	нудота
трагическое	трагічнае
тревога	трывога
тяжесть	цяжар
убеждение	перакананьне
уверенность	упэўненасьць
удивление	зьдзіўленьне
удовлетворение	здаваленьне
удовольствие	прыемнасьць
ужас	жах
узнавание	пазнаваньне
узость ясного сознания	вузкасьць яснай сьвядомасьці
улитка  (<i>cochlea</i>)	сьлімак
ум	розум
умозаключение	вывад
умозаключение непосредственное	вывад беспасрэдні
умозаключение посредственное	вывад пасрэдні
умозаключение аналогическое	вывад аналёгічны, ад частковага да частковага
умозаключение дедуктивное	вывад дэдукцыйны, ад агульнага да частковага
умозаключение индуктивное	вывад індукцыйны, ад частковага да агульнага
умственный	разумовы
упадок духа	заняпад духу
уравнение контраста	раўнаньне контрасту
уравнение светлоты	раунаньне сьвятлыні
усилие	натуга
условие	умова
усталость	утома
утверждение  (<i>affirmatio</i>)	зацьвярджэньне
утвердительный	зацьвярджальны
учетверение терминов  (<i>quaternio terminorum</i>)	учацьвярэньне тэрмінаў
фантазия	фантазія
фантазия бедная	фантазія бедная
фантазия богатая	фантазія багатая
фантастический образ	фантастычны вобраз
фигура силлогизма	фігура сылёгізму
физиогномика  (<i>d. Physiognomik</i>)	фізыогноміка
физиогномия	фізыогномія, аблічча
физический процесс	фізычны процэс
физиология	фізыолёгія
филогенез	філогэнэзіс
филогенетический	філогэнэтычны
форма силлогизма	форма сылёгізму
формальный	формальны
формула	формула
функция	функция
функциональный	функцыянальны
функциональная зависимость	функцыянальная залежнасьць
характер	характар
характер безнравственный	характар неабычайны
характер нравственный	характар абычайны
холод	холад
хотение	хаценьне
хронометр	часамер
хроноскоп	часагляд
хрусталик  (<i>lins crystallina</i>)	крышталёк
цвет	колер
цвет белый	колер белы
цвет голубой	колер блакітны
цвет желтый	колер жоўты
цвет зеленый	колер зялёны
цвет красный	колер чырвоны
цвет оранжевый	колер аранжавы
цвет пурпурный	колер баграны
цвет серый	колер шэры
цвет синий	колер сіні
цвет фиолетовый	колер фіолетавы
цвет черный	колер чорны
цвета дополнительные	колеры дадатковыя
цвета матовые	колеры цьмяныя
цвета нейтральные	колеры нэўтральныя
цвета спектральные	колеры спэктральныя
цвета яркие	колеры яскравыя
цветной слух	каляровы слух
цветные тени	каляровыя цені
цветовая слепота	каляровая сьлепата
цветовая слепота неполная	каляровая сьлепата няпоўная
цветовая слепота полная	каляровая сьлепата поўная
целесообразное движение	мэтазгодны рух
целесообразность	мэтазгоднасьць
цель	мэта
центр нервный	нэрвовы асяродак
центр нервный ассоциативный	нэрвовы асяродак злучальны
центр нервный задний	нэрвовы асяродак патылічны
центр нервный передний	нэрвовы асяродак пярэдні
центр нервный письма	нэрвовы асяродак пісьма
центр нервный речи	нэрвовы асяродак мовы
центры моторные	асяродкі рухавыя
центры сенсорные	асяродкі адчувальныя
часть  (<i>pars</i>)	частка
частный	частковы
четверохолмие  (<i>corpus quadrigeminus</i>)	чатырохпагор'е
чистота тона	чыстата тону
члены деления  (<i>membra divisionis</i>)	члены падзелу
чувственность	пачуцьцёвасьць
чувственный тон ощущения	пачуцьцёвы тон адчуваньня
чувственный характер	пачуцьцёвы характар
чувствительность	чуласьць
чувствительный	чулы
чувство  (<i>d. Jefuhl</i>)	пачуцьцё
чувства альтруистические	пачуцьці альтруістычныя
чувства высшие	пачуцьці вышэйшыя
чувства индивидуальные	пачуцьці індывідуальныя, асабовыя
чувства качественные	пачуцьці якасныя
чувства неприятные	пачуцьці няпрыемныя
чувства низшие	пачуцьці ніжэйшыя
чувства приятные	пачуцьці прыемныя
чувства продолжительные	пачуцьці працяглыя
чувства сильные	пачуцьці моцныя
чувства слабые	пачуцьці слабыя
чувства социальные	пачуцьці соцыяльныя, або грамадзянскія
чувства физические	пачуцьці фізычныя
чувства формальные	пачуцьці формальныя
чувства эгоистические	пачуцьці эгоістычныя
чувствование	пачуваньне
чувствования интеллектуальные	пачуваньні разумовыя
чувствования моральные	пачуваньні моральныя
чувствования религиозные	пачуваньні рэлігійныя
чувствования эстетические	пачуваньні эстэтычныя
чувствовательный	пачувальны, адчувальны
шероховатость	шурпатасьць
шум	шум
шумы длительные	шумы працяглыя
шумы мгновенные	шумы мгненныя
эволюция	эволюцыя, разьвіцьцё
эволюционная теория	эволюцыйная тэорыя
эгоизм	эгоізм, самалюбства
эксперимент	экспэрымэнт, спроба
experimentum crucis	спроба крыжавая
экспериментальный	экспэрымэнтальны, спробны
экстаз	захапленьне
эмоция	эмоцыя
эмоциональный	эмоцыянальны
эмпирический	эмпірычны, дасьвядчальны
энергия	энэргія
энергия нервная	нэрвовая энэргія
энергетизм	энэргетызм
энергетический	энэргетычны
энтимема	энтымэма, скарочаны сылёгізм
эписиллогизм	наступны сылёгізм
эпихейрема	эпіхэйрэма, злучаны скарочаны сылёгізм
эстезиометр	чуламер
явление природы	зьява прыроды
явление сознания	зьява сьвядомасьці
ярость	ярасьць
