##Title: Слоўнік матэматычнае тэрмінолёгіі (проект) (БНТ)
##HTMLDescription_BEGIN
<div>
	<p class="dictdesc-st">Створана на падставе:</p>
	<p><b>Слоўнік матэматычнае тэрмінолёгіі (проект)</b>. Менск: Інбелкульт, 1927.</p>
</div>
<div>
	<p class="spoiler">Ад Галоўнае Тэрмінолёгічнае Камісіі</p>
	<p>Апрацоўка матэматычнае тэрмінолёгіі была распачата яшчэ ў 1921 г. Матэматычнаю Сэкцыяю Беларускае Навукова-Тэрмінолёгічнае Камісіі. Вынікам гэтае работы зьявіўся проект тэрмінолёгіі элемэнтарнае матэматыкі, які быў надрукованы ў канцы 1922 году.</p>
	<p>Непаўната гэтага проекту, няўдаласьць і штучнасьць некаторых нэолёгізмаў, філёлёгічныя няправільнасьці іншых тэрмінаў, а таксама аддаленасьць апошніх ад інтэрнацыянальнае матэматычнае мовы − выклікалі адпаведную крытыку (на Фіз.-Матэматычнай Конфэрэнцыі ў 1926 г., на Настаўніцкім зьезьдзе ў тым-жа годзе, а таксама ў друку). Гэта прымусіла Галоўную Тэрмінолёгічную Камісію злажыць у 1926 г. спэцыяльную Матэматычную Камісію для перагляду старой тэрмінолёгіі і для апрацоўкі тэрмінолёгіі вышэйшае матэматыкі. У склад гэтае Камісіі Прыродазнаўчаю Сэкцыяю ІБК былі запрошаны: проф. А. Міхайлоўскі, Я. Пятосін, Ул. Дыдырка, К. Гадыцкі-Цьвірка, Ант. Лёсік, Ад. Міцкевіч і А. Круталевіч (апошні ў якасьці старшыні і ўкладчыка пачатковага проекту тэрмінолёгіі).</p>
	<p>Зложаны гэтаю Камісіяю проект тэрмінолёгіі ў ліку 3.551 тэрмінаў быў разгледжаны вясною 1927 г. Галоўнаю Тэрмінолёгічнаю Камісіяю (у складзе старшыні Камісіі Яз. Лёсіка, яе членаў − Ів. Луцэвіча (Янка Купала), Кан. Міцкевіча (Якуб Колас), Л. Цьвяткова і сэкратара А. Гурла) і зацьверджаны з некаторымі зьменамі і папраўкамі для друку ў форме слоўніку матэматычнае тэрмінолёгіі ў дзьвюх мовах − расійскай і беларускай.</p>
	<p>Слоўнік гэты, як і папярэднія тэрмінолёгіі, выходзіць у сьвет, як <i>проект</i>, які ў далейшым можа зьмяняцца, калі запатрабуе таго навуковы досьлед ці пэдагогічная практыка.</p>
	<p>Выпускаючы ў сьвет кожную тэрмінолёгію, Г.-Тэрмінолёгічная Камісія і далей зьбірае тэрмінолёгічны матар’ял − народны і літаратурны, − каб у наступных выданьнях пашыраць і выпраўляць тое, што, на падставе новага матар’ялу, будзе вымагаць належных выправак і дадаткаў.</p>
	<p>Даць дакладную тэрмінолёгію тае ці іншае галіны навукі, якая-б у поўнай меры адпавядала навуковасьці і здавальняла-б пэдагогічную і штодзённую практыку, − справа нялёгкая, і Камісія лічыць, што ўдасканаліць сваю работу яна зможа толькі ў тым выпадку, калі на помач ёй прыдзе актыўная работа ўсіх зацікаўленых асоб і ўстаноў. Вось чаму Камісія зварачаецца да іх з просьбаю дапамагчы ёй у цяжкай справе распрацаваньня беларускае навуковае тэрмінолёгіі.</p>
	<p>Сабраны тэрмінолёгічны матар‘ял з тае ці іншае галіны веды або ўвагі, папраўкі і дадаткі да тае ці іншае надрукаванае тэрмінолёгіі Камісія просіць надсылаць у Інбелкульт (Менск, Революцыйная вул., 21) на імя Галоўнае Тэрмінолёгічнае Камісіі. Корэспондэнцыя на імя Інбелкульту паштовай аплаце не падлягае.</p>
	<p> </p>
	<p><i>Галоўная Тэрмінолёгічная Камісія.</i></p>
	<p>Менск, 15/VI−27 г.</p>
</div>
##HTMLDescription_END
##ArticleLang: ru/be

абак	аба´к
абсолютно малый	абсолю´тна малы´
абсолютно сопряженный	абсолю´тна спрэ´жаны
абсолютно сходящийся	абсолю´тна зьбе´жны
абсолютный	абсолю´тны
абстрактный	абстра´ктны
абсцисса	абцы´са
автоморфизм	аўтаморфі´зм
автоморфный	аўтамо´рфны
азигетический	азыгеты´чны
азигетичность	азыгеты´чнасьць
аксиома	аксыё´ма
аксиома арифметическая	аксыё´ма арытмэты´чная
аксиома монотонии	аксыё´ма монатоні´і
аксиома однозначности	аксыё´ма адназна´чнасьці
аксиома плоскости	аксыё´ма ро´ўніцы
аксиома пространства	аксыё´ма прасто´ры
аксиоматика	аксыёма´тыка
аксонометрия	аксонамэтры´я
актуальный	актуа´льны
алгебра	а´льгебра
алгебра формальная	а´льгебра форма´льная
алгебраически	альгебры´чна
алгебраический	альгебры´чны
алгоритм	альгоры´тм
альтернирующий	альтэрнаты´ўны
амплитуда	ампліту´да
анализ	ана´ліз
анализ алгебраический	ана´ліз альгебры´чны
анализ бесконечно малых	ана´ліз бескане´чна малы´х
анализ векториальный	ана´ліз вэктарыя´льны
анализ Диофантов	ана´ліз Дыофа´нтаў
анализ неопределенный	ана´ліз неазна´чаны
анализ положения	ана´ліз палажэ´ньня
анализ прикладной	ана´ліз прыклада´льны
анализ чистый	ана´ліз чы´сты
анализировать	аналізава´ць
аналитический	аналіты´чны
аналогия	аналё´гія
аналогии Неперовы	аналё´гіі Нэ´пэравыя
ангармонический	ангармоні´чны
ангармоничность	ангармані´чнасьць
аномалия	анома´лія
аномалия эксцентрическая	анома´лія эксцэнтры´чная
ансамбль	анса´мбль
антиинволюция	антыінволю´цыя
антилогарифм	антылёгары´тм
антипараллельный	антыпарале´льны
антипроективность	антыпроекты´ўнасьць
аполярность	аполя´рнасьць
аполярный	аполя´рны
апофема	апотэ´ма
ар	ар
аргумент	аргумэ´нт
аргумент сложный	аргумэ´нт склада´ны
арифметизация	арытмэтыза´цыя
арифметика	арытмэ´тыка
арифметика общая	арытмэ´тыка агу´льная
арифметически	арытмэты´чна
арифметический	арытмэты´чны
асимметрический	асымэтры´чны
асимметрия	асымэ´трыя
асимптота	асымпто´та
асимптотический	асымптоты´чны
ассоциативный	асоцыяты´ўны
астроида	астро´іда
аффикс	афі´кс
аффинность	афі´ннасьць
аффинный	афі´нны
базироваться	базава´цца
базис группы	ба´за гру´пы
барицентрический	барыцэнтры´чны
берег	бе´раг
бесконечно большой	бескане´чна вялі´кі
бесконечно далекий	бескане´чна далё´кі
бесконечно малый	бескане´чна малы´
бесконечно отдаленный	бескане´чна адда´лены
бесконечность	бескане´чнасьць
бесконечность актуальная	бескане´чнасьць актуа´льная
бесконечный	бескане´чны
беспредельный	бязьме´жны
биквадратичный	біквадраты´чны
биквадратный	біквадра´тны
билинейный	біліне´йны
бинарный	біна´рны
бином	біно´м
бином Ньютона	біно´м Ньюто´наў
биномиальный	біно´мны
бинормаль	бінорма´ль
биометрический	біямэтры´чны
бипланарный	біпляна´рны
биполярный	біполя´рны
бирациональный	бірацыяна´льны
биссектриса	бісэктры´са
бициклический	біцыклі´чны
бициркулярный	біцыркуля´рны
боковой	бо´чны
брать в скобки	браць у ду´жкі
буква	лі´тара
буква главная (многочлена)	лі´тара гало´ўная (многачле´на)
буквенный	лі´тарны
быть равным	быць ро´ўным
быть сравнимым	быць параўна´льным
вариационный	варыяцы´йны
вариационное исчисление	гл. исчисление
вдоль	уздо´ўж
везде плотный	усю´ды шчы´льны
вектор	вэ´ктар
векториальный	вэктарыя´льны
величина	велічыня´
величина абсолютная	велічыня´ абсолю´тная
величина бесконечно большая	велічыня´ бескане´чна вялі´кая
величина бесконечно малая	велічыня´ бескане´чна мала´я
величина геометрическая	велічыня´ геомэтры´чная
величина действительная	велічыня´ рэчаі´стая
величина дробная	велічыня´ дро´бавая
величина иррациональная	велічыня´ ірацыяна´льная
величина искомая	велічыня´ шука´ная
величина конгредиентная	велічыня´ конгрэдые´нтная
величина конечная	велічыня´ кане´чная
величина контрагредиентная	велічыня´ контрагрэдые´нтная
величина мнимая	велічыня´ ўя´ўная
величина непрерывная	велічыня´ неперары´ўная
величина несоизмеримая	велічыня´ нясупольнаме´рная
величина однородная	велічыня´ аднаро´дная
величина одноименная	велічыня´ аднайме´нная
величина отрицательная	велічыня´ адмо´ўная
величина положительная	велічыня´ дада´тная
величина постоянная	велічыня´ ста´лая
величина прерывная	велічыня´ перары´ўная
величина пространственная	велічыня´ прасто´равая
величина рациональная	велічыня´ рацыяна´льная
величина соизмеримая	велічыня´ супольнаме´рная
величина трансцендентная	велічыня´ трансцэндэ´нтная
величина числовая	велічыня´ лі´кавая
верзор	вэ´рзар
верность	праві´льнасьць
вероятно	праўдападо´бна
вероятность	праўдападо´бнасьць
вероятность абсолютная	праўдападо´бнасьць абсолю´тная
вероятность геометричеcкая	праўдападо´бнасьць геомэтры´чная
вероятность математичеcкая	праўдападо´бнасьць матэматы´чная
вероятность относительная	праўдападо´бнасьць адно´сная
вероятность полная	праўдападо´бнасьць по´ўная
вероятность противоположная	праўдападо´бнасьць проціле´жная
вероятность сложная	праўдападо´бнасьць склада´ная
вероятность статистичеcкая	праўдападо´бнасьць статысты´чная
вероятность частичная	праўдападо´бнасьць часьці´нная
вероятный	праўдападо´бны
вертикально	вэртыка´льна
вертикальный	вэртыка´льны
верхний	ве´рхні
вершина	вяршыня´
вершина многоугольника	вяршыня´ многаку´тніка
вершина пирамиды	вяршыня´ пірамі´ды
вершина свободная	вяршыня´ вол´ьная
вершина треугольника	вяршыня´ трыку´тніка
вершина угла	вяршыня´ кута´
вес	вага´
ветвь	галіна´
ветвь главная	галіна´ гало´ўная
ветвь кривой	галіна´ крыво´й
ветвь полная	галіна´ по´ўная
ветвь функции	галіна´ фу´нкцыі
вещественный	рэчаі´сты
взаимно перпендикулярные	узае´мна пэрпэндыкуля´рныя
взаимно простой	узае´мны про´сты
взаимность	узае´мнасьць
взаимный	узае´мны
взнос	укла´дка
взятый (произвольно)	узя´ты (адво´льна)
взять множитель перед знаком корня	узя´ць мно´жнік пе´рад зна´кам ко´раня
вид	від (лёгічная катэгорыя), вы´гляд
вид нормальный	вы´гляд норма´льны
вид овальный	вы´гляд ова´льны
вид простой	вы´гляд про´сты
вид сопряженный	від спрэ´жаны
вид эллиптический	вы´гляд эліпты´чны
вне	па´-за
вне прямой	па´-за про´стай
внешний	знадво´рны
внутри	унутры´
внутренний	унутраны´
вогнутость	угну´тасьць
вогнутый	угну´ты
возведенный в степень	узьве´дзены ў ступе´нь
возврат	зваро´т
возвратный	зваро´тны
возвышать в квадрат	узво´дзіць у квадра´т
возвышать в степень	узво´дзіць у ступе´нь, ступенява´ць
возвышение в третью степень	узьвядзе´ньне ў трэ´цюю ступе´нь
возвышенный в степень	узьве´дзены ў ступе´нь
возрастание	узраста´ньне
возрастать	узраста´ць
возрастать бесконечно	узраста´ць бескане´чна
возрастающий	узраста´льны
волнообразный	хвалі´сты
вопрос арифметический	пыта´ньне арытмэты´чнае
восстановлять перпендикуляр	узво´дзіць пэрпэндыкуля´р
восьмигранник	васьмігра´ньнік
восьмигранный	васьмігра´нны
восьмиугольник	васьміку´тнік
восьмиугольный	васьміку´тны
вписанный	упі´саны
вписывать	упі´сваць
вращательный	вярча´льны
вращать	вярце´ць
вращаться	вярце´цца
вращение	вярчэ´ньне
вращение вокруг точки	вярчэ´ньне наво´кала пу´нкту
вращение треугольника	вярчэ´ньне трыку´тніка
время	час
вспомогательный	дапамо´жны
вторичный	паўто´рны
второй	другі´
второстепенный	другара´дны
выбранный (произвольно)	вы´браны (адво´льна)
вывод	вы´вад
вывод формулы	вы´вад фо´рмулы
выводить (формулу)	выво´дзіць (фо´рмулу)
выгнутость	вы´гнутасьць
выгнутый	вы´гнуты
выделять	выдзяля´ць
выкладка	вы´кладка
вынести за скобки	вы´несьці за ду´жкі
выпрямить	вы´прастаць
выпрямление дуги	выпро´стваньне дугі´
выпрямление кривой	выпро´стваньне крыво´й
выпуклый	вы´гнуты
выравнение	выро´ўніваньне
выравнение аналитическое	выро´ўніваньне аналіты´чнае
выравнение графическое	выро´ўніваньне графі´чнае
выравнение механическое	выро´ўніваньне мэхані´чнае
выражать	выража´ць
выражать рационально	выража´ць рацыяна´льна
выражение	вы´раз
выражение алгебраическое	вы´раз альгебры´чны
выражение аналитическое	вы´раз аналіты´чны
выражение дифференциальное	вы´раз дыфэрэнцыя´льны
выражение дробное	вы´раз дро´бавы
выражение иррациональное	вы´раз ірацыяна´льны
выражение математическое	вы´раз матэматы´чны
выражение неоднородное	вы´раз неаднаро´дны
выражение однородное	вы´раз аднаро´дны
выражение показательное	вы´раз паказа´льнікавы
выражение рациональное	вы´раз рацыяна´льны
выражение свободное	вы´раз во´льны
выражение числовое	вы´раз лі´кавы
высота	вышыня´
высота боковая	вышыня´ бо´чная
высота конуса	вышыня´ ко´нуса
высота треугольника	вышыня´ трыку´тніка
высота угловая	вышыня´ кутава´я
высота цилиндра	вышыня´ цылі´ндра
высший	вышэ´йшы
вытекать	выцяка´ць
вычет	лі´шак
вычет абсолютно малый	лі´шак абсолю´тна малы´
вычет биквадратичный	лі´шак біквадраты´чны
вычет кубичный	лі´шак кубі´чны
вычет степени	лі´шак ступе´ні
вычисление	вылічэ´ньне
вычислительный	выліча´льны
вычислять	выліча´ць
вычитаемое	адні´мнік
вычитание	адніма´ньне
вычитать	адніма´ць
гармонический	гармоні´чны
гексаэдр	гэкса´эдр
гектар	гэ´ктар
геликоид	гэліко´ід
геодезия	геодэ´зія
геометр	гео´мэтр
геометрический	геомэтры´чны
геометрия	геомэ´трыя
геометрия абсолютная	геомэ´трыя абсолю´тная
геометрия абстрактная	геомэ´трыя абстра´ктная
геометрия аналитическая	геомэ´трыя аналіты´чная
геометрия гиперболическая	геомэ´трыя гіпэрболі´чная
геометрия дифференциальная	геомэ´трыя дыфэрэнцыя´льная
геометрия евклидова	геомэ´трыя эўклі´дава
геометрия идеальная	геомэ´трыя ідэа´льная
геометрия линейная	геомэ´трыя ліне´йная
геометрия метрическая	геомэ´трыя мэтры´чная
геометрия мнимая	геомэ´трыя уя´ўная
геометрия на плоскости	геомэ´трыя на ро´ўніцы
геометрия наглядная	геомэ´трыя нагля´дная
геометрия начертательная	геомэ´трыя нары´сная
геометрия неевклидова	геомэ´трыя неэўклі´дава
геометрия параболическая	геомэ´трыя параболі´чная
геометрия прикладная	геомэ´трыя прыклада´льная
геометрия проективная	геомэ´трыя проекты´ўная
геометрия пространственная	геомэ´трыя прасто´равая
геометрия псевдосферическая	геомэ´трыя псэўдасфэры´чная
геометрия свободная	геомэ´трыя во´льная
геометрия сферическая	геомэ´трыя сфэры´чная
геометрия эллиптическая	геомэ´трыя эліпты´чная
гипербоидальный	гіпэрбоіда´льны
гипербола	гіпэ´рбола
гипербола равносторонняя	гіпэ´рбола роўнабо´чная
гипербола сопряженная	гіпэ´рбола спрэ´жаная
гиперболический	гіпэрболі´чны
гиперболоид	гіпэрболё´ід
гиперболоид вращения	гіпэрболё´ід вярчэ´ньня
гиперболоид двуполый	гіпэрболё´ід двухпо´лы
гиперболоид однополый	гіпэрболё´ід аднапо´лы
гиперболоид равносторонний	гіпэрболё´ід роўнабо´чны
гипергеометрический	гіпэргеомэтры´чны
гиперквадратный	гіпэрквадра´тны
гиперортогональный	гіпэрортогона´льны
гиперэллиптический	гіпэрэліпты´чны
гипотенуза	гіпотэну´за
гипотрохоида	гіпотрохо´іда
гипоциклоида	гіпоцыклё´іда
главный	гало´ўны
глубина	глыбіня´
голоморфизм	голёморфі´зм
голоэдрически изоморфный	голёэдры´чна ізомо´рфны
гомографический	гомографі´чны
гомография	гомогра´фія
гомография инволюционная	гомогра´фія інволюцы´йная
гомография осевая	гомогра´фія во´севая
гомография циклическая	гомогра´фія цыклі´чная
гомологический	гомолёгі´чны
гомология	гомолё´гія
гомотетический	гомотэты´чны
гомотетия	гомотэ´ты´я
гомотетия обратная	гомотэ´ты´я адваро´тная
гомотетия прямая	гомотэ´ты´я про´стая
гониометрический	гоніямэтры´чны
гониометрия	гоніямэ´трыя
горизонт	горызо´нт, пазе´м
горизонтально	горызонта´льна, пазе´мна
горизонтальный	горызонта´льны, пазе´мны
град	град
градус	гра´дус
граненый	гра´нены
граница	мяжа´
граница тени	мяжа´ це´ню
грань	грань
грань боковая	грань бо´чная
грань двугранного угла	грань дзьвюхгра´ннага кута´
грань многогранника	грань многагра´ньніка
грань многогранного угла	грань многагра´ннага кута´
график	гра´фік
графический	графі´чны
графостатика	графаста´тыка
группа	гру´па
группа Абелева	гру´па А´бэлева
группа абстрактная	гру´па абстра´ктная
группа альтернирующая	гру´па альтэрнаты´ўная
группа ангармоническая	гру´па ангармоні´чная
группа арифметическая	гру´па арытмэты´чная
группа аффинная	гру´па афі´нная
группа бесконечная	гру´па бескане´чная
группа гармоническая	гру´па гармоні´чная
группа голоэдрически изоморфная	гру´па голёэдры´чна ізомо´рфная
группа двугранника	гру´па дзьвюхгра´ньніка
группа дискретная	гру´па дыскрэ´тная
группа дополнительная	гру´па дадатко´вая
группа изоморфная	гру´па ізомо´рфная
группа икозаэдрическая	гру´па ікозаэдры´чная
группа импримитивная	гру´па імпрыміты´ўная
группа интранзитивная	гру´па інтранзыты´ўная
группа коммутативная	гру´па комутаты´ўная
группа конечная	гру´па кане´чная
группа конкретная	гру´па конкрэ´тная
группа линейная	гру´па ліне´йная
группа линейная полная	гру´па ліне´йная по´ўная
группа мероэдрически изоморфная	гру´па мэраэдры´чна ізомо´рфная
группа метаабелева	гру´па мэтаа´бэлева
группа метациклическая	гру´па мэтацыклі´чная
группа многогранника	гру´па многагра´ньніка
группа модулевая	гру´па мо´дулевая
группа монодромическая	гру´па монадромі´чная
группа непрерывная	гру´па неперары´ўная
группа п-членная	гру´па п-чле´нная
группа октаэдрическая	гру´па октаэдры´чная
группа операторов производная	гру´па опэра´тараў вывадна´я
группа периодическая	гру´па пэрыяды´чная
группа побочная	гру´па пабо´чная
группа подстановок	гру´па падстано´вак
группа полярная	гру´па поля´рная
группа преобразований	гру´па ператварэ´ньняў
группа примитивная	гру´па прыміты´ўная
группа проективная	гру´па проекты´ўная
группа расширенная	гру´па пашы´раная
группа симметрическая	гру´па сымэтры´чная
группа сопряженная	гру´па спрэ´жаная
группа составная	гру´па сустаўна´я
группа специальная	гру´па спэцыя´льная
группа тождественная	гру´па тожса´мая
группа точек	гру´па пу´нктаў
группа точек резидуальная	гру´па пу´нктаў рэзыдуа´льная
группа транзитивная	гру´па транзыты´ўная
группа циклическая	гру´па цыклі´чная
группа элементов	гру´па элемэ´нтаў
группирование	групава´ньне
группировать	групава´ць
группировка	угрупава´ньне
групповой	групавы´
далёкий	далё´кі
данный	да´ны
два раза	два разы´
движение	рух
движение вращательное	рух вярча´льны
двойничный	дваі´чны
двойной	падво´йны
двоякопериодический	дваякапэрыя´дычны
двугранный	дзьвюхгра´нны
двузначный	двухзна´чны
двукратность	двухкра´тнасьць
двукратный	двухкра´тны
двуполый	двухпо´лы
двухмерный	дзьвюхме´рны
двухсторонний	двухбо´чны
двухугольник	двухку´тнік
двучлен	двухчле´н
двучленный	двухчле´нны
девиация	дэвія´цыя
дегенерация	дэгенэра´цыя
действие	дзе´яньне
действие алгебраическое	дзе´яньне альгебры´чнае
действие арифметическое	дзе´яньне арытмэты´чнае
действие обратное	дзе´яньне адваро´тнае
действие одного порядка	дзе´яньне аднаго´ пара´дку
действие противоположное	дзе´яньне проціле´жнае
действие прямое	дзе´яньне про´стае
действие рациональное	дзе´яньне рацыяна´льнае
действительный	рэчаі´сты
делать простейшим	рабі´ць прасьце´йшым
деление	дзяле´ньне, падзе´л
деление ангармоническое	падзе´л ангармоні´чны
деление внешнее	падзе´л знадво´рны
деление внутреннее	падзе´л унутраны´
деление гармоническое	падзе´л гармоні´чны
деление золотое	падзе´л залаты´
деление круга	падзе´л кру´га
деление непрерывное	дзяле´ньне неперары´ўнае
деление по содержанию	дзяле´ньне па зьме´сту
деление пополам	дзяле´ньне папала´м
деление пропорциональное	падзе´л пропорцыяна´льны
деление сокращенное	дзяле´ньне скаро´чанае
деленный	падзе´лены
делимое	дзе´ліва
делимость	падзе´льнасьць
делимый	дзе´льны
делитель	дзе´льнік
делитель буквенный	дзе´льнік лі´тарны
делитель нормальный	дзе´льнік норма´льны
делитель общий	дзе´льнік супо´льны
делитель общий наибольший	дзе´льнік супо´льны найбо´льшы
делитель элементарный	дзе´льнік элемэнта´рны
делить	дзялі´ць
делить гармонически	дзялі´ць гармоні´чна
делить пополам	дзялі´ць папала´м
делиться	дзялі´цца
делиться пополам	дзялі´цца папала´м
дельтоид	дэльто´ід
деньги процентные	гро´шы про´цантныя
десятиугольник	дзесяціку´тнік
десятичный	дзесятко´вы
десяток	дзеся´так
дефект	дэфэ´кт
диагональ	дыягона´ль
диагональ главная	дыягона´ль гало´ўная
диагональ определителя	дыягона´ль вызна´чніка
диагональ параллелограмма	дыягона´ль паралелёгра´ма
диагональ побочная	дыягона´ль пабо´чная
диагональный	дыягона´льны
диаметр	дыя´мэтр
диаметр главный	дыя´мэтр гало´ўны
диаметр окружности	дыя´мэтр акру´жыны
диаметр сопряженный	дыя´мэтр спрэ´жаны
диаметрально	дыямэтра´льна
диаметральный	дыямэтра´льны
директрисса	дырэктры´са
дискриминант	дыскрыміна´нт
дискриминант квадратного уравнения	дыскрыміна´нт квадра´тнага раўна´ньня
дисперсия	дыспэ´рсія
дисперсия нормальная	дыспэ´рсія норма´льная
дисперсия поднормальная	дыспэ´рсія паднорма´льная
дисперсия сверхнормальная	дыспэ´рсія наднорма´льная
дифферента	дыфэрэ´нта
дифференциал	дыфэрэнцыя´л
дифференциал полный	дыфэрэнцыя´л по´ўны
дифференциал частный	дыфэрэнцыя´л ча´сны
дифференциальный	дыфэрэнцыя´льны
дифференцирование	дыфэрэнцыява´ньне
дифференцирование почленное	дыфэрэнцыява´ньне пачле´ннае
дифференцировать	дыфэрэнцыява´ць
дифференцируемость	дыфэрэнцыява´льнасьць
длина	даўжыня´
длина окружности	даўжыня´ акру´жыны
доказательство	до´вад
доказательство аналитическое	до´вад аналіты´чны
доказательство наглядное	до´вад нагля´дны
доказательство от противного	до´вад ад супраці´ўнага
доказательство прямое	до´вад про´сты
доказательство синтетическое	до´вад сынтэты´чны
доказательство существования	до´вад існава´ньня
доказывать	даво´дзіць
долг	доўг
долгота угловая	даўжыня´ кутава´я
доля	часьць
дописывать	дапі´сваць
дополнение	дапаўне´ньне
дополнение алгебраическое	дапаўне´ньне альгебры´чнае
дополняться до 90°	дапаўня´цца да 90°
дополняться до 180°	дапаўня´цца да 180°
допускать	дапуска´ць, прыпуска´ць
допускать подстановку	дапуска´ць падстано´ўку
допущение	прыпушчэ´ньне
допущение ложное	прыпушчэ´ньне фальшы´вае
достаточный и необходимый	даста´тны і неабхо´дны
достоверность	пэ´ўнасьць
достоверный	пэ´ўны
дробный	дро´бавы
дробь	дроб
дробь абсолютная	дроб абсолю´тны
дробь алгебраическая	дроб альгебры´чны
дробь бесконечная	дроб бескане´чны
дробь десятичная	дроб дзесятко´вы
дробь конечная	дроб кане´чны
дробь непериодическая	дроб непэрыяды´чны
дробь неправильная	дроб няпра´вільны
дробь непрерывная	дроб неперары´ўны
дробь несократимая	дроб нескарача´льны
дробь обратная	дроб адваро´тны
дробь общая	дроб агу´льны
дробь обыкновенная	дроб звыча´йны
дробь относительная	дроб адно´сны
дробь периодическая	дроб пэрыяды´чны
дробь периодическая простая	дроб пэрыяды´чны про´сты
дробь периодическая смешанная	дроб пэрыяды´чны мяша´ны
дробь подходящая	дроб набліжа´льны
дробь правильная	дроб пра´вільны
дробь приближенная	дроб наблі´жаны
дробь рациональная	дроб рацыяна´льны
дробь систематическая	дроб сыстэматы´чны
дробь сократимая	дроб скарача´льны
дробь сокращенная	дроб скаро´чаны
дробь составная	дроб сустаўны´
дуалитет	дуалітэ´т
дуга	дуга´
дуга окружности	дуга´ акру´жыны
дюйм	цаль
единица	адзі´нка
единица главная	адзі´нка гало´ўная
единица групы левая (правая)	адзі´нка гру´пы ле´вая (пра´вая)
единица действительная	адзі´нка рэчаі´стая
единица десятичная	адзі´нка дзесятко´вая
единица дробная	адзі´нка дро´бавая
единица дуг	адзі´нка ду´гаў
единица измерения	адзі´нка вы´меру
единица квадратная	адзі´нка квадра´тная
единица кубическая	адзі´нка кубі´чная
единица мнимая	адзі´нка ўя´ўная
единица отрицательная	адзі´нка адмо´ўная
единица первого разряда	адзі´нка пе´ршага пара´дку
единица площади	адзі´нка пло´шчы
единица положительная	адзі´нка дада´тная
единица пространственная	адзі´нка прасто´равая
единица простая	адзі´нка про´стая
единица разных разрядов	адзі´нка ро´зных пара´дкаў
единица составная	адзі´нка сустаўна´я
единичный	адзі´нкавы, паасо´бны
емкость	ё´масьць
зависить	зале´жыць
зависимость	зале´жнасьць
зависимость прямая	зале´жнасьць про´стая
зависимость функциональная	зале´жнасьць функцыяна´льная
зависимый	зале´жны
задача	зада´ча
задача делийская	зада´ча дэлі´йская
задача изопериметрическая	зада´ча ізопэрымэтры´чная
задача на вычисление	зада´ча на вылічэ´ньне
задача на доказательство	зада´ча на до´вад
задача на построение	зада´ча на збудава´ньне
задача невозможная	зада´ча немагчы´мая
задача неопределенная	зада´ча неазна´чаная
задача определенная	зада´ча азнач´аная
задача простая	зада´ча про´стая
задача сложная	зада´ча склада´ная
задача точно определенная	зада´ча дакла´дна азна´чаная
задача числовая	зада´ча лі´кавая
заем	пазы´ка
заключать	заключа´ць, зьмяшча´ць
заключать в скобки	заключа´ць у ду´жкі
заключаться	зьмяшча´цца
заключение	заключэ´ньне
заключенный в скобки	заклю´чаны ў ду´жкі
закон	зако´н
закон ангармоничности	зако´н ангармоні´чнасьці
закон ассоциативности	зако´н асоцыяты´ўнасьці
закон бинома	зако´н біно´ма
закон больших чисел	зако´н вялі´кіх лі´каў
закон взаимности	зако´н узае´мнасьці
закон двойственности	зако´н падво´йнасьці
закон дистрибутивный	зако´н дыстрыбуты´ўны
закон инверсии	зако´н інвэ´рсіі
закон инерции	зако´н інэ´рцыі
закон коммутативный	зако´н комутаты´ўны
закон переместительный	зако´н перамяшча´льны
закон погрешностей	зако´н хі´бнасьцяй
закон распределительный	зако´н разьмеркава´льны
закон сочетательный	зако´н злуч´альны
замена	заме´на
заменять	замяня´ць
замыкать	замыка´ць
замкнутость	замкну´тасьць
замкнутость числового поля	замкну´тасьць лі´кавага по´ля
замкнутый	замкну´ты, замкнё´ны
звезда	зо´рка
звезда основная	зо´рка асно´ўная
звездчатый	зо´рчасты
звено (непрерывной дроби)	зьвяно´ (неперары´ўнага дро´бу)
знак	знак
знак алгебраический	знак альгебры´чны
знак действия	знак дзе´яньня
знак корня	знак ко´раня
знак противоположный	знак проціле´жны
знакопеременный	знаказьме´нны
знакоположение	знакапалажэ´ньне
знакоположение основное	знакапалажэ´ньне асно´ўнае
знаменатель дроби	назо´ўнік дро´бу
знаменатель геометрического отношения	мно´жнік геомэтры´чнага стасу´нку
знаменатель геометрической прогрессии	мно´жнік геомэтры´чнай прогрэ´сіі
знаменатель общий	назо´ўнік супо´льны
знаменатель наименьший	назо´ўнік супо´льны найме´ншы
знаменатель частный	назо´ўнік супо´льны ча´сны
значек	значо´к
значение	значэ´ньне
значение абсолютное	значэ´ньне абсолю´тнае
значение величины	значэ´ньне велічыні´
значение главное	значэ´ньне гало´ўнае
значение комплексное	значэ´ньне компле´кснае
значение конечное	значэ´ньне кане´чнае
значение критическое функции	значэ´ньне крыты´чнае фу´нкцыі
значение местное	значэ´ньне ме´снае
значение наибольшее	значэ´ньне найбо´льшае
значение настоящее	значэ´ньне сапра´ўднае
значение начальное	значэ´ньне пачатко´вае
значение обратное	значэ´ньне адваро´тнае
значение постоянное	значэ´ньне ста´лае
значение предельное	значэ´ньне грані´чнае
значение приближенное	значэ´ньне наблі´жанае
значение приписанное	значэ´ньне прыпі´санае
значение сопряженное	значэ´ньне спрэ´жанае
значение среднее	значэ´ньне сярэ´дняе
значение целое	значэ´ньне цэ´лае
значение цифр двойное	значэ´ньне цы´фраў падво´йнае
значение частное	значэ´ньне ча´снае
значение числовое	значэ´ньне лі´кавае
значащий	ва´ртасны
зона	зо´на
идеал	ідэа´л
идеал простой	ідэа´л про´сты
избыток	перавы´шка
известный	вядо´мы
извлекать корень	здабыва´ць ко´рань
извлечение корней	здабыва´ньне каранё´ў
изгиб	вы´гіб
излишек	перавы´шка
изложение	выклада´ньне, вы´клад
изменение	зьме´на
изменять	зьмяня´ць
измерение	вы´мер, ме´раньне
измерение величин	ме´раньне велічы´няў
измерение многочлена	вы´мер многачле´на
измерение пространства	вы´мер прасто´ры
измерение углов радиальное	ме´раньне куто´ў радыя´льнае
измерение точное	вы´мер дакла´дны
измеренный	вы´мераны
измеримый	выме´рны
измерительный	выме´рны
измерить	вы´мераць
измеряться	выме´рвацца
изображать	перадава´ць у во´бразе, перадава´ць графі´чна
изображение	во´браз
изображение прерывное	во´браз перары´ўны
изображение графическое функции	во´браз графі´чны фу´нкцыі
изогональный	ізогона´льны
изолированный	ізолява´ны
изометрический	ізомэтры´чны
изоморфизм	ізоморфі´зм
изоморфизм голоэдрический	ізоморфі´зм голёэдры´чны
изоморфизм мэроэдрический	ізоморфі´зм мэраэдры´чны
изоморфный	ізомо´рфны
икозаэдр	ікоза´эдр
икозаэдр ромбоидальный	ікоза´эдр ромбоіда´льны
именованный	найме´нны
импримитивность	імпрыміты´ўнасьць
импримитивный	імпрыміты´ўны
инвариант	інварыя´нт
инвариант абсолютный	інварыя´нт абсолю´тны
инвариант групповой	інварыя´нт групавы´
инвариант дифференциальный	інварыя´нт дыфэрэнцыя´льны
инвариант конечный	інварыя´нт кане´чны
инвариант косой	інварыя´нт касы´
инвариантный	інварыя´нтны
инверсионный	інвэрсы´йны
инверсия	інвэ´рсія
инволюционный	інволюцы´йны
инволюция	інволю´цыя
инволюция абсолютная	інволю´цыя абсолю´тная
инволюция высшего порядка	інволю´цыя вышэ´йшага пара´дку
инволюция гармонически сопряженная	інволю´цыя гармоні´чна спрэ´жаная
инволюция гиперболическая	інволю´цыя гіпэрболі´чная
инволюция главная	інволю´цыя гало´ўная
инволюция диагональная	інволю´цыя дыягона´льная
инволюция квадратная	інволю´цыя квадра´тная
инволюция кривая	інволю´цыя крыва´я
инволюция лучей	інволю´цыя праме´ньняў
инволюция лучей главная	інволю´цыя праме´ньняў гало´ўная
инволюция лучей сопряженная	інволю´цыя праме´ньняў спрэ´жаная
инволюция лучей циклическая	інволю´цыя праме´ньняў цыклі´чная
инволюция общая	інволю´цыя агу´льная
инволюция основная	інволю´цыя асно´ўная
инволюция параболическая	інволю´цыя параболі´чная
инволюция порядковая	інволю´цыя пара´дкавая
инволюция прямая	інволю´цыя про´стая
инволюция результирующая	інволю´цыя выніка´льная
инволюция сопряженная	інволю´цыя спрэ´жаная
инволюция составляющая	інволю´цыя склада´льная
инволюция точек	інволю´цыя пу´нктаў
инволюция фокальная	інволю´цыя фока´льная
инволюция циклическая	інволю´цыя цыклі´чная
инволюция четыресторонника	інволю´цыя чатырохбо´чніка
инволюция четыреугольника	інволю´цыя чатырохку´тніка
инволюция эллиптическая	інволю´цыя эліпты´чная
индэкс	і´ндэкс
индекс группы	і´ндэкс гру´пы
индекс числа	і´ндэкс лі´ку
индикатрисса	індыкатры´са
индукция математическая	інду´кцыя матэматы´чная
интеграл	інтэгра´л
интеграл абелев	інтэгра´л а´бэлеў
интеграл вероятности	інтэгра´л праўдападо´бнасьці
интеграл гиперэллиптический	інтэгра´л гіпэрэліпты´чны
интеграл двойной	інтэгра´л падво´йны
интеграл инвариантный	інтэгра´л інварыя´нтны
интеграл комплексный	інтэгра´л компле´ксны
интеграл кратный	інтэгра´л кра´тны
интеграл неопределенный	інтэгра´л неазна´чаны
интеграл несобственный	інтэгра´л неўласьці´вы
интеграл обобщенный	інтэгра´л неўласьці´вы
интеграл нормальный	інтэгра´л норма´льны
интеграл общий	інтэгра´л агу´льны
интеграл обыкновенный	інтэгра´л звыча´йны
интеграл определенный	інтэгра´л азна´чаны
интеграл особенный	інтэгра´л асаблі´вы
интеграл полный	інтэгра´л по´ўны
интеграл частный	інтэгра´л ча´сны
интеграл эллиптический	інтэгра´л эліпты´чны
интегральный	інтэгра´льны
интегратор	інтэгра´тар
интеграф	інтэгра´ф
интегрирование	інтэграва´ньне
интегрирование графическое	інтэграва´ньне графі´чнае
интегрирование неопределенное	інтэграва´ньне неазна´чанае
интегрирование определенное	інтэграва´ньне азна´чанае
интегрирование почленное	інтэграва´ньне пачле´ннае
интегрировать	інтэграва´ць
интегрировать по частям	інтэграва´ць ча´сткамі
интегрируемость	інтэграва´льнасьць
интегрируемый	інтэграва´льны
интегрирующий множитель	гл. множитель
интерполировать	інтэрполява´ць
интерполяционный	інтэрполяцы´йны
интерполяция	інтэрполя´цыя
интерполяция пропорциональная	інтэрполя´цыя пропорцыяна´льная
интранзитивный	інтранзыты´ўны
интрансцендентный	інтрансцэндэ´нтны
иррациональность	ірацыяна´льнасьць
иррациональный	ірацыяна´льны
искать	шука´ць
исключать	выключа´ць
исключение	выключэ´ньне
исключительный	выклю´чны
искомый	шука´ны
исполнение действия	выкана´ньне дзе´яньня
испытывать	прабава´ць
исследование	дасьле´дваньне
исследование арифметическое	дасьле´дваньне арытмэты´чнае
исследование уравнения	дасьле´дваньне раўна´ньня
исследовать	дасьле´дваць
истинный	сапра´ўдны
источник (семиварианта)	крыні´ца (сэміварыя´нта)
исходный	выхо´дны
исчисление	вылічэ´ньне
исчисление бесконечно малых	вылічэ´ньне бескане´чна малы´х
исчисление вариационное	вылічэ´ньне варыяцы´йнае
исчисление вероятностей	вылічэ´ньне праўдападо´бнасьці
исчисление дифференциальное	вылічэ´ньне дыфэрэнцыя´льнае
исчисление интегральное	вылічэ´ньне інтэгра´льнае
исчисление конечных разностей	вылічэ´ньне кане´чных ро´зьніцаў
исчисление простых процентов	вылічэ´ньне про´стых про´цантаў
исчисление сложных процентов	вылічэ´ньне склада´ных про´цантаў
исчисление среднего срока	вылічэ´ньне сярэ´дняга тэ´рміну
исчислимость	зьліча´льнасьць
исчислять	выліча´ць
итерация	ітэра´цыя
кавстический	каўсты´чны
кажущаяся неопределенность	гл. неопределенность
канонизант	каноніза´нт
канонизировать	канонізава´ць
канонический	каноні´чны
капитал	капіта´л
капитал нарощенный	капіта´л наро´шчаны
капитал первоначальный	капіта´л першапачатко´вы
капитализация	капіталіза´цыя
кардиоида	кардыё´іда
касание	до´тык
касание во многих точках	до´тык у мно´гіх пу´нктах
касание внешнее	до´тык знадво´рны
касание внутренее	до´тык унутраны´
касание высшего порядка	до´тык вышэ´йшага пара´дку
касание двойное	до´тык падво´йны
касательная	даты´чная
касательная внешняя	даты´чная знадво´рная
касательная внутренняя	даты´чная ўнутрана´я
касательная возврата	даты´чная зваро´ту
касательная двойная	даты´чная падво´йная
касательная двойная действительная	даты´чная падво´йная рэчаі´стая
касательная двойная мнимая	даты´чная падво´йная ўя´ўная
касательная изгиба	даты´чная вы´гібу
касательная сопряженная	даты´чная спрэ´жаная
касательный	даты´чны
касаться	датыка´цца
касаться с окружностью	датыка´цца да акру´жыны
катеноид	катэно´ід
катет	ка´тэт
качественный	я´касны
качество	я´касьць
квадрант	квадра´нт
квадрат	квадра´т
квадратичный	квадраты´чны
квадратный	квадра´тны
квадратрика	квадра´трыка
квадратура	квадрату´ра
квадратура круга	квадрату´ра кру´га
квалитативный	квалітаты´ўны
кватернион	кватэрніё´н
кватернион единичный	кватэрніё´н адзі´нкавы
кватернион сопряженный	кватэрніё´н спрэ´жаны
кватернионный	кватэрніё´нны
класс	кля´са
класс линий	кля´са лі´ніяў
класс форм	кля´са фо´рмаў
класс форм главный	кля´са фо´рмаў гало´ўная
класс чисел	кля´са лі´каў
ковариант	коварыя´нт
колебание	вага´ньне
коллинеарный	колінэа´рны
коллинеация	колінэа´цыя
количественный	ко´лькасны
количество	ко´лькасьць
колонна определителя	слупо´к вызна´чніка
кольцо	ко´лца
кольцо круговое	ко´лца кругаво´е
кольцо сходимости	ко´лца зьбе´жнасьці
комбинант	комбіна´нт
комбинация	комбіна´цыя
комбинация линейная	комбіна´цыя ліне´йная
комбинировать	комбінава´ць
коммутативный	комутаты´ўны
коммутатор группы	комута´тар гру´пы
компланация	компляна´цыя
комплекс	компле´кс
комплекс алгебраический	компле´кс альгебры´чны
комплекс гармонический	компле´кс гармоні´чны
комплекс гиперболический	компле´кс гіпэрболі´чны
комплекс инволюционный	компле´кс інволюцы´йны
комплекс линейный	компле´кс ліне´йны
комплекс мнимый	компле´кс уя´ўны
комплекс общий	компле´кс агу´льны
комплекс основной	компле´кс асно´ўны
комплекс особенный	компле´кс асаблі´вы
комплекс полярный	компле´кс поля´рны
комплекс равнофокусный	компле´кс роўнафока´льны
комплекс сфер	компле´кс сфэ´раў
комплекс четырегранника	компле´кс чатырохгра´ньніка
комплекс эллиптический	компле´кс эліпты´чны
комплексный	компле´ксны
композиция (форм)	композы´цыя (фо´рмаў)
конгруентность	конгруэ´нтнасьць
конгруентность обратная	конгруэ´нтнасьць адваро´тная
конгруентность прямая	конгруэ´нтнасьць про´стая
конгруентность попарно	конгруэ´нтнасьць па´рамі
конгруировать	конгруява´ць
конечность	кане´чнасьць
конечный	кане´чны
конический	коні´чны
конкоминант	конкоміна´нт
конкоминант смешанный	конкоміна´нт мяша´ны
конкретный	конкрэ´тны
коннекс	конэ´кс
коннекс плоский	конэ´кс пло´скі
коннекс сопряженный	конэ´кс спрэ´жаны
коноидальный	коноіда´льны
конструировать	конструява´ць
конструкционный	конструкцы´йны
конструкция	констру´кцыя
конструкция геометрическая	констру´кцыя геомэтры´чная
континуум	конты´нуум
контравариант	контраварыя´нт
контур	ко´нтур
конус	ко´нус
конус асимптотический	ко´нус асымптоты´чны
конус двуполый	ко´нус двухпо´лы
конус дополнительный	ко´нус дапаўня´льны
конус касания	ко´нус судо´тыку
конус комплекса	ко´нус компле´ксу
конус круговой	ко´нус кругавы´
конус круговой прямой	ко´нус кругавы´ про´сты
конус минимальный	ко´нус мініма´льны
конус наклонный	ко´нус нахі´лены
конус направляющий	ко´нус кірава´льны
конус правильный	ко´нус пра´вільны
конус прямой	ко´нус про´сты
конус равносторонний	ко´нус роўнабо´чны
конус соприкасательный	ко´нус судаты´чны
конус усеченный	ко´нус зрэ´заны
конфигурация	конфігура´цыя
конфокальный	конфока´льны
конформный	конфо´рмны
конхоида	конхо´іда
конхоидальный	конхоіда´льны
концентрический	концэнтры´чны
координата	коордына´та
координата барицентрическая	коордына´та барыцэнтры´чныя
координата биполярная	коордына´та біполя´рная
координата гипербоидальная	коордына´та гіпэрбоіда´льная
координата криволинейная	коордына´та крываліне´йная
координата линейная	коордына´та ліне´йная
координата лучевая	коордына´та праме´невая
координата ортогональная	коордына´та ортаго´нальная
координата однородная	коордына´та аднаро´дная
координата однородная тангенциальная	коордына´та аднаро´дная тангенцыя´льная
координата обыкновенная	коордына´та звыча´йная
координата полярная	коордына´та поля´рная
координата проективная	коордына´та проекты´ўная
координата прямолинейная	коордына´та просталіне´йная
координата прямоугольная	коордына´та простаку´тная
координата сферическая	коордына´та сфэры´чная
координата тангенциальная	коордына´та тангенцыя´льная
координата тетраметрическая	коордына´та тэтрамэтры´чная
координата точки	коордына´та пу´нкту
координата треугольная	коордына´та трыку´тная
координата трилинейная	коордына´та трыліне´йная
координата трилинейная нормальная	коордына´та трыліне´йная норма´льная
координата трилинейная тангенциальная	коордына´та трыліне´йная тангенцыя´льная
координата триметрическая	коордына´та трымэтры´чная
координата цилиндрическая	коордына´та цыліндры´чная
координата четырех плоскостей	коордына´та чатыро´х ро´ўніцаў
координата четырегранника	коорды´ната чатырохгра´ньніка
координата эллиптическая	коордына´та эліпты´чная
координатный	коордына´тны
корень	ко´рань
корень действительный	ко´рань рэчаі´сты
корень из единицы	ко´рань з адзі´нкі
корень импримитивный	ко´рань імпрыміты´ўны
корень квадратный	ко´рань квадра´тны
корень комплексный	ко´рань компле´ксны
корень кратный	ко´рань кра´тны
корень кубический	ко´рань кубі´чны
корень обратный	ко´рань адваро´тны
корень примитивный	корань прымітыўны
корень первообразный	ко´рань першапачатко´вы
корень уравнения	ко´рань раўна´ньня
корень уравнения лишний	ко´рань раўна´ньня лі´шні
корпус	ко´рпус
корпус (числовой) абстрактный	ко´рпус (лі´кавы) абстра´ктны
косеканс	косэ´канс
косинус	косі´нус
косинус справляющий	косі´нус кірава´льны
косой	касы´
косоугольник	косаку´тнік
косоугольный	косаку´тны
котангенс	кота´нгенс
коэффициент	коэфіцые´нт
коэффициент биномиальный	коэфіцые´нт біномія´льны
коэффициент многочленный	коэфіцые´нт многачле´нны
коэффициент пропорциональности	коэфіцые´нт пропорцыяна´льнасьці
коэффициент угловой	коэфіцые´нт ку´тавы
коэффициент числовой	коэфіцые´нт лі´кавы
крайний	кра´йні
кратное (число)	кра´тны (лік)
кратное общее наименьшее	кра´тны супо´льны найме´ншы
кратный	кра´тны
кривая	крыва´я
кривая алгебраическая	крыва´я альгебры´чная
кривая аналлагматическая	крыва´я аналягматы´чная
кривая апланатическая	крыва´я аплянаты´чная
кривая бициркулярная	крыва´я біцыркуля´рная
кривая возврата	крыва´я зваро´ту
кривая второго порядка	крыва´я друго´га пара´дку
кривая гармоническая	крыва´я гармоні´чная
кривая гиперэллиптическая	крыва´я гіпэрэліпты´чная
кривая двойная	крыва´я падво´йная
кривая двойного касания	крыва´я падво´йнага до´тыку
кривая действительная	крыва´я рэчаі´стая
кривая деления	крыва´я падзе´лу
кривая замкнутая	крыва´я замкну´тая
кривая инверсионная	крыва´я інвэрсы´йная
кривая интегральная	крыва´я інтэгра´льная
кривая касания	крыва´я до´тыку
кривая ковариантная	крыва´я коварыя´нтная
кривая комплекса	крыва´я ко´мплексу
кривая коническая	крыва´я коні´чная
кривая конхоидальная	крыва´я конхоіда´льная
кривая коррезидуальная	крыва´я корэзыдуа´льная
кривая крайняя	крыва´я кра´йняя
кривая направляющая	крыва´я кірава´льная
кривая неприводимая	крыва´я няпрыво´дная
кривая объемлемая	крыва´я абні´мная
кривая объемлющая	крыва´я абніма´льная
кривая общая	крыва´я агу´льная
кривая оснований	крыва´я асно´ваў
кривая основная	крыва´я асно´ўная
кривая особенная	крыва´я асаблі´вая
кривая параболическая	крыва´я параболі´чная
кривая плоская	крыва´я пло´ская
кривая показательная	крыва´я паказа´льнікавая
кривая полигональная	крыва´я полігона´льная
кривая полярная	крыва´я поля´рная
кривая порядковая	крыва´я пара´дкавая
кривая приводимая	крыва´я прыво´дная
кривая примитивная	крыва´я прыміты´ўная
кривая проницания	крыва´я праніка´ньня
кривая простая	крыва´я паасо´бная
кривая пространственная	крыва´я прасто´равая
кривая радиальная	крыва´я радыя´льная
кривая резидуальная	крыва´я рэзыдуа´льная
кривая скрученная	крыва´я скру´чаная
кривая сопряженная	крыва´я спрэ´жаная
кривая сферическая	крыва´я сфэры´чная
кривая сходимости	крыва´я зьбе´жнасьці
кривая транцендентная	крыва´я трансцэндэ´нтная
кривая узловая	крыва´я вузлава´я
кривая уникурсальная	крыва´я ўнікурса´льная
кривая фокальная	крыва´я фока´льная
кривая циклическая	крыва´я цыклі´чная
кривая циклоидальная	крыва´я цыклёіда´льная
кривая циркулярная	крыва´я цыркуля´рная
кривая четырехвершинная	крыва´я чатырохвяршы´нная
кривая экстремальная	крыва´я экстрэма´льная
кривая эллиптическая	крыва´я эліпты´чная
кривизна	крыві´зна
кривизна абсолютная	крыві´зна абсолю´тная
кривизна вторая	крыві´зна друга´я
кривизна главная	крыві´зна гало´ўная
кривизна относительная	крыві´зна адно´сная
кривизна отрицательная	крыві´зна адмо´ўная
кривизна полная	крыві´зна по´ўная
кривизна положительная	крыві´зна дада´тная
кривизна постоянная	крыві´зна ста´лая
кривизна средняя	крыві´зна сярэ´дняя
кривизна тангенциальная	крыві´зна тангенцыя´льная
кривой	крывы´
криволинейный	крываліне´йны
кривосторонний	крывабо´чны
круг	круг
круг большой	круг вялі´кі
круг главный	круг гало´ўны
круг малый	круг малы´
круг параллельный	круг парале´льны
круг расстояния	круг адле´гласьці
круглый	кру´глы
круговой	кругавы´
кручение	кручэ´ньне
куб	куб
кубатура	кубату´ра
кубичный	кубі´чны
кубический	кубі´чны
лежащий симметрически	ляжа´чы сымэтры´чна
лемма	лема´
лемма основная	лема´ асно´ўная
лемниската	лемніска´та
линейка	ліне´йка
линейка логарифмическая	ліне´йка лёгарытмі´чная
линейный	ліней´ны
линейчатый	ліне´йчаты
линия	лі´нія
линия асимптотическая	лі´нія асымптоты´чная
линия вертикальная	лі´нія вэртыка´льная
линия вершин	лі´нія вяршы´няў
линии взимно перпендикулярные	лі´ніі ўзае´мна пэрпэндыкуля´рныя
линия винтовая	лі´нія вінтава´я
линия вогнутая	лі´нія ўгну´тая
линия вспомогательная	лі´нія дапамо´жная
линия выпуклая	лі´нія вы´гнутая
линия геодезическая	лі´нія геодэзы´чная
линия главная	лі´нія гало´ўная
линия горизонтальная	лі´нія горызонта´льная, пазе´мная
линия делящая пополам	лі´нія, яка´я дзе´ліць папала´м
линия диагональная	лі´нія дыягона´льная
линия замкнутая	лі´нія замкну´тая
линия конечная	лі´нія кане´чная
линии конфокальные	лі´ніі конфока´льныя
линия кратная	лі´нія кра´тная
линия кривизны	лі´нія крыві´зны
линия ломаная	лі´нія лама´ная
линия наклонная	лі´нія нахі´леная
линия непрерывная	лі´нія неперары´ўная
линия объемлемая	лі´нія абні´мная
линия объемлюшая	лі´нія абніма´льная
линия особенная	лі´нія асаблі´вая
линия параллельная	лі´нія парале´льная
линии пересекающиеся	лі´ніі перасяка´льныя
линия пересечения плоскостей	лі´нія перасячэ´ньня ро´ўніцаў
линия пересеченная	лі´нія перасе´чаная
линия перехода	лі´нія перахо´ду
линия перпендикулярная	лі´нія пэрпэндыкуля´рная
линия плоская	лі´нія пло´ская
линия погонная	лі´нія паго´нная
линия предельная	лі´нія грані´чная
линия прилежащая	лі´нія прыле´глая
линия проектирующая	лі´нія проектава´льная
линия проекционная	лі´нія проекцы´йная
линия пространственная	лі´нія прасто´равая
линия пунктирная	лі´нія кро´пкавая
линия сечения	лі´нія сячэ´ньня
линии скрещивающиеся	лі´ніі мімабе´жныя
линия следовая	лі´нія сьледава´я
линия смешанная	лі´нія мяша´ная
линии совпадают	лі´ніі супада´юць
линия совпадения	лі´нія супадзе´ньня
линия соединяющая	лі´нія злуча´льная
линии софокусные	лі´ніі конфока´льныя
линия средняя	лі´нія сярэ´дняя
линия степенная	лі´нія ступянё´вая
линия уровня	лі´нія ро´ўню
линия фокальная	лі´нія фо´кальная
линия фокальная вторичная	лі´нія фока´льная паўто´рная
линия центральная	лі´нія цэнтра´льная
линия цепная	лі´нія ланцу´жная
линия числовая	лі´нія лі´кавая
лист Декартов	ліст Дэка´ртаў
лист Римановой поверхности	ліст Ры´манавай паве´рхні
лишний	лі´шні
логарифм	лёгары´тм
логарифм десятичный	лёгары´тм дзесятко´вы
логарифм натуральный	лёгары´тм натура´льны
логарифм Неперов	лёгары´тм Нэ´пэраў
логарифм обыкновенный	лёгары´тм звыча´йны
логарифмика	лёгары´тміка
логарифмирование	лёгарытмава´ньне
логарифмировать	лёгарытмава´ць
логарифмически	лёгарытмі´чна
логарифмический	лёгарытмі´чны
локсодрома	лёксодро´ма
ломаная (линия)	лама´ная (лінія)
ломаная замкнутая	лама´ная замкну´тая
ломаная объемлемая	лама´ная абні´мная
ломаная объемлющая	лама´ная абніма´льная
ломанный	лама´ны
луночка	сярпо´к
луч	праме´нь
луч аффинности	праме´нь афі´ннасьці
луч гармонический	праме´нь гармоні´чны
луч главный	праме´нь гало´ўны
луч двойной	праме´нь падво´йны
луч перспективы	праме´нь пэрспэкты´вы
луч подобия	праме´нь падо´бнасьці
луч порядковый	праме´нь пара´дкавы
луч проектирующий	праме´нь проектава´льны
луч противоположный	праме´нь проціле´жны
луч разветвления	праме´нь разгаліне´ньня
луч сопряженный	праме´нь спрэ´жаны
максимальный	максыма´льны
максимум	ма´ксымум
максимум абсолютный	ма´ксымум абсолю´тны
максимум относительный	ма´ксымум адно´сны
малый	малы´
малый достаточно	до´сыць малы´, даво´лі малы´
мантисса	манты´са
масштаб	машта´б
масштаб уменьшенный	машта´б зьме´ншаны
математика	матэма´тыка
математика прикладная	матэма´тыка прыклада´льная
математика чистая	матэма´тыка чы´стая
математический	матэматы´чны
матрица	ма´трыца
матрица квадратная	ма´трыца квадра´тная
матрица прямоугольная	ма´трыца простаку´тная
матрица транспонированная	ма´трыца транспонава´ная
медиана	мэдыя´на
меняющийся	зьме´нлівы
мера	ме´ра
мера кривизны	ме´ра крыві´зны
мера общая	ме´ра супо´льная
мера общая наибольшая	ме´ра супо´льная найбо´льшая
мера угловая	ме´ра кутава´я
меридиан	мэрыдыя´н
место геометрическое	ме´сца геомэтры´чнае
место наибольшей плотности	ме´сца найбо´льшай шчы´льнасьці
место нулевое	ме´сца нуляво´е
место особенное	ме´сца асаблі´вае
место разветвления	ме´сца разгаліне´ньня
место сгущения	ме´сца згушчэ´ньня
метагеометрия	мэтагеомэ´трыя
метаморфный	мэтамо´рфны
метациклический	мэтацыклі´чны
метод	мэ´тод
метод альтернирующий	мэ´тод альтэрнаты´ўны
метод вспомогательных фигур	мэ´тод дапамо´жных фігу´раў
метод геометрических мест	мэ´тод геомэтры´чных ме´сцаў
метод логарифмический	мэ´тод лёгарытмі´чны
метод наименьших квадратов	мэ´тод найме´ншых квадра´таў
метод обратности	мэ´тод адваро´тнасьці
метод параллельного перенесения	мэ´тод перале´льнага перано´су
метод подобия	мэ´тод падо´бнасьці
метод подобных фигур	мэ´тод падо´бных фігу´раў
метод сравнения	мэ´тод параўна´ньня
метод трансформационный	мэ´тод трансформацы´йны
метр	мэтр
метр квадратный	мэтр квадра´тны
метр кубический	мэтр кубі´чны
метрика	мэ´трыка
метрика гиперболическая	мэ´трыка гіпэрболі´чная
метрика параболическая	мэ´трыка параболі´чная
метрика проективная	мэ´трыка проекты´ўная
метрика эллиптическая	мэ´трыка эліпты´чная
метрический	мэтры´чны
минимум	мі´німум
минор	мі´нор
минор главный	мі´нор гало´ўны
минор дополнительный	мі´нор дапаўня´льны
минус	мі´нус
минута	міну´та
мнимый	уя´ўны
многогранник	многагра´ньнік
многогранник выпуклый	многагра´ньнік вы´гнуты
многогранник закмнутый	многагра´ньнік замкну´ты
многогранник незамкнутый	многагра´ньнік незамкну´ты
многогранник правильный	многагра´ньнік пра´вільны
многогранник ромбоидальный	многагра´ньнік ромбоіда´льны
многогранный	многагра´нны
многозначность	многазна´чнасьць
многозначный	многазна´чны
многоименный	многайме´нны
многомерный	многаме´рны
многообразие	мно´ства
многосторонний	многабо´чны
многосторонник простой	многабо´чнік про´сты
многоульник	многаку´тнік
многоульник выгнутый	многаку´тнік угну´ты
многоульник вписанный	многаку´тнік упі´саны
многоульник выпуклый	многаку´тнік вы´гнуты
многоульник звездчатый	многаку´тнік зо´рчасты
многоульник неправильный	многаку´тнік няпра´вільны
многоульник описанный	многаку´тнік апі´саны
многоульник подобный	многаку´тнік падо´бны
многоульник правильный	многаку´тнік пра´вільны
многоульник простой	многаку´тнік про´сты
многоульник сечения	многаку´тнік сячэ´ньня
многоугольный	многаку´тны
многоциферный	многацыфро´вы
многочлен	многачле´н
многочлен неоднородный	многачле´н неаднаро´дны
многочлен однородный	многачле´н аднаро´дны
многочлен расположенный (относительно букв)	многачле´н упара´дкаваны (адносна літараў)
многочленный	многачле´нны
множество	мно´ства
множество бесконечное	мно´ства бескане´чнае
множество везде плотное	мно´ства ўсю´ды шчы´льнае
множество в себе плотное	мно´ства ў сабе´ шчы´льнае
множество вполне упорядоченное	мно´ства до´бра ўпара´дкаванае
множество замкнутое	мно´ства замкну´тае
множество изолированное	мно´ства ізолява´нае
множество исчислимое	мно´ства зьліча´льнае
множество конечное	мно´ства кане´чнае
множество континуума	мно´ства конты´нууму
множество линейное	мно´ства ліне´йнае
множество неупорядоченное	мно´ства неўпара´дкаванае
множество ограниченное	мно´ства аграні´чанае
множество плотное	мно´ства шчы´льнае
множество производное	мно´ства вывадно´е
множество расположенное	мно´ства разьмеркава´нае
множество совершенное	мно´ства зако´нчанае
множество счетное	мно´ства зьліча´льнае
множество точечное	мно´ства пу´нктавае
множество упорядоченное	мно´ства ўпара´дкаванае
множество эквивалентное	мно´ства эквівале´нтнае
множимое	мно´жыва
множитель	мно´жнік
множитель буквенный	мно´жнік лі´тарны
множитель дополнительный	мно´жнік дапаўня´льны
множитель идеальный	мно´жнік ідэа´льны
множитель интегрирующий	мно´жнік інтэграва´льны
множитель линейный	мно´жнік ліне´йны
множитель общий	мно´жнік супо´льны
множитель произвольный	мно´жнік адво´льны
множитель простой	мно´жнік про´сты
множитель процентный	мно´жнік про´цантны
множитель числовой	мно´жнік лі´кавы
модулевый	мо´дулевы
модуль	мо´дуль
модуль простой	мо´дуль про´сты
модуль функции	мо´дуль фу´нкцыі
моногенический	монагені´чны
монодромический	монадромі´чны
моноид	моно´ід
моном	моно´м
монотония	монатоні´я
мощность	магу´тнасьць
мощность счетная	магу´тнасьць зьліча´льная
наблюдение	нагляда´ньне
наглядный	нагля´дны
наибольший	найбо´льшы
наименьший	найме´ншы
наклон	нахі´л
наклонение	нахіле´ньне
наклоненный	нахі´лены
наклонный	нахі´лены
накрытие	накрыцьцё´
наличность	ная´ўнасьць
наложение плоскостей	налажэ´ньне ро´ўніцаў
направление	кіру´нак
направление вертикальное	кіру´нак вэртыка´льны
направление впадания	кіру´нак упада´ньня
направление вращения	кіру´нак вярчэ´ньня
направление движения	кіру´нак ру´ху
направление неизменное	кіру´нак нязьме´нны
направление противоположное	кіру´нак проціле´жны
направленный	накірава´ны
направленный одинаково	накірава´ны адна´ка
направленный противоположно	накірава´ны проціле´жна
направляющий	кірава´льны
настоящий	сапра´ўдны
натуральный	натура´льны
наугольник	наку´тнік
нахождение	знахаджэ´ньне
нахождение общей меры	знахаджэ´ньне супо´льнай ме´ры
начало	пача´так
начало координат	пача´так коордына´таў
начальный	пачатко´вы
начертательный	нары´сны
не возрастать	не ўзраста´ць
не убывать	не спада´ць
невозможность	немагчы´масьць
невозможный	немагчы´мы
невычет	нялі´шак
невычет квадратичный	нялі´шак квадраты´чны
недействительный	нерэчаі´сты
недостаток	недахва´т
независимость	незале´жнасьць
независимый	незале´жны
независимый линейно	незале´жны ліне´йна
неизвестная	невядома´я
неизвестный	невядо´мы
неисчислимость	нязьліча´льнасьць
нелинейный	няліне´йны
необходимый	неабхо´дны
неограниченный	неаграні´чаны
неодинаково направленный параллельный	неадна´ка накірава´ны парале´льны
неоднородный	неаднаро´дны
неопределенность	неазна´чанасьць
неопределенность кажущаяся	неазна´чанасьць зданьнё´вая
неопределенный	неазна´чаны
неопределимость	неазнача´льнасьць
непараллельный	непарале´льны
непериодический	непэрыяды´чны
неподвижный	нярухо´мы
неполный	няпо´ўны
непостоянный	няста´лы
неправильный	няпра´вільны
непрерывно	неперары´ўна
непрерывно возрастающий	неперары´ўна ўзраста´льны
непрерывность	неперары´ўнасьць
непрерывный	неперары´ўны
неприводимость	няпрыво´днасьць
неприводимость особенная	няпрыво´днасьць асаблі´вая
неприводимый	няпрыво´дны
неприлежащий	няпрыле´глы
непрямой	няпро´сты
неравенство	няро´ўнасьць
неравновеликий	няроўнавялі´кі
неравносторонний	няроўнабо´чны
неравный	няро´ўны
несовместимость	несумяшча´льнасьць
несовместимый	несумяшча´льны
несогласованность	няўзго´дненасьць
несогласованный	няўзго´днены
несоизмеримость	нясупольнаме´рнасьць
несоизмеримый	нясупольнаме´рны
несократимый	нескарача´льны
неточность	недакла´днасьць
неупорядкованный	неўпара´дкаваны
нечетный	няцо´тны
нечетного порядка	няцо´тнага пара´дку
неявный	няя´ўны
нижний	ні´жні
нодоид	нодо´ід
норма	но´рма
нормаль	норма´ль
нормаль главная	норма´ль гало´ўная
нормальный	норма´льны
носительница ряда точек	асно´ва ра´ду пу´нктаў
носительница ряда точек прямолинейная	асно´ва ра´ду пу´нктаў просталіне´йная
нулевой	нулявы´
нуль	нуль
нумерация	нумара´цыя
нумер	ну´мар
обвертка	абго´ртка
объект	об'е´кт
объем	аб'ё´м
объемлемый	абні´мны
объемлющий	абніма´льны
область	дзядзі´на
область иррациональности	дзядзі´на ірацыяна´льнасьці
область непрерывности	дзядзі´на неперары´ўнасьці
область основная	дзядзі´на асно´ўная
область отобразованная	дзядзі´на адо´бразная
область рациональности	дзядзі´на рацыяна´льнасьці
область рациональности натуральная	дзядзі´на рацыяна´льнасці натура´льная
область рациональности расширенная	дзядзі´на рацыяна´льнасці пашы´раная
область сходимости	дзядзі´на зьбе´жнасьці
область чисел	дзядзі´на лі´каў
обобщать	абагульня´ць
обобщение	абагульне´ньне
обозначать	абазнача´ць
обозначение	абазначэ´ньне
обозначенный	абазна´чаны
оборот	абаро´т
образ	во´браз
образ абсолютный	во´браз абсолю´тны
образ алгебраический	во´браз альгебры´чны
образ квадратный	во´браз квадра´тны
образ обратный	во´браз адваро´тны
образ основной	во´браз асно´ўны
образ пространственный	во´браз прасто´равы
образ функции графический	во´браз фу´нкцыі графі´чны
образование (кривой)	утварэ´ньне (крыво´й)
образование целых чисел	утварэ´ньне цэ´лых лі´каў
образовать	утвары´ць
образующая	вытвара´льная
образующая двойная	вытвара´льная падво´йная
образующая конуса	вытвара´льная ко´нуса
образующая особенная	вытвара´льная асаблі´вая
образующая прямолинейная	вытвара´льная просталіне´йная
образующая сопряженная	вытвара´льная спрэ´жаная
образующая цилиндра	вытвара´льная цылі´ндра
образующий	утвара´льны
обратный	адваро´тны
обращение	абарачэ´ньне
обращение теоремы	абарачэ´ньне тэорэ´мы
общий	агу´льны, супо´льны
овал	ова´л
овальность	ова´льнасьць
овальный	ова´льны
огибать	абго´ртваць
ограничение	агранічэ´ньне
ограниченный	аграні´чаны
ограничивать	аграні´чваць
один	адзі´н
одинаковый	адна´кі
однозначно	адназна´чна
однозначность	адназна´чнасьць
однозначный	адназна´чны
одноименный	аднайме´нны
однократный	аднакра´тны
одно-однозначный	адна-адназна´чны
однополый	аднапо´лы
однородный	аднаро´дны
односторонний	аднабо´чны
одночлен	адначле´н
одночлен подобный	адначле´н падо´бны
одночленный	адначле´нны
ожидание математическое	спадзява´ньне матэматы´чнае
октаэдр	окта´эдр
октаэдроид	октаэдро´ід
округление	закругле´ньне
окружность	акру´жына
окружность внеписанная	акру´жына прыўпі´саная
окружность вписанная	акру´жына ўпі´саная
окружность главная	акру´жына гало´ўная
окружность действительная	акру´жына сапра´ўдная
окружность касания	акру´жына до´тыку
окружность концентрическая	акру´жына концэнтры´чная
окружность кривизны	акру´жына крыві´зны
окружность направляющая	акру´жына кірава´льная
окружность описанная	акру´жына апі´саная
окружность описанная радиусом	акру´жына апі´саная ра´дыюсам
окружность предельная	акру´жына грані´чная
окружность сечения	акру´жына сячэ´ньня
окружность средняя	акру´жына сярэ´дняя
окружность сферическая	акру´жына сфэры´чная
окружность числовая	акру´жына лі´кавая
окружность эксцентрическая	акру´жына эксцэнтры´чная
оператор	опэра´тар
описанный	апі´саны
описывать	апі´сваць
описывать окружность	апі´сваць акру´жыну
определение	азначэ´ньне
определение вероятности	азначэ´ньне праўдападо´бнасьці
определенный	азна´чаны
определенный геометрически	азна´чаны геомэтры´чна
определимость	азнача´льнасьць
определимый	азнача´льны
определитель	вызна´чнік
определитель взаимный	вызна´чнік узае´мны
определитель косой	вызна´чнік касы´
определитель косой симметрический	вызна´чнік касы´ сымэтры´чны
определитель n-го порядка	вызна´чнік n-га пара´дку
определитель ортосимметрический	вызна´чнік ортасымэтры´чны
определитель преобразования	вызна´чнік ператварэ´ньня
определитель симметрический	вызна´чнік сымэтры´чны
определитель формы	вызна´чнік фо´рмы
определитель функциональный	вызна´чнік функцыяна´льны
определитель характеристический	вызна´чнік характарысты´чны
определитель-произведение	вызна´чнік-здабы´так
определять	азнача´ць
опускать перпендикуляр	спуска´ць пэрпэндыкуля´р
ордината	ордына´та
ордината циклическая	ордына´та цыклі´чная
орисфера	орысфэ´ра
ортогональный	ортагона´льны
осевой	во´севы
основание	асно´ва
основание верхнее	асно´ва ве´рхняя
основание косоугольное	асно´ва косаку´тная
основание логарифмов	асно´ва лёгары´тмаў
основание нижнее	асно´ва ні´жняя
основание общее	асно´ва супо´льная
основание параллелограмма	асно´ва паралелёгра´ма
основание перпендикуляра	асно´ва пэрпэндыкуля´ра
основание прямой	асно´ва про´стай
основание степени	асно´ва ступе´ні
основание трапеции	асно´ва трапэ´цыі
основание треугольника	асно´ва трыку´тніка
основной	асно´ўны
основываться	грунтава´цца
особенность	асаблі´васьць
особенный	асаблі´вы
особенный несущественно	асаблі´вы няісто´тна
остаток	аста´ча
остроугольный	востраку´тны
острый	во´стры
осциллировать	осцылява´ць
осциллирующий	осцылява´льны
осцилляция	осцыля´цыя
осцилляция функции	осцыля´цыя фу´нкцыі
ось	вось
ось абсцисс	вось абсцы´саў
ось аффинности	вось афі´ннасьці
ось большая	вось вялі´кая
ось вращения	вось вярчэ´ньня
ось главная	вось гало´ўная
ось гомологии	вось гомолё´гіі
ось горизонтальная	вось горызонта´льная, пазе´мная
ось действительная	вось рэчаі´стая
ось инволюции	вось інволю´цыі
ось конуса	вось ко´нуса
ось координатная	вось коордына´тная
ось кривой	вось крыво´й
ось кривизны	вось крыві´зны
ось малая	вось мала´я
ось мнимая	вось уя´ўная
ось направляющая	вось кірава´льная
ось ординат	вось ордына´таў
ось перспективы	вось пэрспэкты´вы
ось побочная	вось пабо´чная
ось полюса	вось по´люса
ось поперечная	вось папярэ´чная
ось проективности	вось проекты´ўнасьці
ось проекционная	вось проекцы´йная
ось прямолинейная	вось просталіне´йная
ось прямоугольная	вось простаку´тная
ось радикальная	вось радыка´льная
ось симметрии	вось сымэ´трыі
ось фокальная	вось фока´льная
ось центральная	вось цэнтра´льная
ось цилиндра	вось цылі´ндра
ось числовая	вось лі´кавая
отверстие	атво´рына
ответ задачи	адка´з на зада´чу
отвлеченный	абстра´ктны
отдаление	аддале´ньне
отделение корней	аддзяле´ньне каранё´ў
отделенный	аддзе´лены
отдельный	асо´бны
отделять	аддзяля´ць
откладывание отрезков	адклада´ньне адрэ´зкаў
отклонение	адхіле´ньне
открывать скобки	раскрыва´ць ду´жкі
относительность	адно´снасьць
относительный	адно´сны
относиться	адно´сіцца
отношение	стасу´нак
отношение ангармоническое	стасу´нак ангармоні´чны
отношение арифметическое	стасу´нак арытмэты´чны
отношение возрастающее	стасу´нак узраста´льны
отношение геометрическое	стасу´нак геомэтры´чны
отношение двойное	стасу´нак падво´йны
отношение единичное	стасу´нак адзі´нкавы
отношение метрическое	стасу´нак мэтры´чны
отношение подобия	стасу´нак падо´бнасьці
отношение приближенное	стасу´нак наблі´жаны
отношение простое	стасу´нак про´сты
отношение проективное	стасу´нак проекты´ўны
отношение прямое	стасу´нак про´сты
отношение составное	стасу´нак сустаўны´
отношение убывающее	стасу´нак спада´льны
отношение числовое	стасу´нак лі´кавы
отображение	адо´браз
отобразование	адо´браз
отобразование изогональное	адо´браз ізогона´льны
отобразованный	адо´бразны
отобразование конфокальное	адо´браз конфока´льны
отобразование с сохранением подобия	адо´браз з захава´ньнем падо´бнасьці
отобразование стереографическое	адо´браз стэрэаграфі´чны
отобразованный аффинно	адо´бразны афі´нна
отражаться	адбіва´цца
отражение	адбіцьцё´
отрезок	адрэ´зак
отрезок наклонный	адрэ´зак нахі´лены
отрезок направляющий	адрэ´зак кірава´льны
отрезок несоизмеримый	адрэ´зак нясупольнаме´рны
отрезок перпендикулярный	адрэ´зак пэрпэндыкуля´рны
отрезок соизмеримый	адрэ´зак супольнаме´рны
отрезывать	адрэ´зваць
отрицание	адмо´ўе
отрицательный	адмо´ўны
отсекать	адсяка´ць
отстоящий	адле´глы
отсчитывание	адлі´чваньне
отсчитывать	адлі´чаць
отыскивать	шука´ць
р-адическое число	р-ады´чны лік
паналгебраический	панальгебры´чны
пангеометрия	пангеомэ´трыя
пантахия	пантахі´я
пантограф	панто´граф
пара	па´ра
пара кривых	па´ра крывы´х
пара лучей	па´ра праме´ньняў
пара плоскостей	па´ра ро´ўніцаў
пара прямых	па´ра про´стых
пара точек	па´ра пу´нктаў
парабола	пара´бола
парабола полукубическая	пара´бола паўкубі´чная
параболический	параболі´чны
параболоид	параболё´ід
параболоид гиперболический	параболё´ід гіпэрболі´чны
параболоид равносторонний	параболё´ід роўнабо´чны
параболоид эллиптический	параболё´ід эліпты´чны
параллелепипед	паралелепі´пэд
параллелепипед наклонный	паралелепі´пэд нахі´лены
параллелепипед прямой	паралелепі´пэд про´сты
параллелограм	паралелёгра´м
параллелограм косоугольный	паралелёгра´м косаку´тны
параллелограм неравносторонний	паралелёгра´м няроўнабо´чны
параллелограм периодичности	паралелёгра´м пэрыяды´чнасьці
параллельность	парале´льнасьць
параллельный	парале´льны
параллельный неодинаково направленный	парале´льны неадна´ка накірава´ны
параллельный одинаково направленный	парале´льны адна´ка накірава´ны
параметр	пара´мэтр
параметр главный	пара´мэтр гало´ўны
параметр изометрический	пара´мэтр ізомэтры´чны
параметр пучка	пара´мэтр пучка´
пелекоида	пэлеко´іда
первообразность	першапачатко´васьць
первый	пе´ршы
перегиб	перагі´б
перегибать (фигуру)	перагіба´ць (фігу´ру)
передвигать	перасо´ўваць
передвижение	перасо´ўваньне
перемена	пераме´на
переменная	зьме´нная
переменная зависимая	зьме´нная зале´жная
переменная комплексная	зьме´нная ко´мплексная
переменная независимая	зьме´нная незале´жная
переменная составная	зьме´нная сустаўна´я
переменная стремится к пределу	зьме´нная імкне´цца да грані´цы
переменный	пераме´нны
переменчивость	зьме´нлівасьць
переместительный	перамяшча´льны
перемещать	перамяшча´ць
перемещение	перамяшчэ´ньне
перемещение параллельное	перамяшчэ´ньне парале´льнае
перемещение слагаемых	перамяшчэ´ньне скла´днікоў
перенесение	перанясе´ньне
переносить	перано´сіць
переносить отрезок	перано´сіць адрэ´зак
пересекать	перасяка´ць
пересекаться	перасяка´цца
пересечение	перасячэ´ньне
пересеченный	перасе´чаны
переставлять	перастаўля´ць
перестановка	перастано´ўка
перестановка переменная	перастано´ўка пераме´нная
перестановка проективная	перастано´ўка проекты´ўная
перестановка сомножителей	перастано´ўка сумно´жнікаў
перестановка тождественная	перастано´ўка тожса´мая
перестановка четная	перастано´ўка цо´тная
перестановочный	перамяшча´льны
перечеркивать	перакасо´ўваць
перечисление	пералі´к, пералічэ´ньне
перечислять	пералі´чваць
периметр	пэры´мэтр
периметр основания	пэры´мэтр асно´вы
периметр многоугольника	пэры´мэтр многаку´тніка
период	пэры´яд
период примитивный	пэры´яд прыміты´ўны
период чистый	пэры´яд чы´сты
периодический	пэрыяды´чны
периодичность	пэрыяды´чнасьць
периодичность двойная	пэрыяды´чнасьць падво´йная
периферический	пэрыфэры´чны
перманентность	пэрманэ´нтнасьць
пермутационный	пэрмутацы´йны
пермутация	пэрмута´цыя
перпендикуляр	пэрпэндыкуля´р
перпендикуляр сферический	пэрпэндыкуля´р сфэры´чны
перпендикулярно	пэрпэндыкуля´рна
перпендикулярный	пэрпэндыкуля´рны
перпендикулярный взаимно	пэрпэндыкуля´рны ўзае´мна
перпендикулярные попарно	пэрпэндыкуля´рныя па´рамі
перспектива	пэрспэкты´ва
перспектива живописная	пэрспэкты´ва маля´рская
перспектива Саvаlіегі	пэрспэкты´ва Кавалье´ры
перспектива непосредственная	пэрспэкты´ва непасрэ´дная
перспектива ортографическая параллельная	пэрспэкты´ва ортаграфі´чная парале´льная
перспектива параллельная	пэрспэкты´ва парале´льная
перспектива производная	пэрспэкты´ва вывадна´я
перспектива рельефная	пэрспэкты´ва рэлье´фная
перспектива собственная	пэрспэкты´ва ўласьці´вая
перспектива центральная	пэрспэкты´ва цэнтра´льная
перспективность	пэрспэкты´ўнасьць
перспективный	пэрспэкты´ўны
пирамида	пірамі´да
пирамида дополнительная	пірамі´да дапаўня´льная
пирамида многогранная	пірамі´да многагра´нная
пирамида наклонная	пірамі´да нахі´леная
пирамида правильная	пірамі´да пра´вільная
пирамида прямая	пірамі´да про´стая
пирамида трегранная	пірамі´да трохгра´нная
пирамида усеченная	пірамі´да зрэ´заная
пирамида четырегранная	пірамі´да чатырохгра´нная
пирамидальный	піраміда´льны
планиметр	плянімэ´тр
планиметрический	плянімэтры´чны
планиметрия	плянімэ´трыя
плечо	плячо´
плоский	пло´скі
плоскость	ро´ўніца
плоскость асимптотическая	ро´ўніца асымптоты´чная
плоскость бесконечно далекая	ро´ўніца бескане´чна далё´кая
плоскость бисекции	ро´ўніца бісэ´кцыі
плоскость вертикальная	ро´ўніца вэртыка´льная
плоскость гармоническая	ро´ўніца гармоні´чная
плоскость горизонтальная	ро´ўніца горызонта´льная, пазем´ная
плоскость двойная	ро´ўніца падво´йная
плоскость двойного касания	ро´ўніца падво´йнага до´тыку
плоскость диагональная	ро´ўніца дыягона´льная
плоскость диаметральная	ро´ўніца дыямэтра´льная
плоскость касательная	ро´ўніца даты´чная
плоскость координатная	ро´ўніца коордына´тная
плоскость кривизны	ро´ўніца крыві´зны
плоскость образа	ро´ўніца во´бразу
плоскость основная	ро´ўніца асно´ўная
плоскость перпендикулярная	ро´ўніца пэрпэндыкуля´рная
плоскость погонная	ро´ўніца паго´нная
плоскость полюса	ро´ўніца пол´юса
плоскость полярная	ро´ўніца поля´рная
плоскость проведенная через точку	ро´ўніца праве´дзеная праз пункт
плоскость проективная	ро´ўніца проекты´ўная
плоскость проекционная	ро´ўніца проекцы´йная
плоскость радикальная	ро´ўніца радыка´льная
плоскость сечения	ро´ўніца сячэ´ньня
плоскость симметрии	ро´ўніца сымэ´трыі
плоскость совпадения	ро´ўніца супадзе´ньня
плоскость соприкасательная	ро´ўніца судаты´чная
плоскость сопряженная	ро´ўніца спрэ´жаная
плоскость фокальная	ро´ўніца фока´льная
плоскость центральная	ро´ўніца цэнтра´льная
плоскость чертежа	ро´ўніца рысу´нку
плоскость числовая	ро´ўніца лі´кавая
плоскостный	ро´ўнічны
плотность	шчы´льнасьць
плотный	шчы´льны
площадь	пло´шча
площадь кругового кольца	пло´шча кругаво´га ко´лца
площадь многоугольника	пло´шча многаку´тніка
площадь основания	пло´шча асно´вы
площадь полная	пло´шча по´ўная
площади равные	пло´шчы ро´ўныя
площадь сегмента	пло´шча сэгмэ´нта
площадь сектора	пло´шча сэ´ктара
площадь треугольника	пло´шча трыку´тніка
плюс	плюс
побочный	пабо´чны
поверка	праве´рка
поверка корня	праве´рка ко´раня
повернуть треугольник вокруг точки	павярну´ць трыку´тнік наво´кала пу´нкту
поверхностный	паве´рхневы
поверхность	паве´рхня
поверхность алгебраическая	паве´рхня альгебры´чная
поверхность бициклическая	паве´рхня біцыклі´чная
поверхность боковая	паве´рхня бо´чная
поверхность вогнутая	паве´рхня ўгну´тая
поверхность волнообразная	паве´рхня хвалі´стая
поверхность вращения	паве´рхня вярчэ´ньня
поверхность выпуклая	паве´рхня вы´гнутая
поверхность гиперквадратная	паве´рхня гіпэрквадра´тная
поверхность двухлистная	паве´рхня двухлі´стая
поверхность двухсторонняя	паве´рхня двухбо´чная
поверхность диагональная	паве´рхня дыягона´льная
поверхность замкнутая	паве´рхня замкну´тая
поверхность идеальная	паве´рхня ідэа´льная
поверхность касательная	паве´рхня даты´чная
поверхность ковариантная	паве´рхня коварыя´нтная
поверхность комплекса	паве´рхня компле´ксу
поверхность коническая	паве´рхня коні´чная
поверхность коноидальная	паве´рхня коноіда´льная
поверхность косая	паве´рхня каса´я
поверхность кривая	паве´рхня крыва´я
поверхность криволинейная	паве´рхня крываліне´йная
поверхность линейчатая	паве´рхня ліне´йчастая
поверхность линейчатая косая	паве´рхня ліне´йчастая каса´я
поверхность линейчатая минимальная	паве´рхня ліне´йчастая мініма´льная
поверхность линейчатая развертывающаяся	паве´рхня ліне´йчастая разго´ртвальная
поверхность меридиана	паве´рхня мэрыдыя´на
поверхность минимальная	паве´рхня мініма´льная
поверхность многогранная	паве´рхня многагра´нная
поверхность незамкнутая	паве´рхня незамкну´тая
поверхность объемлемая	паве´рхня абні´мная
поверхность объемлющая	паве´рхня абніма´льная
поверхность обратная	паве´рхня адваро´тная
поверхность однократно связная	паве´рхня аднакра´тна зьвя´зная
поверхность односвязная	паве´рхня адназьвя´зная
поверхность односторонняя	паве´рхня аднабо´чная
поверхность оснований	паве´рхня асно´ваў
поверхность особенностей	паве´рхня асаблі´васьцяў
поверхность полярная	паве´рхня поля´рная
поверхность предельная	паве´рхня грані´чная
поверхность псевдосферическая	паве´рхня псэўдасфэры´чная
поверхность рациональная	паве´рхня рацыяна´льная
поверхность Риманна	паве´рхня Ры´мана
поверхность развернутая	паве´рхня разго´рнутая
поверхность развертывающаяся	паве´рхня разго´ртвальная
поверхность развертывающаяся линейчатая	паве´рхня разго´ртвальная ліне´йчастая
поверхность средняя	паве´рхня сярэ´дняя
поверхность трансцендентная	паве´рхня трансцэндэ´нтная
поверхность трубчастая	паве´рхня трубча´стая
поверхность уникурсальная	паве´рхня ўнікурса´льная
поверхность фокальная	паве´рхня фока´льная
поверхность цилиндрическая	паве´рхня цыліндры´чная
поверхность шаровая	паве´рхня сфэры´чная
поверхность шарового сегмента	паве´рхня сфэры´чнага сэгмэ´нта
поверхность экваториальная	паве´рхня экватарыя´льная
поворачивание	паваро´чваньне
поворотить	павярну´ць
погашение	пагашэ´ньне
погрешность	хі´бнасьць
погрешность вероятная	хі´бнасьць праўдападо´бная
погрешность измерения	хі´бнасьць ме´раньня
погрешность наблюдения	хі´бнасьць нагляда´ньня
погрешность отрицательная	хі´бнасьць адмо´ўная
погрешность положительная	хі´бнасьць дада´тная
погрешность с избытком	хі´бнасьць з перавы´шкай
погрешность средняя	хі´бнасьць сярэ´дняя
подвижной	рухо´мы
подгруппа	падгру´па
подгруппа инвариантная	падгру´па інварыя´нтная
подгруппа инвариантная максимальная	падгру´па інварыя´нтная максыма´льная
подгруппа циклическая	падгру´па цыклі´чная
подкасательная	паддаты´чная
подкоренной	падкарэ´нны
поднормаль	паднорма´ль
поднормаль полярная	паднорма´ль поля´рная
поднормальный	паднорма´льны
подобие	падо´бнасьць
подобие геометрических фигур	падо´бнасьць геомэтры´чных фігу´раў
подобие многоугольников	падо´бнасьць многаку´тнікаў
подобие обратное	падо´бнасьць адваро´тная
подобие прямое	падо´бнасьць про´стая
подобие свободное	падо´бнасьць во´льная
подобный	падо´бны
подстановка	падстано´ўка
подстановка арифметическая	падстано´ўка арытмэты´чная
подстановка геометрическая	падстано´ўка геомэтры´чная
подстановка двухсторонняя	падстано´ўка двухбо´чная
показатель	паказа´льнік
показатель дробный	паказа´льнік дро´бавы
показатель отрицательный	паказа´льнік адмо´ўны
показатель степени	паказа´льнік ступе´ні
показательный	паказа´льнікавы
пола (конуса)	крысо´ (ко´нуса)
поле	по´ле
поле абстрактное	по´ле абстра´ктнае
поле алгебраическое	по´ле альгебры´чнае
поле действительных чисел	по´ле рэчаі´стых лі´каў
поле рациональности	по´ле рацыяна´льнасьці
поле рациональных чисел	по´ле рацыяна´льных лі´каў
поле угла	по´ле кута´
поле числовое	по´ле лі´кавае
поле числовое квадратное	по´ле лі´кавае квадра´тнае
поле числовое конечное	по´ле лі´кавае кане´чнае
поле числовое нормальное	по´ле лі´кавае норма´льнае
поле сопряженное	по´ле спрэ´жанае
полигон	поліго´н
полигон внешний	поліго´н знадво´рны
полигон внутренний	поліго´н унутраны´
полигон финикулярный	поліго´н фінікуля´рны
полигональный	полігона´льны
полином	поліно´м
полный	по´ўны
половина	палаві´на
положение	палажэ´ньне
положение взаимное	палажэ´ньне ўзае´мнае
положение двух фигур гомологическое	палажэ´ньне дзьвюх фігу´раў гомалёгі´чнае
положение инволюционное	палажэ´ньне інволюцы´йнае
положение обратное	палажэ´ньне адваро´тнае
положение параллельное	палажэ´ньне парале´льнае
положение перспективное	палажэ´ньне пэрспэкты´ўнае
положение предельное	палажэ´ньне грані´чнае
положение проективное	палажэ´ньне проекты´ўнае
положение прямое	палажэ´ньне про´стае
положенный	пало´жаны
положительно	дада´тна
положительный	дада´тны
полоса	паласа´
полоса квадратов	паласа´ квадра´таў
полоса функциональная	пала´са функцыяна´льная
полуаналитический	паўаналіты´чны
полукруг	паўкру´г
полукубический	паўкубі´чны
полуоборот	паўабаро´т
полуокружность	паўакру´жына
полуокружность главная	паўакру´жына гало´ўная
полуопределенный	паўазна´чаны
полуось	паўво´сь
полупериметр	паўпэры´мэтр
полуплоскость	паўро´ўніца
полупространство	паўпрасто´ра
полупрямая	паўпро´стая
полусимметрический	паўсымэтры´чны
полусумма	паўсу´ма
получетный	паўцо´тны
получить	даста´ць
полушарие	паўсфэ´ра
полюс	по´люс
полюс гармонический	по´люс гармоні´чны
полюс сопряженный	по´люс спрэ´жаны
поляра	поля´ра
поляра гармоническая	поля´ра гармоні´чная
поляра кратная	поля´ра кра´тная
поляра подобия	поля´ра падо´бнасьці
поляризация	полярыза´цыя
полярность	поля´рнасьць
полярный	поля´рны
поместный	ме´сны
помещаться	зьмяшча´цца
понижать	зьніжа´ць
понижение	зьніжэ´ньне
понизить степень уравнения	зьні´зіць ступе´нь раўна´ньня
понятие	паня´цьце
понятие основное	паня´цьце асно´ўнае
поперечный	папярэ´чны
поперечная	папярэ´чная
порядковый	пара´дкавы
порядок	пара´дак
порядок группы	пара´дак гру´пы
порядок определителя	пара´дак вызна´чніка
порядок полный	пара´дак по´ўны
последний	апо´шні
последовательность	пасьлядо´ўнасьць
последовательность бесконечная	пасьлядо´ўнасьць бескане´чная
последовательность возрастающая	пасьлядо´ўнасьць узраста´льная
последовательность чисел	пасьлядо´ўнасьць лі´каў
последующий	насту´пны
постоянная	ста´лая
постоянная направляющая	cта´лая кірава´льная
постоянный	ста´лы
постоянство	ста´ласьць
построение	збудава´ньне
постулат	постуля´т
посчитать	палічы´ць
потенцировать	потэнцыява´ць
почленно	чле´намі
пояс сферический	пояс сфэры´чны
правило	пра´віла
правило пропорционального деления	пра´віла пропорцыяна´льнага падзе´лу
правило товарищества	пра´віла тавары´ства
правило тройное	пра´віла тро´йнае
правило тройное простое	пра´віла тро´йнае про´стае
правило тройное сложное	пра´віла тро´йнае склада´нае
правило цепное	пра´віла ланцу´жнае
правильность	пра´вільнасьць
правильный	пра´вільны
превосходить	перавыша´ць
предел	грані´ца
предел верхний	грані´ца ве´рхняя
предел нижний	грані´ца ні´жняя
предел общий	грані´ца супо´льная
предельный	грані´чны
предыдущий	папярэ´дні
предложение	сказ
предложение математическое	сказ матэматы´чны
предмет	прадме´т
предполагать	прыпуска´ць
предположение	прыпушчэ´ньне
представление	прадстаўле´ньне
представление неявное	прадстаўле´ньне няя´ўнае
представление функции табличное	прадстаўле´ньне фу´нкцыі таблі´чнае
представление явное	прадстаўле´ньне я´ўнае
представлять	прадстаўля´ць
предшествующий	папярэ´дні
преобразование	ператварэ´ньне
преобразование бесконечно малое	ператварэ´ньне бескане´чна мало´е
преобразование бирациональное	ператварэ´ньне бірацыяна´льнае
преобразование дополнительное	ператварэ´ньне дапаўня´льнае
преобразование инфинитезимальное	ператварэ´ньне інфінітэзіма´льнае
преобразование иррациональное	ператварэ´ньне ірацыяна´льнае
преобразование конформное	ператварэ´ньне конфо´рмнае
преобразование координат	ператварэ´ньне коордына´таў
преобразование линейное	ператварэ´ньне ліне´йнае
преобразование многоугольников	ператварэ´ньне многаку´тнікаў
преобразование непрерывное	ператварэ´ньне неперары´ўнае
преобразование обратимое	ператварэ´ньне абарача´льнае
преобразование обратное	ператварэ´ньне адваро´тнае
преобразование обыкновенных дробей в десятичные	ператварэ´ньне звыча´йных дро´баў у дзесятко´выя
преобразование однородное	ператварэ´ньне аднаро´днае
преобразование ортоморфное	ператварэ´ньне ортамо´рфнае
преобразование основное	ператварэ´ньне асно´ўнае
преобразование параболическое	ператварэ´ньне параболі´чнае
преобразование подобия	ператварэ´ньне падо´бнасьці
преобразование подобия пространственное	ператварэ´ньне падо´бнасьці прасто´равае
преобразование прерывное	ператварэ´ньне перары´ўнае
преобразование проективное	ператварэ´ньне проекты´ўнае
преобразование рациональное	ператварэ´ньне рацыяна´льнае
преобразование тождественное	ператварэ´ньне тожса´мае
преобразование унимодулярное	ператварэ´ньне ўнімодуля´рнае
преобразовывать	ператвара´ць
премия	прэ´мія
прерывность	перары´ўнасьць
прерывный	перары´ўны
при вершине	каля вяршыні´
прибавлять	дадава´ць
приближение	набліжэ´ньне
приближенный	набліжа´ны
прибор	прыла´да
прибор для черчения	прыла´да для рысава´ньня
прибор измерительный	прыла´да выме´рная
приведение	прывядзе´ньне
приведение дробей к общему знаменателю	прывядзе´ньне дро´баў да супо´льнага назо´ўніка
приведение к единице	прывядзе´ньне да адзі´нкі
приведение к одной плоскости	прывядзе´ньне да аднэ´й ро´ўніцы
приведение подобных членов	прывядзе´ньне падо´бных чле´наў
приведенный к общему знаменателю	прыве´дзены да супо´льнага назо´ўніка
приводимость	прыво´днасьць
приводимый	прыво´дны
приводить	прыво´дзіць
приводить дроби к общему знаменателю	прыво´дзіць дро´бы да супо´льнага назо´ўніка
приводить к общему показателю	прыво´дзіць да супо´льнага паказа´льніка
приводить подобные члены	прыво´дзіць падо´бныя чле´ны
призма	пры´зма
призма наклонная	пры´зма нахі´леная
призма правильная	пры´зма пра´вільная
призма прямая	пры´зма про´стая
призма трегранная	пры´зма трохгра´нная
призма четырегранная	пры´зма чатырохгра´нная
призматический	прызматы´чны
призматоид	прызмато´ід
признак	прыме´та
признак делимости	прыме´та падзе´льнасьці
признак подобия	прыме´та падо´бнасьці
признак равенства треугольников	прыме´та ро´ўнасьці трыку´тнікаў
признак существенный	прыме´та істо´тная
прикладной	прыклада´льны
прилегать	прыляга´ць
прилежащий	прыле´глы
примарный	прыма´рны
применение	прыстасава´ньне
применение алгебры к геометрии	прыстасава´ньне а´льгебры да геомэ´трыі
применение числовое	прыстасава´ньне лі´кавае
применять	прыстасо´ўваць
пример	пры´клад
примитивный	прыміты´ўны
принадлежать к показателю	наляжа´ць да паказа´льніка
принадлежащий	прынале´жны
принимать	прыма´ць
принимать значения	прыма´ць значэ´ньні
принцип	прынцы´п
принцип обращения	прынцы´п абарачэ´ньня
принцип относительности	прынцы´п адно´снасьці
принцип передвижения	прынцы´п перасо´ўваньня
приравнивать	прыро´ўніваць
приравненный нулю	прыро´ўнены да нуля´
приращение	прыро´ст
присоединенный	далу´чаны
присоединять	далуча´ць
присчитывание	прылі´чваньне
присчитывать	прылі´чваць
проба	спро´ба
пробегать	прабяга´ць
проблема	пробле´ма
проблема деления чисел	пробле´ма падзе´лу лі´каў
проблема обращения	пробле´ма абарачэ´ньня
проведение	правядзе´ньне
проведенный	праве´дзены
проверка	праве´рка
проверка корня	праве´рка ко´раня
проверка уравнения	праве´рка раўна´ньня
проверять	правяра´ць
провести (прямую)	праве´сьці (про´стую)
провизия	прові´зія
прогрессия	прогрэ´сія
прогрессия арифметическая	прогрэ´сія арытмэты´чная
прогрессия бесконечная	прогрэ´сія бескане´чная
прогрессия возрастающая	прогрэ´сія ўзраста´льная
прогрессия геометрическая	прогрэ´сія геомэтры´чная
прогрессия конечная	прогрэ´сія кане´чная
прогрессия убывающая	прогрэ´сія спада´льная
продолжать функцию	праця´гваць фу´нкцыю
продолжение	праця´г
продолжение функции аналитическое	праця´г фу´нкцыі аналіты´чны
проективность	проекты´ўнасьць
проективность кривая	проекты´ўнасьць крыва´я
проективность лучей	проекты´ўнасьць праме´ньняў
проективность сопряженная	проекты´ўнасьць спрэ´жаная
проективность циклическая	проекты´ўнасьць цыклі´чная
проективный	проекты´ўны
проектировать	проектава´ць
проектирующий	проектава´льны
проекционный	проекцы´йны
проекция	прое´кцыя
проекция вертикальная	прое´кцыя вэртыка´льная
проекция гармоническая	прое´кцыя гармоні´чная
проекция гиперболическая	прое´кцыя гіпэрболі´чная
проекция горизонтальная	прое´кцыя горызонта´льная, пазе´мная
проекция изометрическая	прое´кцыя ізомэтры´чная
проекция косая	прое´кцыя каса´я
проекция кривая	прое´кцыя крыва´я
проекция лучей	прое´кцыя праме´ньняў
проекция лучей кривая	прое´кцыя праме´ньняў крыва´я
проекция монодиметрическая	прое´кцыя монадымэтры´чная
проекция нижняя	прое´кцыя ні´жняя
проекция ортогональная	прое´кцыя ортагона´льная
проекция параболическая	прое´кцыя параболі´чная
проекция параллельная	прое´кцыя парале´льная
проекция стереографическая	прое´кцыя стэрэаграфі´чная
проекция точек	прое´кцыя пу´нктаў
проекция триметрическая	прое´кцыя трымэтры´чная
проекция центральная	прое´кцыя цэнтра´льная
проекция эллиптическая	прое´кцыя эліпты´чная
произведение	здабы´так
произведение бесконечное	здабы´так бескане´чны
произведение расходящееся	здабы´так разьбе´жны
произведение сходящееся	здабы´так зьбе´жны
произведение частичное	здабы´так часьці´нны
производить (действие)	рабі´ць (дзе´яньне)
производить подстановку	рабі´ць падстано´ўку
производная	вывадна´я
производная высшая	вывадна´я вышэ´йшая
производная логарифмическая	вывадна´я лёгарытмі´чная
производная полная	вывадна´я по´ўная
производная частная	вывадна´я ча´сная
производный	вывадны´
произвольный	адво´льны
промежуток	праме´жак
промежуточный	праме´жны
проницание	праніка´ньне
пропорциональность	пропорцыяна´льнасьць
пропорциональность обратная	пропорцыяна´льнасьць адваро´тная
пропорциональность прямая	пропорцыяна´льнасьць про´стая
пропорциональный	пропорцыяна´льны
пропорциональный непрерывный	пропорцыяна´льны неперары´ўны
пропорциональный обратно	пропорцыяна´льны адваро´тна
пропорциональный четвертый	пропорцыяна´льны чацьве´рты
пропорциональное среднее	пропорцыяна´льны сярэ´дні
пропорция	пропо´рцыя
пропорция арифметическая	пропо´рцыя арытмэты´чная
пропорция гармоническая	пропо´рцыя гармоні´чная
пропорция геометрическая	пропо´рцыя геомэтры´чная
пропорция многочленная	пропо´рцыя многачле´нная
пропорция непрерывная	пропо´рцыя неперары´ўная
пропорция правильная	пропо´рцыя пра´вільная
пропорция производная	пропо´рцыя вывадна´я
пропорция сложная	пропо´рцыя склада´ная
простой	про´сты
пространственный	прасто´равы
пространство	прасто´ра
пространство аффинное	прасто´ра афі´нная
пространство беспредельное	прасто´ра бязьме´жная
пространство гиперболическое	прасто´ра гіпэрболі´чная
пространство гомографическое	прасто´ра гомаграфі´чная
пространство двухстороннее	прасто´ра двухбо´чная
пространство евклидово	прасто´ра эўклі´дава
пространство замкнутое	прасто´ра замкну´тая
пространство кватернионное	прасто´ра кватэрніё´нная
пространство коллинеарное	прасто´ра колінэа´рная
пространство линейно связное	прасто´ра ліне´йна зьвя´зная
пространство линейное	прасто´ра ліне´йная
пространство многих измерений	прасто´ра мно´гіх выме´раў
пространство неевклидово	прасто´ра няэўклі´дава
пространство ограниченное	прасто´ра аграні´чаная
пространство однородное	прасто´ра аднаро´дная
пространство одностороннее	прасто´ра аднабо´чная
пространство параболическое	прасто´ра параболі´чная
пространство предметное	прасто´ра прадме´тная
пространство призматическое	прасто´ра прызматы´чная
пространство проективное	прасто´ра проекты´ўная
пространство псевдосферическое	прасто´ра псэўдасфэры´чная
пространство сопряженное	прасто´ра спрэ´жаная
пространство эллиптическое	прасто´ра эліпты´чная
противодвойственность	процідво´йнасьць
противолежащий	проціле´глы
противоположность	проціле´жнасьць
противоположность симметрическая	проціле´жнасьць сымэтры´чная
противоположный	проціле´жны
противоречить	супярэ´чыць
протяжение	прасьця´г
процент	про´цант
проценты простые	про´цанты про´стыя
проценты сложные	про´цанты склада´ныя
прямая	про´стая
прямая бесконечно далекая	про´стая бескане´чна далё´кая
прямая бесконечная	про´стая бескане´чная
прямая гиперболическая	про´стая гіпэрбо´лічная
прямая главная	про´стая гало´ўная
прямая двойная	про´стая падво´йная
прямая действительная	про´стая рэчаі´стая
прямая диаметральная	про´стая дыямэтра´льная
прямая минимальная	про´стая мініма´льная
прямая на конечном расстоянии	про´стая на кане´чнай адле´гласьці
прямая наклонная	про´стая нахі´леная
прямая неограниченная	про´стая неаграні´чаная
прямая оснований	про´стая асно´ваў
прямая основная	про´стая асно´ўная
прямая параболическая	про´стая параболі´чная
прямая параллельная	про´стая парале´льная
прямая перпендикулярная	про´стая пэрпэндыкуля´рная
прямая погонная	про´стая паго´нная
прямая полярная	про´стая поля´рная
прямая предельная	про´стая грані´чная
прямая радикальная	про´стая радыка´льная
прямая сечения	про´стая сячэ´ньня
прямая, соединяющая середины двух сторон треугольника	про´стая, што злуча´е сярэ´дзіны двух бако´ў трыку´тніка
прямая сопряженная	про´стая спрэ´жаная
прямая числовая	про´стая лі´кавая
прямая эллиптическая	про´стая эліпты´чная
прямой	про´сты
прямолинейно	просталіне´йна
прямолинейный	просталіне´йны
прямо пропорциональный	про´ста пропорцыяна´льны
прямоугольник	простаку´тнік
прямоугольный	простаку´тны
прямые взаимно перпендикулярные	про´стыя ўзае´мна пэрпэндыкуля´рныя
прямые скрещивающиеся	про´стыя мімабе´жныя
псевдосфера	псэўдасфэ´ра
псевдопериодический	псэўдапэрыяды´чны
псевдосферический	псэўдасфэры´чны
путь	пуць
путь интегрирования	пуць інтэграва´ньня
пучек	пучо´к
пучек инволюционный	пучо´к інволюцы´йны
пучек касательных	пучо´к даты´чных
пучек кривых	пучо´к крывы´х
пучек лучей	пучо´к праме´ньняў
пучек лучей 2-го порядка	пучо´к праме´ньняў 2-га пара´дку
пучек лучей гармонический	пучо´к праме´ньняў гармоні´чны
пучек лучей перспективный	пучо´к праме´ньняў пэрспэкты´ўны
пучек перспективный	пучо´к пэрспэкты´ўны
пучек плоскостей	пучо´к ро´ўніцаў
пучек полярных плоских систем	пучо´к поля´рных пло´скіх сыстэ´маў
пучек порядковый	пучо´к пара´дкавы
пучек прямых	пучо´к про´стых
пятерка	пяцё´рка
пятигранник	пяцігра´ньнік
пятиугольник	пяціку´тнік
пятиугольник звездчатый	пяціку´тнік зо´рчасты
пятиугольник криволинейный	пяціку´тнік крываліне´йны
пятиугольный	пяціку´тны
равенство	ро´ўнасьць
равенство безусловное	ро´ўнасьць бязумо´ўная
равенство геометрическое	ро´ўнасьць геомэтры´чная
равенство гониометрическое	ро´ўнасьць гоніёмэтры´чная
равенство треугольников	ро´ўнасьць трыку´тнікаў
равенство условное	ро´ўнасьць умо´ўная
равнобедренность	роўнапле´чнасьць
равнобедренный	роўнапле´чны
равновеликость	роўнавялі´касьць
равновеликий	роўнавялі´кі
равновозможность	роўнамагчы´масьць
равновозможный	роўнамагчы´мы
равнозначный	роўназна´чны
равнозначащий	роўназна´чны
равномерно	роўнаме´рна
равномерный	роўнаме´рны
равноотстоящий	роўнаадле´глы
равносторонний	роўнабо´чны
равноугольный	роўнаку´тны
равноудаленный	роўнаадда´лены
равнофокусный	роўнафока´льны
равный	ро´ўны
равные попарно	ро´ўныя па´рамі
равняться	раўня´цца
радиан	радыя´н
радиальный	радыя´льны
радикал	радыка´л
радикальный	радыка´льны
радиус	ра´дыюс
радиус кривизны	ра´дыюс крыві´зны
радиус обратный	ра´дыюс адваро´тны
радиус окружности	ра´дыюс акру´жыны
радиус основания	ра´дыюс асно´вы
радиус, проведенный в точку касания	ра´дыюс, праве´дзены ў пункт до´тыку
радиус сопряженный	ра´дыюс спрэ´жаны
радиус сходимости	ра´дыюс зьбе´жнасьці
радиус-вектор	ра´дыюс-вэ´ктар (на паперы без злучка, але магчыма гэта абдрукоўка)
развернутый	разго´рнуты
развернуть определитель	разгарну´ць вызна´чнік
развертка	разго´ртка
развертка цилиндра	разго´ртка цылі´ндра
развертывать	разго´ртваць
развертывать на плоскость	разго´ртваць на ро´ўніцу
развертывающийся	разго´ртвальны
разветвление	разгаліне´ньне
разветвление вершин	разгаліне´ньне вяршы´няў
развивать	разьвіва´ць
разделение	падзе´л
разлагать	расклада´ць
разлагать на множителей	расклада´ць на мно´жнікі
разлагаться	расклада´цца
разложение	расклада´ньне, раскла´д
разложение в ряд	расклада´ньне ў рад
разложение на множителей	расклада´ньне на мно´жнікі
разложимость	расклада´льнасьць
разложимый	расклада´льны
размещение	разьмяшчэ´ньне
разница	ро´зьніца
разноименный	рознайме´нны
разностный	ро´зьнічны
разносторонний	рознабо´чны
разность	ро´зьніца
разность арифметической прогрессии	ро´зьніца арытмэты´чнай прогрэ´сіі
разность арифметической пропорции	ро´зьніца арытмэты´чнай пропо´рцыі
разность табличная	ро´зьніца таблі´чная
разных направлений	ро´зных кіру´нкаў
разрыв	разры´ў
разрыв функции	разры´ў фу´нкцыі
ранг	ранг
ранг кривой	ранг крыво´й
раскрытие определителя	раскрыцьцё´ вызна´чніка
располагать	пара´дкаваць
расположение	упара´дкаваньне
расположение многочлена	упара´дкаваньне многачле´на
расположенный	упара´дкаваны
распределение	разьмеркава´ньне
распределение погрешностей	разьмеркава´ньне хі´бнасьцяў
распределительный	разьмеркава´льны
распределять	разьмярко´ўваць
растворение	расхі´л
растворение циркуля	расхі´л цы´ркуля
рассекать	расьсяка´ць
расстояние	адле´гласьць
расстояние полярное	адле´гласьць поля´рная
расстояние сферическое	адле´гласьць сфэры´чная
расстояние фокусов	адле´гласьць фо´кусаў
расходимость	разьбе´жнасьць
расходящийся	разьбе´жны
расширенный	пашы´раны
рационализация знаменателя	рацыяналіза´цыя назо´ўніка
рационально	рацыяна´льна
рациональный	рацыяна´льны
реальный	рэа´льны
ребро	кант
ребро боковое	кант бо´чны
ребро вертикальное	кант вэртыка´льны
ребро возврата	кант зваро´ту
ребро горизонтальное	кант горызо´нтальны, пазе´мны
ребро двухгранного угла	кант дзьвюхгра´ннага кута´
ребро многогранного угла	кант многагра´ннага кута´
ребро при основании	кант пры асно´ве
редукция	рэду´кцыя
редукция угловых функций	рэду´кцыя кутавы´х фу´нкцыяў
резидуальный	рэзыдуа´льны
резольвента	рэзольвэ´нта
результант	рэзульта´нт
результат	рэзульта´т
результат вращения	рэзульта´т вярчэ´ньня
результат приближенный	рэзульта´т наблі´жаны
результирующий	выніка´льны
реккурентный	рэкурэ´нтны
рельефный	рэлье´фны
рента	рэ´нта
рента пожизненная	рэ´нта дажыцьцё´вая
решать	разьвя´зваць
решать уравнение	разьвя´зваць раўна´ньне
решение	разьвяза´ньне, разьвя´зак
решение алгебраическое	разьвяза´ньне альгэбры´чнае
решение задачи	разьвяза´ньне зада´чы, разьвя´зак зада´чы
решение особенное	разьвя´зак асаблі´вы
решение побочное	разьвя´зак пабо´чны
решение приближенное	разьвя´зак наблі´жаны
решение пропорции	разьвяза´ньне пропо´рцыі
решение треугольника	разьвяза´ньне трыку´тніка
решение уравнения	разьвяза´ньне раўна´ньня, разьвя´зак раўна´ньня
решето эратосфеново	рэ´шата эратостэ´нава
решимость	разьвяза´льнасьць
решимый	разьвяза´льны
решить уравнение	разьвяза´ць раўна´ньне
риск математический	ры´зыка матэматы´чная
рисунок	рысу´нак
род	род
род геометрический	род геомэтры´чны
род числовой	род лі´кавы
родственный	ро´дны
ромб	ромб
ромбоид	ромбо´ід
ромбоидальный	ромбоіда´льны
ряд	рад
ряд абсолютно сходящийся	рад абсолю´тна зьбе´жны
ряд арифметический	рад арытмэты´чны
ряд бесконечный	рад бескане´чны
ряд возрастающий	рад узраста´льны
ряд гармонический	рад гармоні´чны
ряд геометрический	рад геомэтры´чны
ряд гипергеометрический	рад гіпэргеомэтры´чны
ряд двойной	рад падво´йны
ряд канонический	рад каноні´чны
ряд натуральных чисел	рад натура´льных лі´каў
ряд неопределенный	рад неазна´чаны
ряд осциллирующий	рад осцылява´льны
ряд показательный	рад паказа´льнікавы
ряд равномерно сходящийся	рад роўнаме´рна зьбе´жны
ряд равных отношений	рад ро´ўных стасу´нкаў
ряд разностный	рад ро´зьнічны
ряд расходящийся	рад разьбе´жны
ряд реккурентный	рад рэкурэ´нтны
ряд сходящийся	рад зьбе´жны
ряд точек	рад пу´нктаў
ряд точек гомографический	рад пу´нктаў гомаграфі´чны
ряд точек коллинеарный	рад пу´нктаў колінеа´рны
ряд точек кривой	рад пу´нктаў крыво´й
ряд точек наложенный	рад пу´нктаў нало´жаны
ряд точек перспективный	рад пу´нктаў пэрспэкты´ўны
ряд точек совместимый	рад пу´нктаў сумяшча´льны
ряд точек тождественный	рад пу´нктаў тожса´мы
ряд тригонометрический	рад трыгономэтры´чны
ряд триметрический	рад трымэтры´чны
ряд убывающий	рад спада´льны
ряд условно сходящийся	рад умо´ўна зьбе´жны
ряд циклометрический	рад цыклямэтры´чны
c избытком	з перавы´шкай
с недостатком	з недахва´там
самокасание	самадо´тык
сверхнормальный	наднорма´льны
свивание	зьвіва´ньне
свободный	во´льны
свойство	уласьці´васьць
свойство основное	уласьці´васьць асно´ўная
связка	зьвя´зка
связка конгруентная	зьвя´зка конгруэ´нтная
связка конических сечений	зьвя´зка коні´чных сячэ´ньняў
связка лучей	зьвя´зка праме´ньняў
связка плоскостей	зьвя´зка ро´ўніцаў
связка поверхностей	зьвя´зка паве´рхняў
связка подобная	зьвя´зка падо´бная
связка полярная	зьвя´зка поля´рная
связка проективная	зьвя´зка проекты´ўная
связка прямых	зьвя´зка про´стых
связка равная	зьвя´зка ро´ўная
связность	зьвя´знасьць
связный	зьвя´зны
сгущение	згушчэ´ньне
сегмент	сэгмэ´нт
сегмент конический	сэгмэ´нт коні´чны
сегмент круговой	сэгмэ´нт кругавы´
сегмент шаровой	сэгмэ´нт сфэры´чны
секанс	сэ´канс
сектор	сэ´ктар
сектор конический	сэ´ктар коні´чны
сектор круговой	сэ´ктар кругавы´
сектор кругового кольца	сэ´ктар кругаво´га ко´лца
сектор шаровой	сэ´ктар сфэры´чны
секстант	сэкста´нт
секунда	сэку´нда
секущая	сяку´чая
секущий	сяку´чы
семейство	сям'я´
семейство конических сечений	сям'я´ коні´чных сячэ´ньняў
семейство кривых	сям'я´ крывы´х
семейство полярных полей	сям'я´ поля´рных палё´ў
семейство преобразований	сям'я´ ператварэ´ньняў
семейство сизигетическое	сям'я´ сызыгеты´чная
семерка	сямё´рка
семивариант	сэміварыя´нт
семидетерминант	сэмідэтэрміна´нт
семиугольник	сяміку´тнік
середина	сярэ´дзіна
середина отрезка	сярэ´дзіна адрэ´зка
серпентина	сэрпэнты´на
сеть	се´тка
сеть кубов пространственная	се´тка ку´баў прасто´равая
сеть лучей	се´тка праме´ньняў
сеть основная	се´тка асно´ўная
сеть поверхностей	се´тка паве´рхняў
сечение	сячэ´ньне
сечение абсолютное	сячэ´ньне абсолю´тнае
сечение возвратное	сячэ´ньне зваро´тнае
сечение главное	сячэ´ньне гало´ўнае
сечение диагональное	сячэ´ньне дыягона´льнае
сечение коническое	сячэ´ньне коні´чнае
сечение коническое двойное	сячэ´ньне коні´чнае падво´йнае
сечение коническое полярное	сячэ´ньне коні´чнае поля´рнае
сечение коническое конфокальное	сячэ´ньне коні´чнае конфока´льнае
сечение коническое фокусное	сячэ´ньне коні´чнае фока´льнае
сечение круговое	сячэ´ньне кругаво´е
сечение осевое	сячэ´ньне во´севае
сечение параллельное	сячэ´ньне парале´льнае
сечение перпендикулярное	сячэ´ньне пэрпэндыкуля´рнае
сечение пирамиды диагональное	сячэ´ньне пірамі´ды дыягона´льнае
сечение плоcкое	сячэ´ньне пло´скае
сечение площадей	сячэ´ньне пло´шчаў
сечение поперечное	сячэ´ньне папярэ´чнае
сечение призмы диагональное	сячэ´ньне пры´змы дыягона´льнае
сечение среднее	сячэ´ньне сярэ´дняе
сечение среднее усеченного конуса	сячэ´ньне сярэ´дняе зрэ´занага ко´нуса
сечение шара плоскостью	сячэ´ньне сфэ´ры ро´ўніцаю
сизигетический	сызыгеты´чны
сизигетичность	сызыгеты´чнасьць
символ	сы´мболь
символ неопределенный	сы´мболь неазна´чаны
символический	сымболі´чны
симметраль	сымэтра´ль
симметральный	сымэтра´льны
симметрический	сымэтры´чны
симметрически относительно (оси)	сымэтры´чны адно´сна (во´сі)
симметрия	сымэ´тры´я
симметрия относительно оси	сымэ´тры´я адно´сна во´сі
симметрия относительно плоскости	сымэ´тры´я адно´сна ро´ўніцы
симметрия относительно центра	сымэ´тры´я адно´сна цэ´нтра
симметрия плоская	сымэ´тры´я пло´ская
симметрия пространственная	сымэ´тры´я прасто´равая
симметрия центральная	сымэ´тры´я цэнтра´льная
симметроид	сымэтро´ід
синтез	сы´нтэз
синтетический	сынтэты´чны
синус	сі´нус
синусоида	сінусо´іда
синусоидальный	сінусоіда´льны
система	сыстэ´ма
система аффинная	сыстэ´ма афі´нная
система биполярная	сыстэ´ма біполя´рная
система вычетов	сыстэ´ма лі´шкаў
система геометрии	сыстэ´ма геомэ´трыі
система гомографическая	сыстэ´ма гомаграфі´чная
система десятичная	сыстэ´ма дзесятко´вая
система импримитивности	сыстэ´ма імпрыміты´ўнасьці
система интегралов	сыстэ´ма інтэгра´лаў
система интегралов основная	сыстэ´ма інтэгра´лаў асно´ўная
система каноническая	сыстэ´ма каноні´чная
система коллинеарная	сыстэ´ма колінэа´рная
система координат	сыстэ´ма коордына´таў
система координат косоугольная	сыстэ´ма коордына´таў косаку´тная
система координат полярная	сыстэ´ма коордына´таў поля´рная
система координат прямоугольная	сыстэ´ма коордына´таў простаку´тная
система логарифмов	сыстэ´ма лёгары´тмаў
система метрическая	сыстэ´ма мэтры´чная
система нормалей	сыстэ´ма норма´ляў
система нулевая	сыстэ´ма нулява´я
система основная	сыстэ´ма асно´ўная
система основная взаимная	сыстэ´ма асноў´ная ўзае´мная
система плоскостей	сыстэ´ма ро´ўніцаў
система поверхностей	сыстэ´ма паве´рхняў
система полная	сыстэ´ма по´ўная
система правильная	сыстэ´ма пра´вільная
система противоречивых уравнений	сыстэ´ма супярэ´чных раўна´ньняў
система сопряженная	сыстэ´ма спрэ´жаная
система счисления	сыстэ´ма лічэ´ньня
система счисления десятичная	сыстэ´ма лічэ´ньня дзесятко´вая
система точек	сыстэ´ма пу´нктаў
система тройная	сыстэ´ма патро´йная
система уравнений	сыстэ´ма раўна´ньняў
система уравнений, в которой число уравнений больше неизвестных	сыстэ´ма раўна´ньняў, у якой лік раўна´ньняў больш за лік невядо´мых
система уравнений неопределенная	сыстэ´ма раўна´ньняў неазна´чаная
система циклическая	сыстэ´ма цыклі´чная
система эквивалентная	сыстэ´ма эквівале´нтная
систематический	сыстэматы´чны
скаляр	скаля´р
складывать	скла´дваць
скобка	ду´жка
скобка квадратная	ду´жка квадра´тная
скобка круглая	ду´жка кру´глая
скобка фигурная	ду´жка фігу´рная
скользить	сьлі´згацца, сьлізгаце´ць
скольжение	сьлі´зганьне, сьлізгаце´ньне
скрученный	скру´чаны
слагаемое	складні´к
след	сьлед
след горизонтальный	сьлед горызонта´льны, пазе´мны
следовать	выхадзі´ць
следствие	вы´нік
сложение	склада´ньне
сложение приближенное	склада´ньне наблі´жанае
сложный	склада´ны, сустаўны´
слой	слой
слой кубических метров	слой кубі´чных мэ´траў
слой поверхностный	слой паве´рхневы
слой шаровой	слой сфэры´чны
слой концентрический	слой концэнтры´чны
случай	вы´падак
случай равенства	вы´падак ро´ўнасьці
случай частный	вы´падак ча´сны
случайность	выпадко´васьць
случайный	выпадко´вы
смежный	суме´жны
смесь	су´месь
смешанный	мяша´ны
смешение	зьмяшэ´ньне
смысл неравенства	сэнс няро´ўнасьці
собственный	уласьці´вы, ула´сны
совершать действие	рабі´ць дзе´яньне
совершенный	зако´нчаны
совместимость	сумяшча´льнасьць
совместимость плоскостей	сумяшча´льнасьць ро´ўніцаў
совместимый	сумяшча´льны
совместный	суме´сны
совмещенный	суме´шчаны
совокупность	ску´пнасьць
совокупность азигетическая	ску´пнасьць азыгеты´чная
совокупность сизигетическая	ску´пнасьць сызыгеты´чная
совокупность чисел	ску´пнасьць лі´каў
совпадать	супада´ць
совпадающий	супада´льны
совпадение	супадзе´ньне
согласованный	узго´днены
согнутый	сагну´ты
содержание	зьмест
соединение	злучэ´ньне
соединение в пары	злучэ´ньне па´рамі
соединение инволюционное	злучэ´ньне інволюцы´йнае
соединительный	злуча´льны
соединять	злуча´ць
соединять в лары	злуча´ць па´рамі
cоединяющий	злуча´льны
соизмеримый	супольнаме´рны
сократимый	скарача´льны
сокращать	скарача´ць
сокращать дроби	скарача´ць дро´бы
сокращение	скарачэ´ньне
сокращенный	скаро´чаны
сомножитель	cумно´жнік
соответственный	адпаве´дны
соответствие	адпаве´днасьць
соответствие бинарное	адпаве´днасьць біна´рная
соответствие взаимное	адпаве´днасьць узае´мная
соответствие гармоническое	адпаве´днасьць гармо´нічная
соответствие двойное	адпаве´днасьць падво´йная
соответствие изогональное	адпаве´днасьць ізогона´льная
соответствие инволюционное	адпаве´днасьць інволюцы´йная
соответствие непрерывное	адпаве´днасьць неперары´ўная
соответствие общее	адпаве´днасьць агульна´я
соответствие однозначное	адпаве´днасьць адназна´чная
соответствие одно-однозначное	адпаве´днасьць адна-адназна´чная
соответствие особенное	адпаве´днасьць асаблі´вая
соответствие перспективное	адпаве´днасьць пэрспэкты´ўная
соответствие полярное	адпаве´днасьць поля´рная
соответствие проективное	адпаве´днасьць проекты´ўная
соответствие циклическое	адпаве´днасьць цыклі´чная
соответствовать	адпавяда´ць
соответствующий	адпаве´дны
соотношение	суадносі´ны
сопоставление однозначное	супастаўле´ньне адназна´чнае
сопоставлять	супастаўля´ць
соприкасание	судо´тык
соприкасание внешнее	судо´тык знадво´рны
соприкасание внутреннее	судо´тык унутраны´
соприкасательный	судаты´чны
спрягать	спрага´ць
сопряжение	спражэ´ньне
сопряженный	спрэ´жаны
соседний	сусе´дні
состав	склад
состав теоремы	склад тэорэ´мы
составление	уклада´ньне
составление уравнений	уклада´ньне раўна´ньняў
составлять	уклада´ць
составляющий	склада´льны
составной	сустаўны´
состоять	склада´цца
софокусный	конфока´льны
сочетание	комбіна´цыя
сочетательный	злуча´льны
специальный	спэцыя´льны
спираль	сьпіра´ль
спираль коническая	сьпіра´ль коні´чная
спираль логарифмическая	сьпіра´ль лёгарытмі´чная
спираль цилиндрическая	сьпіра´ль цыліндры´чная
спиральный	сьпіра´льны
способ вычисления	спо´саб вылічэ´ньня
способ неопределенных коэффициентов	спо´саб неазна´чаных коэфіцые´нтаў
справляющий	кірава´льны
сравнение	параўна´ньне
сравнение двучленное	параўна´ньне двухчле´ннае
сравнение единичное	параўна´ньне адзі´нкавае
сравнение экспоненциальное	параўна´ньне экспонэнцыя´льнае
сравнение квадратичное	параўна´ньне квадраты´чнае
сравнение линейное	параўна´ньне ліне´йнае
сравнивать	параўно´ўваць
сравнимый	параўна´льны
среднее арифметическое	cярэ´дні арытмэты´чны
среднее гармоническое	cярэ´дні гармо´нічны
среднее геометрическое	cярэ´дні геомэтры´чны
среднее пропорциональное	cярэ´дні пропорцыяна´льны
средний	сярэ´дні
срочный	тэрміно´вы
старший	старэ´йшы
статистический	статысты´чны
степенной	ступе´нны
степень	ступе´нь
степень инволюции	ступе´нь інволю´цыі
степень многочлена	ступе´нь многачле´на
степень одночлена	ступе´нь адначле´на
степень окружности	ступе´нь акру´жыны
степень параболы	ступе´нь пара´болы
степень точности	ступе´нь дакла´днасьці
степень третья	ступе´нь трэ´цяя
степень уравнения	ступе´нь раўна´ньня
степень формы	ступе´нь фо´рмы
степень шара	ступе´нь сфэ´ры
стереографический	cтэрэографі´чны
стереометрический	стэрэомэтры´чны
стереометрия	стэрэомэ´трыя
сторона	бок
сторона касания	бок до´тыку
сторона ломанной	бок лама´най
сторона многоугольника	бок многаку´тніка
сторона неравенства	бок няро´ўнасьці
сторона общая	бок супо´льны
сторона прилежащая	бок прыле´глы
сторона противолежащая	бок проціле´глы
сторона противоположная	бок проціле´жны
сторона равенства	бок ро´ўнасьці
сторона треугольника	бок трыку´тніка
сторона угла	бок кута´
сторона уравнения	бок раўна´ньня
стремиться к пределу	імкну´цца да грані´цы
строить	будава´ць
строка определителя	радо´к вызна´чніка
строфоида	строфо´іда
субдетерминант	субдэтэрміна´нт
субдискриминант	субдыскрыміна´нт
субституционный	субстытуцы´йны
субституция	субстыту´цыя
сумма	су´ма
сумма алгебраическая	су´ма альгебры´чная
суммирование	сумава´ньне
суммировать	сумава´ць
существенный	істо´тны
сфера	сфэ´ра
сферический	сфэры´чны
сфероид	сфэро´ід
сходимость	зьбе´жнасьць
сходимость абсолютная	зьбе´жнасьць абсолю´тная
сходимость колебательная	зьбе´жнасьць вага´льная
сходимость монотонная	зьбе´жнасьць монато´нная
сходимость равномерная	зьбе´жнасьць роўнаме´рная
сходимость условная	зьбе´жнасьць умо´ўная
сходиться	зьбяга´цца
сходящийся	зьбе´жны
счет	лічэ´ньне
счетность	зьліча´льнасьць
счетный	зьліча´льны
считать	лічы´ць
таблица	таблі´ца
таблица вычитания	таблі´ца адніма´ньня
таблица деления	таблі´ца дзяле´ньня
таблица логарифмическая	таблі´ца лёгарытмі´чная
таблица сложения	таблі´ца склада´ньня
таблица умножения	таблі´ца мно´жаньня
табличный	таблі´чны
тангенс	та´нгенс
тангенциальный	тангенцы´яльны
тезис	тэ´зыс
текущий	бягу´чы
тело	це´ла
тело вращения	це´ла вярчэ´ньня
тело геометрическое	це´ла геомэтры´чнае
тело граненное	це´ла гра´ненае, канто´вае
тело круглое	це´ла кру´глае
тело правильное	це´ла пра´вільнае
тензор	тэ´нзар
тень	цень
тень падения	цень упа´ду
тень собственная	цень ула´сны
теорема	тэорэ´ма
теорема колебания	тэорэ´ма вага´ньня
теорема о среднем значении	тэорэ´ма аб сярэ´днім значэ´ньні
теорема обратная	тэорэ´ма адваро´тная
теорема основная	тэорэ´ма асно´ўная
теорема противоположная	тэорэ´ма проціле´жная
теорема прямая	тэорэ´ма про´стая
теорема сложения	тэорэ´ма склада´ньня
теорема умножения	тэорэ´ма мно´жаньня
теоретический	тэорэты´чны
теория	тэо´рыя
теория арифметическая	тэо´рыя арытмэты´чная
теория выравнения погрешностей	тэо´рыя выро´ўніваньня хі´бнасьцяў
теория групп	тэо´рыя гру´паў
теория деления круга	тэо´рыя падзе´лу кру´га
теория дисперсии	тэо´рыя дыспэ´рсіі
теория индексов	тэо´рыя і´ндэксаў
теория множеств	тэо´рыя мно´стваў
теория погрешностей	тэо´рыя хі´бнасьцяў
теория соединений	тэо´рыя злу´чэньняў
теория форм	тэо´рыя фо´рмаў
теория чисел	тэо´рыя лі´каў
тетраметрический	тэтрамэтры´чны
тетраэдр	тэтраэ´др
тетраэдр сопряженный	тэтраэ´др спрэ´жаны
тетраэдрический	тэтраэдры´чны
тетраэдроид	тэтраэдро´ід
тип порядковый	тып пара´дкавы
типичный	тыпо´вы
тождественный	тожса´мы
тождество	тожса´масьць
толщина	таўшчыня´
топографический	топаграфі´чны
топология	топалё´гія
точечный	пу´нктавы
точка	пункт
точка абсолютно сопряженная	пункт абсолю´тна спрэ´жаны
точка асимптотическая	пункт асымптоты´чны
точка ассоцированная	пункт асоцыява´ны
точка бесконечно далекая	пункт бескане´чна далё´кі
точка бипланарная	пункт біпляна´рны
точка возврата	пункт зваро´ту
точка вязки основная	пункт вя´зкі асно´ўны
точка гармоническая	пункт гармоні´чны
точка гиперболическая	пункт гіпэрболі´чны
точка главная	пункт гало´ўны
точка двойная	пункт падво´йны
точка двойная видимая	пункт падво´йны відо´чны
точка двойная действительная	пункт падво´йны рэчаі´сты
точка двойная мнимая	пункт падво´йны ўя´ўны
точка действительная	пункт рэчаі´сты
точка деления	пункт падзе´лу
точка десятичная	пункт дзесятко´вы
точка диагональная	пункт дыягона´льны
точка единичная	пункт адзі´нкавы
точка единичная относительная	пункт адзі´нкавы адно´сны
точка закругления	пункт закругле´ньня
точка зрения	пункт зро´ку
точка изгиба	пункт вы´гібу
точка изолированная	пункт ізолява´ны
точка исключительная	пункт выклю´чны
точка исходная	пункт выхо´дны
точка касания	пункт до´тыку
точка конечная	пункт кане´чны
точка коническая	пункт коні´чны
точка коническая двойная	пункт коні´чны падво´йны
точка кратная	пункт кра´тны
точка мнимая	пункт уя´ўны
точка начальная	пункт пачатко´вы
точка недоступная	пункт недасту´пны
точка несущественно особенная	пункт няісто´тна асаблі´вы
точка нулевая	пункт нулявы´
точка общая	пункт супо´льны
точка особенная	пункт асаблі´вы
точка параболическая	пункт параболі´чны
точка погонная	пункт паго´нны
точка подобия внешняя	пункт падо´бнасьці знадво´рны
точка подобия внутренняя	пункт падо´бнасці ўнутраны´
точка постоянная	пункт ста´лы
точка правильная	пункт пра´вільны
точка предельная	пункт грані´чны
точка разветвления	пункт разгаліне´ньня
точка самокасания	пункт самадо´тыку
точка сгущения	пункт згушчэ´ньня
точка сети	пункт се´ткі
точка сечения	пункт сячэ´ньня
точка соответственная	пункт адпаве´дны
точка сопряженная	пункт спрэ´жаны
точка существенно особенная	пункт істо´тна асаблі´вы
точка сходимости	пункт зьбе´жнасьці
точка текущая	пункт бягу´чы
точка узловая	пункт вузлавы´
точка ундуляционная	пункт ундуляцы´йны
точка унипланарная	пункт уніпляна´рны
точка фиксационная	пункт фіксацы´йны
точка циклическая	пункт цыклі´чны
точка эквиангармоническая	пункт эквіангармоні´чны
точка эллиптическая	пункт эліпты´чны
точно определенный	дакла´дна азна´чаны
точность	дакла´днасьць
точный	дакла´дны
трактрисса	трактры´са
трансверсаль	трансвэрса´ль
трансверсальный	трансвэрса´льны
транзитивность	транзыты´ўнасьць
транзитивный	транзыты´ўны
транспозиция	транспозы´цыя
транспонированный	транспонава´ны
транспонирующий	транспонава´льны
транспортир	транспорты´р
трансфинитный	трансфіні´тны
трансформация	трасформа´цыя
трансформационный	трансформацы´йны
трансцендентность	трансцэндэ´нтнасьць
трансцендентный	трансцэндэ´нтны
трапезоид	трапэзо´ід
трапеция	трапэ´цыя
трапеция криволинейная	трапэ´цыя крываліне´йная
трапеция прямоугольная	трапэ´цыя простаку´тная
трапеция равнобедренная	трапэ´цыя роўнапле´чная
траса	тра´са
траса вертикальная	тра´са вэртыка´льная
траса горизонтальная	тра´са горызонта´льная, пазе´мная
требование	вымо´га
трегранный	трохгра´нны
треугольник	трыку´тнік
треугольник диагональный	трыку´тнік дыягона´льны
треугольник координатный	трыку´тнік коордына´тны
треугольник косоугольный	трыку´тнік косаку´тны
треугольник криволинейный	трыку´тнік крываліне´йны
треугольник описанный	трыку´тнік апі´саны
треугольник осевой	трыку´тнік во´севы
треугольник основной	трыку´тнік асно´ўны
треугольник остроугольный	трыку´тнік востраку´тны
треугольник Паскаля	трыку´тнік Паска´леў
треугольник полярный	трыку´тнік поля´рны
треугольник прямоугольный	трыку´тнік простаку´тны
треугольник равнобедренный	трыку´тнік роўнапле´чны
треугольник равновеликий	трыку´тнік роўнавялі´кі
треугольник равносторонний	трыку´тнік роўнабо´чны
треугольник равный	трыку´тнік ро´ўны
треугольник разносторонний	трыку´тнік рознабо´чны
треугольник сопряженный	трыку´тнік спрэ´жаны
треугольник сопряженный с самим собой	трыку´тнік спрэ´жаны з самы´м сабо´ю
треугольник сферический	трыку´тнік сфэры´чны
треугольник сферический полярный	трыку´тнік сфэры´чны поля´рны
треугольник сферический противоположный	трыку´тнік сфэры´чны проціле´жны
треугольник сферический смежный	трыку´тнік сфэры´чны суме´жны
треугольник тупоугольный	трыку´тнік тупаку´тны
треугольный	трыку´тны
трехкратность	трохкра´тнасьць
трехкратный	трохкра´тны
трехмерный	трохме´рны
трехсторонник	трохбо´чнік
трехсторонник криволинейный	трохбо´чнік крываліне´йны
трехсторонник пучка	трохбо´чнік пучка´
трехсторонник равнобедренный	трохбо´чнік роўнапле´чны
трехчлен	трохчле´н
трехчлен квадратный	трохчле´н квадра´тны
трехчленный	трохчле´нны
тригонометрический	трыгонамэтры´чны
тригонометрия	трыгонамэ´трыя
тригонометрия прямолинейная	трыгонамэ´трыя просталіне´йная
тригометрия сферическая	трыгонамэ´трыя сфэры´чная
трилинейный	трыліне´йны
триметрический	трымэтры´чны
трисекция	трысэ´кцыя
trifolium Decarti	Дэка´ртаў трылі´сьнік
тройка	тро´йка
тройка азигетическая	тро´йка азыгеты´чная
тройка двойная	тро´йка падво´йная
тройка действительная	тро´йка рэчаі´стая
тройка сизигетическая	тро´йка сызыгеты´чная
тройка точек	тро´йка пу´нктаў
тройничный	патро´йны
тройной	патро´йны
трохоида	трохо´іда
трубчастый	трубча´сты
тупой	тупы´
тупоугольный	тупаку´тны
тысяча	ты´сяча
убывание	спада´ньне
убывать	спада´ць
убывающий	спада´льны
увеличение	павялічэ´ньне
увеличение одного числа другим	павялічэ´ньне аднаго´ лі´ку другі´м
увеличивание	павялі´чваньне
увеличивать	павялі´чваць
угловой	кутавы´
угол	кут
угол в полуокружности	кут у паўакру´жыне
угол вертикальный	кут вэртыка´льны
угол, вершина которого лежит внутри круга	кут, вяршыня´ яко´га ляжы´ць унутры´ круга´
угол внешний	кут знадво´рны
угол внутренний	кут унутраны´
угол вписанный	кут упі´саны
угол вращения	кут вярчэ´ньня
угол вспомогательный	кут дапамо´жны
угол выгнутый	кут вы´гнуты
угол выпрямленный	кут вы´прастаны
угол двугранный	кут дзьвюхгра´нны
угол двугранный вертикальный	кут дзьвюхгра´нны вэртыка´льны
угол двугранный выпрямленный	кут дзьвюхгра´нны вы´прастаны
угол двугранный дополнительный до 90°	кут дзьвюхгра´нны дапаўня´льны да 90°
угол двугранный полярный	кут дзьвюхгра´нны поля´рны
угол двугранный смежный	кут дзьвюхгра´нны суме´жны
угол дополнительный до 90°	кут дапаўня´льны да 90°
угол дополнительный до 180°	кут дапаўня´льны да 180°
угол зрения	кут зро´ку
угол косой	кут касы´
угол линейный	кут ліне´йны
угол линейный двугранного угла	кут ліне´йны дзьвюхгра´ннага кута´
угол линейный многогранного угла	кут ліне´йны многагра´ннага кута´
угол меньший 180°	кут ме´ншы за 180°
угол многогранный	кут многагра´нны
угол многогранный выпуклый	кут многагра´нны вы´гнуты
угол многогранный полярный	кут многагра´нны поля´рны
угол многогранный правильный	кут многагра´нны пра´вільны
угол наклонения	кут нахіле´ньня
угол неприлежащий	кут няпрыле´глы
угол непрямой	кут няпро´сты
угол неравный	кут няро´ўны
угол несовместимый	кут несумяшча´льны
угол острый	кут во´стры
угол отрицательный	кут адмо´ўны
угол полный	кут по´ўны
угол положительный	кут дада´тны
угол полярный	кут поля´рны
угол при основании	кут пры асно´ве
угол прилежащий	кут прыле´глы
угол противоположный	кут проціле´жны
угол прямой	кут про´сты
угол равный	кут ро´ўны
угол смежности	кут суме´жнасьці
угол смежный	кут суме´жны
угол соответственный	кут адпаве´дны
угол сферический	кут сфэры´чны
угол трегранный	кут трохгра´нны
угол трегранный прямоугольный	кут трохгра´нны простаку´тны
угол трегранный равнобедренный	кут трохгра´нны роўнапле´чны
угол тупой	кут тупы´
угол центральный	кут цэнтра´льны
углы односторонние	куты´ аднабо´чныя
углы попарно равные	куты´ па´рамі ро´ўныя
углы разносторонние	куты´ рознабо´чныя
удаленный	адда´лены
удваивать	падво´йваць
удвоенный	падво´ены
удовлетворять	здавальня´ць
удовлетворять арифметическому отношению	здавальня´ць арытмэты´чны стасу´нак
удовлетворять уравнению	здавальня´ць раўна´ньне
узловой	вузлавы´
указательница	паказа´льніца
уклонение	ухіле´ньне
уменьшаемое	зьме´ншыва
уменьшать	зьмянша´ць
уменьшаться	зьмянша´цца
уменьшаться бесконечно	зьмянша´цца бескане´чна
уменьшение	зьмяншэ´ньне
уменьшенный	зьме´ншаны
умножать	памнажа´ць
умножение	мно´жаньне
умножение комплексное	мно´жаньне компле´кснае
умножение символическое	мно´жаньне сымболі´чнае
умножение сокращенное	мно´жаньне скаро´чанае
умноженный	памно´жаны
ундулоид	ундулё´ід
ундуляционный	ундуляцы´йны
уникурсальный	унікурса´льны
унимодулярный	унімодуля´рны
унипланарный	уніпляна´рны
уничтожать	зьнішча´ць
уничтожаться	зьнішча´цца
уничтожаться взаимно	зьнішча´цца ўзае´мна
уничтожение	зьнішчэ´ньне
уничтожение одинаковых членов	зьнішчэ´ньне адна´кіх чле´наў
уничтожение скобок	зьнішчэ´ньне ду´жак
уплата срочная	вы´плата тэрміно´вая
употребить подстановку	ужы´ць падстано´ўку
упорядоченный	упара´дкаваны
упражнение	практыкава´ньне
упражнение наглядное	практыкава´ньне наво´чнае
упражнение наочное	практыкава´ньне наво´чнае
уравнение	раўна´ньне
уравнение алгебраическое	раўна´ньне альгебры´чнае
уравнение аналитическое	раўна´ньне аналіты´чнае
уравнение биквадратное	раўна´ньне біквадра´тнае
уравнение буквенное	раўна´ньне лі´тарнае
уравнение возвратное	раўна´ньне зваро´тнае
уравнение второй степени	раўна´ньне друго´й ступе´ні
уравнение высшей степени	раўна´ньне вышэ´йшай ступе´ні
уравнение двучленное	раўна´ньне двухчле´ннае
уравнение деления круга	раўна´ньне падзе´лу кру´га
уравнение дифференциальное	раўна´ньне дыфэрэнцыя´льнае
уравнение дифференциальное линейное	раўна´ньне дыфэрэнцыя´льнае ліне´йнае
уравнение дифференциальное n-го порядка	раўна´ньне дыфэрэнцыя´льнае n-га пара´дку
уравнение дифференциальное обыкновенное	раўна´ньне дыфэрэнцыя´льнае звыча´йнае
уравнение дифференциальное полное	раўна´ньне дыфэрэнцыя´льнае по´ўнае
уравнение дифференциальное с частными производными	раўна´ньне дыфэрэнцыя´льнае з ча´снымі вывадны´мі
уравнение дифференциальное совместное	раўна´ньне дыфэрэнцыя´льнае суме´снае
уравнение дифференциальное сопряженное	раўна´ньне дыфэрэнцыя´льнае спрэ´жанае
уравнение каноническое	раўна´ньне каноні´чнае
уравнение квадратное	раўна´ньне квадра´тнае
уравнение квадратное неполное	раўна´ньне квадра´тнае няпо´ўнае
уравнение квадратное полное	раўна´ньне квадра´тнае по´ўнае
уравнение коэффициентов	раўна´ньне коэфіцые´нтаў
уравнение линейное	раўна´ньне ліне´йнае
уравнение лишнее	раўна´ньне лі´шняе
уравнение логарифмическое	раўна´ньне лёгарытмі´чнае
уравнение модулевое	раўна´ньне мо´дулевае
уравнение неопределенное	раўна´ньне неазна´чанае
уравнение неприводимое	раўна´ньне няпрыво´днае
уравнение нормальное	раўна´ньне норма´льнае
уравнение общее	раўна´ньне агу´льнае
уравнение однородное	раўна´ньне аднаро´днае
уравнение определяющее	раўна´ньне азнача´льнае
уравнение первой степени	раўна´ньне пе´ршай ступе´ні
уравнение погрешностей	раўна´ньне хі´бнасьцяў
уравнение показательное	раўна´ньне паказа´льнікавае
уравнение полярное	раўна´ньне поля´рнае
уравнение приведенное к нулю	раўна´ньне прыве´дзенае да нуля´
уравнение приводимое	раўна´ньне прыво´днае
уравнение разностное	раўна´ньне ро´зьнічнае
уравнение расположенное	раўна´ньне ўпара´дкаванае
уравнение с одним неизвестным	раўна´ньне з адны´м невядо´мым
уравнение симметрическое	раўна´ньне зваро´тнае
уравнение смешанное	раўна´ньне мяша´нае
уравнение совместимое	раўна´ньне сумяшча´льнае
уравнение соответствия	раўна´ньне адпаве´днасьці
уравнение специальное	раўна´ньне спэцыя´льнае
уравнение тождественное	раўна´ньне тожса´мае
уравнение точки	раўна´ньне пу´нкту
уравнение трансцендентное	раўна´ньне трансцэндэ´нтнае
уравнение трехчленное	раўна´ньне трохчле´ннае
уравнение тригонометрическое	раўна´ньне трыгонамэтры´чнае
уравнение условное	раўна´ньне ўмо´ўнае
уравнение функциональное	раўна´ньне функцыяна´льнае
уравнение характеристическое	раўна´ньне характарысты´чнае
уравнение числовое	раўна´ньне лі´кавае
уравнение чистое	раўна´ньне чы´стае
уравнение эквивалентное	раўна´ньне эквівале´нтнае
уровень	ро´вень
усекать	зрэ´зваць
усеченный	зрэ´заны
условие	умо´ва
условие достаточное и необходимое	умо´ва даста´тная і неабхо´дная
условие задачи	умо´ва зада´чы
условие сходимости	умо´ва зьбе´жнасьці
условно сходящийся	умо´ўна зьбе´жны
условный	умо´ўны
утроенный	патро´ены
факториал	фактарыя´л
факультет	факультэ´т
фигура	фігу´ра
фигура взаимно полярная	фігу´ра ўзае´мна поля´рная
фигура вписанная	фігу´ра ўпі´саная
фигура вращения	фігу´ра вярчэ´ньня
фигура вспомогательная	фігу´ра дапамо´жная
фигура геометрическая	фігу´ра геомэтры´чная
фигура гомотетическая	фігу´ра гомотэты´чная
фигура замкнутая	фігу´ра замкну´тая
фигура конгруентная	фігу´ра конгруэ´нтная
фигура криволинейная	фігу´ра крываліне´йная
фигура описанная	фігу´ра апі´саная
фигура плоская	фігу´ра пло´ская
фигура подобно расположенная	фігу´ра падо´бна разьме´шчаная
фигура полярная	фігу´ра поля´рная
фигура проницания	фігу´ра праніка´ньня
фигура прямолинейная	фігу´ра просталіне´йная
фигура равная	фігу´ра ро´ўная
фигура равновеликая	фігу´ра роўнавялі´кая
фигура эквивалентная	фігу´ра эквівале´нтная
фигурный	фігу´рны
фиксационный	фіксацы´йны
финикулярный	фінікуля´рны
фокальный	фока´льны
фокус	фо´кус
фокус главный	фо´кус гало´ўны
фокус мнимый	фо´кус уя´ўны
фокусный	фока´льны
форма	фо´рма
форма автоморфная	фо´рма аўтамо´рфная
форма алгебраическая	фо´рма альгебры´чная
форма аполярная	фо´рма аполя´рная
форма биквадратичная	фо´рма біквадраты´чная
форма билинейная	фо´рма біліне´йная
форма двойничная	фо´рма дваі´чная
форма дифференциальная	фо´рма дыфэрэнцыя´льная
форма инвариантная	фо´рма інварыя´нтная
форма каноническая	фо´рма каноні´чная
форма квадратичная	фо´рма квадраты´чная
форма косая	фо´рма каса´я
форма неопределенная	фо´рма неазна´чаная
форма определенная	фо´рма азна´чаная
форма основная	фо´рма асно´ўная
форма пентаэдральная	фо´рма пэнтаэдра´льная
форма полуопределенная	фо´рма паўазна´чаная
форма приведенная	фо´рма прыве´дзеная
форма примитивная	фо´рма прыміты´ўная
форма присоединения	фо´рма далучэ´ньня
форма промежуточная	фо´рма праме´жная
форма простая	фо´рма про´стая
форма родственная	фо´рма ро´дная
форма сопряженная	фо´рма спрэ´жаная
форма средняя	фо´рма сярэ´дняя
форма типичная	фо´рма тыпо´вая
форма тройничная	фо´рма патро´йная
форма четверичная	фо´рма пачацьвё´рная
форма числовая	фо´рма лі´кавая
форма эквивалентная	фо´рма эквівале´нтная
формальный	форма´льны
формула	фо´рмула
формула алгебраическая	фо´рмула альгебры´чная
формула интерполяционная	фо´рмула інтэрполяцы´йная
формула реккурентная	фо´рмула рэкурэ´нтная
функциональный	функцыяна´льны
функция	фу´нкцыя
функция абелева	фу´нкцыя а´бэлева
функция автоморфная	фу´нкцыя аўтамо´рфная
функция алгебраическая	фу´нкцыя альгебры´чная
функция аналитическая	фу´нкцыя аналіты´чная
функция биометрическая	фу´нкцыя біямэтры´чная
функция векториальная	фу´нкцыя вэктарыя´льная
функция гармоническая	фу´нкцыя гармоні´чная
функция гиперболическая	фу´нкцыя гіпэрболі´чная
функция гипергеометрическая	фу´нкцыя гіпэргеомэтры´чная
функция гиперэллиптическая	фу´нкцыя гіпэрэліпты´чная
функция голоморфная	фу´нкцыя голёмо´рфная
функция гониометрическая	фу´нкцыя гоніёмэтры´чная
функция двугранника	фу´нкцыя двухгра´ньніка
функция двупериодическая	фу´нкцыя двухпэрыяды´чная
функция действительная	фу´нкцыя рэчаі´стая
функция дробная	фу´нкцыя дро´бавая
функция дуговая	фу´нкцыя дугава´я
функция знакопеременная	фу´нкцыя знаказьме´нная
функция интегральная	фу´нкцыя інтэгра´льная
функция интермедиарная	фу´нкцыя інтэрмэдыя´рная
функция интерполяционная	фу´нкцыя інтэрполяцы´йная
функция иррациональная	фу´нкцыя ірацыяна´льная
функция искомая	фу´нкцыя шука´ная
функция коническая	фу´нкцыя коні´чная
функция лемнискатная	фу´нкцыя лемніска´тная
функция логарифмическая	фу´нкцыя лёгарытмі´чная
функция мероморфная	фу´нкцыя мэрамо´рфная
функция метациклическая	фу´нкцыя мэтацыклі´чная
функция мнимая	фу´нкцыя ўя´ўная
функция моногогранника	фу´нкцыя многагра´ньніка
функция модулевая	фу´нкцыя мо´дулевая
функция моногеническая	фу´нкцыя монагені´чная
функция монотонная	фу´нкцыя монато´нная
функция непрерывная	фу´нкцыя неперары´ўная
функция нечетная	фу´нкцыя няцо´тная
функция неявная	фу´нкцыя няя´ўная
функция образующая	фу´нкцыя ўтвара´льная
функция обратимая	фу´нкцыя абарача´льная
функция обратная	фу´нкцыя адваро´тная
функция одного переменного	фу´нкцыя аднэ´й зьме´ннай
функция однозначная	фу´нкцыя адназна´чная
функция однородная	фу´нкцыя аднаро´дная
функция определяющая	фу´нкцыя азнача´льная
функция первоначальная	фу´нкцыя першапачатко´вая
функция периодическая	фу´нкцыя пэрыяды´чная
функция показательная	фу´нкцыя паказа´льнікавая
функция полуаналитическая	фу´нкцыя паўаналіты´чная
функция правильная	фу´нкцыя праві´льная
функция прерывная	фу´нкцыя перары´ўная
функция принадлежащая	фу´нкцыя прынале´жная
функция присоединенная	фу´нкцыя далу´чаная
функция производная	фу´нкцыя вывадна´я
функция простая	фу´нкцыя про´стая
функция псевдопериодическая	фу´нкцыя псэўдапэрыя´дычная
функция рациональная	фу´нкцыя рацыяна´льная
функция родственная	фу´нкцыя ро´дная
функция симметрическая	фу´нкцыя сымэтры´чная
функция сложная	фу´нкцыя склада´ная
функция сферическая	фу´нкцыя сфэры´чная
функция тетраэдрическая	фу´нкцыя тэтраэдры´чная
функция треугольника	фу´нкцыя трыку´тніка
функция угловая	фу´нкцыя кутава´я
функция характеристическая	фу´нкцыя характарысты´чная
функция целая	фу´нкцыя цэ´лая
функция циклическая	фу´нкцыя цыклі´чная
функция циклометрическая	фу´нкцыя цыклямэтры´чная
функция цилиндрическая	фу´нкцыя цыліндры´чная
функция четная	фу´нкцыя цо´тная
функция эллиптическая	фу´нкцыя эліпты´чная
функция явная	фу´нкцыя я´ўная
фут	фут
характер	хара´ктар
характер главный	хара´ктар гало´ўны
характер квадратичный	хара´ктар квадраты´чны
характеристика	характары´стыка
характеристический	характарысты´чны
ход (кривой)	ход (крыво´й)
хорда	хо´рда
хорда главная	хо´рда гало´ўная
хорда касания	хо´рда до´тыку
хорда круга	хо´рда кру´га
целый	цэ´лы
центр	цэнтр
центр геометрический	цэнтр геомэтры´чны
центр гомологии	цэнтр гомалё´гіі
центр группы	цэнтр гру´пы
центр инволюции	цэнтр інволю´цыі
центр кривизны	цэнтр крыві´зны
центр многоугольника	цэнтр многаку´тніка
центр общий	цэнтр супо´льны
центр окружности	цэнтр акру´жыны
центр перспективы	цэнтр пэрспэкты´вы
центр подобия	цэнтр падо´бнасьці
центр подобия внешний	цэнтр падо´бнасьці знадво´рны
центр подобия внутренний	цэнтр падо´бнасьці ўнутраны´
центр проекции	цэнтр прое´кцыі
центр радикальный	цэнтр радыка´льны
центр связки	цэнтр зьвя´зкі
центр симметрии	цэнтр сымэ´тры´і
центр степенной	цэнтр ступе´нны
центр шара	цэнтр сфэ´ры, га´лы
центральный	цэнтра´льны
цепной	ланцу´жны
цикл	цыкль
циклида	цыклі´да
циклида кольцеобразная	цыклі´да колцападо´бная
циклида параболическая	цыклі´да параболі´чная
циклика	цы´кліка
циклический	цыклі´чны
циклоида	цыклё´іда
циклоидальный	цыклёіда´льны
циклометрический	цыклямэтры´чны
цилиндр	цылі´ндр
цилиндр гиперболический	цылі´ндр гіпэрболі´чны
цилиндр круговой	цылі´ндр кругавы´
цилиндр наклонный	цылі´ндр нахі´лены
цилиндр параболический	цылі´ндр параболі´чны
цилиндр правильный	цылі´ндр пра´вільны
цилиндр прямой	цылі´ндр про´сты
цилиндр равносторонний	цылі´ндр роўнабо´чны
цилиндр эллиптический	цылі´ндр эліпты´чны
цилиндрический	цыліндры´чны
цилиндроид	цыліндро´ід
циркуль	цы´ркуль
циркулярный	цыркуля´рны
циссоида	цысо´іда
циферный	цыфравы´
цифра	цы´фра
цифра арабская	цы´фра ара´бская
цифра десятичная	цы´фра дзесятко´вая
цифра значащая	цы´фра ва´ртасная
цифра римская	цы´фра ры´мская
цифра славянская	цы´фра славя´нская
частичный	часьці´нны
частное	дзель
частное приближенное	дзель наблі´жаная
частное разностное	дзель ро´зьнічная
частный	ча´сны
частота	частата´
частота относительная	частата´ адно´сная
частость	ча´стасьць
часть	часьць
часть действительная	часьць рэчаі´стая
часть десятая	часьць дзеся´тая
часть мнимая	часьць уя´ўная
часть множества	часьць мно´ства
часть формулы левая	часьць фо´рмулы ле´вая
часть формулы правая	часьць фо´рмулы пра´вая
четверичный	пачацьвё´рны
четверка	чацьвё´рка
четверка азигетическая	чацьвё´рка азыгеты´чная
четверка двойная	чацьвё´рка падво´йная
четверка сизигетическая	чацьвё´рка сызыгеты´чная
четверка точек	чацьвё´рка пу´нктаў
четверть	чвэрць
черта	ры´са
чертеж	рысу´нак
чертеж перекрестный	рысу´нак скрыжава´ны
чертить	рысава´ць
черчение	рысава´ньне
черчение топографическое	рысава´ньне топаграфі´чнае
четный	цо´тны
четыревершинный	чатырохвяршы´нны
четырегранник	чатырохгра´ньнік
четырегранник основной	чатырохгра´ньнік асно´ўны
четырегранник полярный	чатырохгра´ньнік поля´рны
четырегранник правильный	чатырохгра´ньнік пра´вільны
четырегранный	чатырохгра´нны
четыресторонник	чатырохбо´чнік
четыресторонник криволинейный	чатырохбо´чнік крываліне´йны
четыресторонник полный	чатырохбо´чнік по´ўны
четыресторонник простой	чатырохбо´чнік про´сты
четыресторонник пучка	чатырохбо´чнік пучка´
четыреугольник	чатырохку´тнік
четыреугольник вписанный	чатырохку´тнік упі´саны
четыреугольник криволинейный	чатырохку´тнік крываліне´йны
четыреугольник описанный	чатырохку´тнік апі´саны
четыреугольник полный	чатырохку´тнік по´ўны
четыреугольник простой	чатырохку´тнік про´сты
четыреугольный	чатырохку´тны
четырехчлен	чатырохчле´н
численный	лі´кавы
числитель	лі´чнік
числитель частичный	лі´чнік часьці´нны
число	лік
число абсолютное	лік абсолю´тны
число абстрактное	лік абстра´ктны
число алгебраическое	лік альгебры´чны
число ассоциированное	лік асоцыява´ны
число взаимно простое	лік узае´мна про´сты
число вещественное	лік рэчаі´сты
число главное	лік гало´ўны
число действительное	лік рэчаі´сты
число десятичное	лік дзесятко´вы
число дружественное	лік асоцыява´ны
число золотое	лік залаты´
число идеальное	лік ідэа´льны
число известное	лік вядо´мы
число именованное	лік найме´нны
число иррациональное	лік ірацыяна´льны
число кардинальное	лік кардына´льны
число комплексное	лік компле´ксны
число конечное	лік кане´чны
число логарифмированное	лік лёгарытмава´ны
число людольфово	лік людо´льфаў
число мнимое	лік уя´ўны
число многоименное	лік многайме´нны
число настоящее	лік сапра´ўдны
число натуральное	лік натура´льны
число неизвестное	лік невядо´мы
число неполное	лік няпо´ўны
число несравнимое	лік непараўна´льны
число нечетное	лік няцо´тны
число обратное	лік адваро´тны
число общее	лік агу´льны
число одноименное	лік аднайме´нны
число основное	лік асно´ўны
число отвлеченное	лік бязыме´нны
число относительное	лік адно´сны
число отрицательное	лік адмо´ўны
число радическое	лік рады´чны
число периодическое	лік пэрыяды´чны
число пирамидальное	лік піраміда´льны
число погрешностей настоящее	лік хі´бнасьцяў сапра´ўдны
число подкоренное	лік падкарэ´нны
число полигональное	лік полігона´льны
число положительное	лік дада´тны
число получетное	лік паўцо´тны
число порядковое	лік пара´дкавы
число постоянное	лік ста´лы
число приближенное	лік наблі´жаны
число примарное	лік прыма´рны
число промежуточное	лік праме´жны
число пропорциональное	лік пропорцыяна´льны
число простое	лік про´сты
число противоположное	лік проціле´жны
число римское	лік ры´мскі
число смешанное	лік мяша´ны
число совершенное	лік зако´нчаны
число сопряженное	лік спрэ´жаны
число составное	лік сустаўны´
число сравнимое	лік параўна´льны
число трансфинитное	лік трансфіні´тны
число трансцендентное	лік трансцэндэ´нтны
число треугольное	лік трыку´тны
число фигурное	лік фігу´рны
число характеристическое	лік характарысты´чны
число целое	лік цэ´лы
число частное	лік ча´сны
число четное	лік цо´тны
число чисто периодическое	лік чы´ста пэрыяды´чны
числовой	лі´кавы
чисто периодический	чы´ста пэрыяды´чны
чистый	чы´сты
член	член
член арифметической прогрессии	член арытмэты´чнай прогрэ´сіі
член арифметической пропорции	член арытмэты´чнай пропо´рцыі
член геометрической прогрессии	член геомэтры´чнай прогрэ´сіі
член геометрической пропорции	член геомэтры´чнай пропо´рцыі
член дроби	член дро´бу
член крайний	член кра´йні
член многочлена главный	член многачле´на гало´ўны
член многочлена мадший	член многачле´на мало´дшы
член многочлена старший	член многачле´на старэ´йшы
член отношения	член стасу´нку
член отношения второй	член стасу´нку другі´
член отношения первый	член стасу´нку пе´ршы
член отношения предыдущий	член cтасу´нку папярэ´дні
член отношения последующий	член стасу´нку насту´пны
член первый	член пе´ршы
член подобный	член падо´бны
член последовательности	член пасьлядо´ўнасьці
член пропорции крайний	член пропо´рцыі кра´йні
член пропорции средний	член пропо´рцыі сярэ´дні
член свободный	член во´льны
член средний	член сярэ´дні
шар	сфэ´ра, га´ла
шар вписанный	сфэ´ра ўпі´саная
шар описанный	сфэ´ра апі´саная
шар соприкасательный	сфэ´ра судаты´чная
шаровой	сфэры´чны
шарообразный	сфэрападо´бны, галападо´бны
шестерка	шасьцё´рка
шестерка двойная	шасьцё´рка падво´йная
шестигранник	шасьцігра´ньнік
шестигранник полярный	шасьцігра´ньнік поля´рны
шестигранный	шасьцігра´нны
шестисторонник	шасьцібо´чнік
шестиугольник	шасьціку´тнік
шестиугольник криволинейный	шасьціку´тнік крываліне´йны
шестиугольный	шасьціку´тны
широкий	шыро´кі
широта	шырыня´
широта угловая	шырыня´ кутава´я
шкала	ска´ля
штрих	ры´ска
эвектант	эвэкта´нт
эвольвента	эвольвэ´нта
эволюта	эволю´та
экватор	эква´тар
экваториальный	экватарыя´льны
эквиангармонический	эквіангармоні´чны
эквивалентность	эквівале´нтнасьць
эквивалентность мощностей	эквівале´нтнасьць магу´тнасьцяў
эквивалентный	эквівале´нтны
эккер	э´кер
экспоненциальный	экспонэнцыя´льны
экстрем	экстрэ´м
экстремальный	экстрэма´льны
эксцентриситет	эксцэнтрыцытэ´т
эксцентриситет абстрактный	эксцэнтрыцытэ´т абстра´ктны
эксцентриситет астрономический	эксцэнтрыцытэ´т астрономі´чны
эксцентриситет линейный	эксцэнтрыцытэ´т ліне´йны
эксцентрический	эксцэнтры´чны
эксцесс	эксцэ´с
эксцесс сферический	эксцэ´с сфэры´чны
элемент	элемэ´нт
элемент бесконечно далекий	элемэ´нт бескане´чна далё´кі
элемент гармонический	элемэ´нт гармоні´чны
элемент гомологический	элемэ´нт гомолёгі´чны
элемент группы изолированный	элемэ´нт гру´пы ізолява´ны
элемент группы обратный	элемэ´нт гру´пы адваро´тны
элемент двойной	элемэ´нт падво´йны
элемент линейный	элемэ´нт ліне´йны
элемент определителя	элемэ´нт вызна´чніка
элемент порядковый	элемэ´нт пара´дкавы
элемент функции	элемэ´нт фу´нкцыі
элемент уплотнения	элемэ´нт згушчэ´ньня
элементарный	элемэнта´рны
эллипс	э´ліпс
эллипс геодезический	э´ліпс геодэзы´чны
эллипс кубический	э´ліпс кубі´чны
эллипс софокусный	э´ліпс конфока´льны
эллипсоид	эліпсо´ід
эллипсоид вращения	эліпсо´ід вярчэ´ньня
эллипсоидальный	эліпсоіда´льны
эллиптический	эліпты´чны
эманант	эмана´нт
энвелоппа	анвэлё´па
эпитрохоида	эпітрохо´іда
эпициклоида	эпіцыклё´іда
явный	я´ўны
якобиан	якобія´н
ячейка	кле´тка
