##Title: Слоўнік хэмічнае тэрмінолёгіі (проект) (БНТ)
##HTMLDescription_BEGIN
<div>
	<p class="dictdesc-st">Створана на падставе:</p>
	<p><b>Слоўнік хэмічнае тэрмінолёгіі (проект)</b>. Менск: Інбелкульт, 1927.</p>
</div>
<div>
	<p class="spoiler">Прадмова</p>
	<p>У гэты выпуск увайшла першая частка хэмічнае тэрмінолёгіі − <i>агульная хэмія</i> (неорганічная і часьць органічнае).</p>
	<p>Апрацоўка хэмічнае тэрмінолёгіі распачата была ў 1924 г. асобнаю камісіяю, спэцыяльна выдзеленаю для гэтае работы Прыродазнаўчаю Сэкцыяю ІБК у складзе яе членаў − В. Вяршука, Ч. Родзевіча, А. Круталевіча і Я. Сушынскага, але дзейнасьць гэтае камісіі скора прыпынілася, не давёўшы работы да канца (былі апрацованы тэрміны на некалькі першых літар).</p>
	<p>Для заканчэньня гэтае работы Прэзыдыумам Прыродазнаўчае Сэкцыі была выдзелена ў 1925 г. новая камісія ў складзе яе членаў В. Вяршука і Ч. Родзевіча.</p>
	<p>Пры ўкладаньні тэрмінолёгіі камісія кіравалася наступнымі палажэньнямі:</p>
	<p>1) Даць тэрмінолёгію агульнае хэміі ў аб’ёме програм тэхнікумаў, рабфакаў, камвуза і першых двух курсаў унівэрсытэту.</p>
	<p>2) Інтэрнацыянальныя тэрміны ўводзяцца ў беларускую мову нязьменна, толькі ў беларускай транскрыпцыі.</p>
	<p>3) Тэрміны, узятыя з жывой народнай мовы даюцца ў іх народнай форме.</p>
	<p>4) Пры адсутнасьці патрэбных слоў у народнай мове і агульна-пашыраных інтэрнацыянальных − вытвараюцца нэалёгізмы згодна з законамі беларускае мовы.</p>
	<p>5) Тэрміны складаныя (назоўнік+прыметнік) зьмяшчаюцца ў альфабэце пад літараю назоўніка.</p>
	<p>6) Тэрміны, зьвязаныя з адным якім хэмічным элемэнтам, зьмяшчаюцца ў альфабэце пад назваю гэтага элемэнту, напр., тленьнік натру − пад літараю Н.</p>
	<p>Апрацованы такім спосабам проект хэмічнае тэрмінолёгіі, перад пераглядам яе ў Галоўнай Тэрмінолёгічнай Камісіі, пасылаўся для дадаткаў, уваг і паправак у Горацкае Навуковае Таварыства (пры С.-Г. Акадэміі), а потым перагледжан і зацьверджан Г.-Тэрмінолёгічнаю Камісіяй у 1927 г.</p>
	<p>Слоўнік хэмічнае тэрмінолёгіі, як і ўсе папярэднія тэрмінолёгічныя слоўнікі, выходзіць у сьвет як <i>проект</i> і мае дыскусійны характар. У далейшым ён можа зьмяняцца, калі запатрабуюць таго навуковы досьлед і школьная практыка. Дзеля гэтага кожны можа падаваць свае ўвагі, якія будуць разглядацца і прымацца да ведама. Але <i>для настаўнікаў і аўтараў падручнікаў гэтая тэрмінолёгія зьяўляецца абавязковаю, покі ня будуць зроблены зьмены прынятым у Інбелкульце парадкам</i>.</p>
	<p>Выпускаючы ў сьвет кожную тэрмінолёгію, Г.-Тэрмінолёгічная Камісія і далей зьбірае тэрмінолёгічны матар'ял − народны і літаратурны, каб у наступных выданьнях пашыраць і выпраўляць тое, што на падставе новага матар'ялу будзе вымагаць належных выправак і дадаткаў.</p>
	<p>Даць дакладную тэрмінолёгію, якая-б адпавядала ў поўнай меры навуковасьці і здавальняла-б пэдагогічную практыку − справа нялёгкая, і Камісія лічыць, што ўдасканаліць сваю работу яна зможа толькі ў тым выпадку, калі на помач ёй прыдзе актыўная праца ўсіх зацікаўленых асоб і ўстаноў. Вось чаму Камісія зварачаецца да іх з просьбаю дапамагчы ёй у цяжкай справе распрацаваньня беларускае навуковае тэрмінолёгіі.</p>
	<p>Сабраны тэрмінолёгічны матар‘ял Камісія просіць надсылаць у Інбелкульт (Менск, Рэволюцыйная, 21) на імя Галоўнае Тэрмінолёгічнае Камісіі. Корэспондэнцыя на імя Інбелкульту, паштовай аплаце не падлягае.</p>
	<p>Гэты выпуск хэмічнае тэрмінолёгіі выходзіць з яўрэйскім тэкстам, апрацованым Тэрм. Камісіяю Яўрэйскаго Сэктару ІБК.</p>
	<p> </p>
	<p><i>Галоўная Тэрмінолёгічная Камісія.</i></p>
	<p>15 чэрвеня 1927 г.</p>
</div>
<div>
	<p class="spoiler">Сьпіс літаратуры, выкарыстанае пры складаньні беларускае хэмічнае тэрмінолёгіі (ч. 1-я неорганічная хэмія)</p>
	<p>1) Менделеев − Основы химии. С.-Петербург 1906 г.</p>
	<p>2) W. Оstwаld. Grundlinien der anorganischen Chemie. Leipzig 1900</p>
	<p>3) L. Bruner i S. Tоłłоczko − Chemja nieorganiczna. Warszawa 1922 r.</p>
	<p>4) L. Bruner i S. Tołłoczko − Chemja organiczna. Warszawa 1922 r.</p>
	<p>5) О. Курило − Словник хемичноï термінологіï. Кіïв 1926 г.</p>
	<p>6) В. Ластоўскі − Слоўнік Расійска-Крыўскі (беларускі). Коўна 1924 г.</p>
	<p>7) И. Носович − Словарь бѣлорусскаго нарѣчия. С.-Петербург 1870 г.</p>
	<p>8) Prof. Dr. Walther Rоth. − Chemiker-Kalender. Berlin 1924.</p>
	<p>9) M. Байкоў i M. Гapэцкi. − Практычны расійска-беларускі слоўнік Менск 1926 г.</p>
	<p>10) K. Tіандеръ. − Нѣмецко-Русскій словарь. С.-Петербургъ 1911 г.</p>
	<p>11) М. Байкоў i С. Некрашэвіч. − Беларуска-расійскі слоўнік. Менск 1926 г.</p>
	<p>12) Тэрмінолёгіі, выданыя Інстытутам Беларускае Культуры.</p>
	<p>13) А. Голлеман − Органическая химия. Одесса 1923 г.</p>
</div>
##HTMLDescription_END
##ArticleLang: ru/be

абсолютный	абсолю´тны
абсорбциометр Бунзена	абсорбцыё´мэтр Бу´нзэна
абсорбция	абсо´рбцыя
авгит	аўгі´т
автогенная сварка	аўтаге´ннае літава´ньне
автоклав	аўтакля´ва
автомат газовый	аўтама´т га´завы
агар	ага´р
агат	ага´т
агатовая ступка	ага´тавы мажджэ´р
агрегатное состояние	агрэга´тны стан
аддитивные свойства	адыты´ўныя ўласьці´васьці
адский камень, ляпис	ля´піс
адсорбция	адсо´рбцыя
азбест (асбест)	азбэ´ст
горный лен	азбэ´ст
азбест платинированный	плятынава´ны азбэ´ст
азиды (соли азотистоводородной кислоты)	азы´ды
азобензол	aзoбэнзо´ль
азоксисоединение	азоксызлучэ´ньне
азосоединение	азозлучэ´ньне
азот	азо´т
азота двуокись	двохтле´ньнік азо´ту
азота закись	падтле´ньнік азо´ту
азота окись	тле´ньнік азо´ту
азота группа	азо´та гру´па
азотистая кислота	азо´цістая кіслата´
азотистоводородная кислота	азо´ціста-вадаро´дная кіслата´
азотистой кислоты соли	нітры´ты
азотистый ангидрид	азо´цісты ангідры´д
азотистокалиевая соль	нітры´т ка´лію
азотная кислота	азо´тная кіслата´
азотная кислота красная дымящаяся	азо´тная кіслата´ чырво´ная дыму´чая
азотноватая окись	двохтле´ньнік азо´ту
азотноватистая кислота	падазо´цістая кіслата´
азотноватистой кислоты соли	паднітры´ты
aзoтнoй кислоты соли	нітра´ты
азотнокислый аммоний	нітра´т амо´нію
азотнокислый барий	нітра´т ба´рыю
азотнокислый калий	нітра´т ка´лію
азотнокислый кальций	нітра´т ва´пеню
азотнокислая медь	нітра´т ме´дзі
азотнокислый натрий	нітра´т на´трыю
азотнокислый свинец	нітра´т во´лава
азотнокислое серебро	нітра´т срэ´бра
азотный ангидрид	азо´тны ангідры´д
Аккера способ (получение хлора из хлор. натра)	А´кераў спо´саб 
аккумулятор	акумуля´тар
актиний (радиоактивный элемент)	акты´ні
активная масса	акты´ўная ма´са
акролеин	акролеі´на
алебастр	алеба´стар
ализарин	алізары´на
алгоротов порошок	хлёратле´ньнік антымо´ну
алкалиметрия	алькалімэ´трыя
алкалоид	алькалё´ід
алкоголят	алькоголя´т
алкоголь	алького´ль
алкоголометр, спиртомер	сьпірытусаме´р
аллонж	алё´нж
аллотропия	алётро´пія
аллотропический	алётропі´чны
алмаз	дыямэ´нт, адама´нт
алхимия	альхэ´мія
альбит (натриевый полевой шпат)	альбі´т
альбумин	альбумі´на
альбуминоид	альбуміно´ід
альдегид	альдэгі´д
альдолы	альдо´лы
алюдели	алюдэ´лі
алюминаты	алюміна´ты
алюминиевая бронза	алюмі´ніевая, глінцо´вая бро´нза
алюминиевые квасцы	алюмі´ніевы, глінцо´вы галы´н
алюминий	алюмі´ні, гліне´ц
алюминий азотнокислый	нітра´т алюмі´нію
алюминий азотистокислый	нітры´т алюмі´нію
алюминий азотистый	нітры´д алюмі´нію
алюминий бромистый	бромі´д алюмі´нію
алюминий иодистый	ёды´д алюмі´нію
алюминий сернистый	сульфі´д, сярча´к алюмі´нію
алюминий сернокислый	сульфа´т алюмі´нію
алюминий углеродистый	карбі´д, вугля´к алюмі´нію
алюминий уксуснокислый	ацэта´т алюмі´нію
алюминий фосфорнокислый	фосфа´т алюмі´нію
алюминий фтористый	флюёры´д алюмі´нію
алюминий хлористый	хлёры´д алюмі´нію
алюминит (минерал)	алюміні´т
алюминия гидрат окиcи	гідра´т тле´ньніка алюмі´нію (гідратле´ньнік)
алюминия группа	гру´па алюмі´нію, глінца´
алюминия окись	тле´ньнік алюмі´нію, глінца´
алюминия силикат	сыліка´т алюмі´нію
амальгама	амальга´ма
амальгамация	амальгама´цыя
аметист	амэты´ст
амидо-азобензол	амі´да-азобэнзо´ль
амидобензол	амідабэнзо´ль
амидокислоты	амідакісло´ты
амидосульфоновая кислота	амідасульфо´навая кіслата´
амиды	амі´ды
амилен	аміле´н
амиловый алкоголь	амі´лавы алького´ль
амино-группа (амидо-группа)	гру´па амі´да
амины (первичные, вторичные, третичные)	амі´ны
аммиак	амонія´к
аммиачная вода	вада´ амонія´чная
аммиачная сода	амонія´чная со´да
аммиачные соединения	амонія´чныя злучэ´ньні
аммиачный	амонія´чны
аммониевая амальгама	амо´ніева амальга´ма
аммоний	амо´ні
аммоний азотистокислый	нітры´т амо´нію
аммоний азотнокислый	нітра´т амо´нію
аммоний бромистый	бромі´д амо´нію
аммоний двууглекислый	бікарбона´т амо´нію
аммоний двухромовокислый	біхрома´т амо´нію
аммоний иодистый	ёды´д амо´нію
аммоний иодноватокислый	ёда´т амо´нію
аммоний молибденовокислый	молібда´т амо´нію
аммонийноалюминиевые квасцы	галы´н амонія´кавы
аммоний роданистый	родані´д амо´нію
аммоний сернистый	сульфі´д, сярча´к амо´нію
аммоний сернокислый	сульфа´т амо´нію
аммоний сульфгидрат	сульфагідра´т амо´нію
аммоний углекислый	карбона´т амо´нію
аммоний фосфористокислый	фосфі´т амо´нію
аммоний фосфорноватистокислый	падфосфі´т амо´нію
аммоний фосфорнокислый	фосфа´т амо´нію
аммоний фосфорно-молибденово-кислый	фо´сфара-молібда´т амо´нію
аммоний фтористый	флюёры´д амо´нію
аммоний хлористый	хлёры´д амо´нію
аммоний хлорноватокислый	хлёра´т амо´нію
аммоний хлорнокислый	надхлёра´т амо´нію
аммоний хлороплатинат	плятынахлёры´д амо´нію
аммоний хромовокислый	хрома´т амо´нію
аммоний цианистый	цыяні´д амо´нію
аммоний циановокислый	цыяна´т амо´нію
аммоний щавелевокислый	оксаля´т амо´нію
аммония гидроокись	гідратле´ньнік амо´нію
аммония соли	амо´ніевы со´лі
аморфный	амо´рфны
ампула	а´мпула
амфотерный	амфотэ´рны
амфотерные окислы	амфотэ´рныя тле´ньнікі
анализ	ана´ліз
анализ весовой	вагавы´ ана´ліз
анализ газовый	га´зны ана´ліз
анализ калориметрический	ана´ліз калёрымэтры´чны
анализ качественный	ана´ліз я´касны
анализ количественный	ана´ліз ко´лькасны
анализ колориметрический	ана´ліз каляро´вы
анализ мокрый	ана´ліз мо´кры
анализ объемный	ана´ліз аб'ё´мны
анализ сухой	ана´ліз сухі´
анализ элементарный	ана´ліз элемэнта´рны
аналитические весы	аналіты´чныя ва´гі
ангидрид	ангідры´д
ангидрит	ангідры´т
ангидридокислоты	ангідрыдакісло´ты
анилин	анілі´на
анилиновая краска	анілі´навая фа´рба
анилиновое масло	анілі´навы але´й
анилин хлористый	анілі´на хлё´рыстая
анион	аніё´н
анод	ано´д
антимонил	антымоні´л
антимонил сернокислый	сульфа´т антымоні´лу
антихлор	антыхлё´р
антрахинон	антрахіно´н
антрацен	антрацэ´н
антрацит	антрацы´т
аппарат	апара´т, прыла´да
аппарат Киппа	апара´т Кі´паў
арабиноза	арабіно´за
арагонит	арагоні´т
аргон	арго´н
ареометр	арэо´мэтр
ароматический (производные бензола)	ароматы´чны
ароматический (непроизводные бензола)	паху´чы
асимметрия	асымэ´трыя
асимметрический	асымэтры´чны
ассимиляция (напр. азота)	асыміля´цыя
астраханит	астрахані´т
асфальт, горная смола	асфа´льт, земляна´я смала´
атмосфера	атмосфэ´ра
атом	а´том
атомно-молекулярная теория	а´томна-молекуля´рная тэо´рыя
атомный вес	а´томная вага´
атомный объем	а´томны аб'ё´м
атропин	атропі´на
аргентан	аргента´н
аргиродит	аргіроды´т
ацетилен	ацэтыле´н
ацетиленистое серебро	ацэтыле´навае срэ´бра
ацетометр	воцтаме´р
ацидиметрия	ацыдымэ´трыя
ацетон	ацэто´н
ауэровская сетка	а´ўэраўская се´тка
аэрометр	паветраме´р
аураты	аўра´ты
аурипигмент	аўрыпігмэ´нт
баббит	бабі´т
базальт	база´льт
бальзам	бальза´м
банка	сло´ік
баня (в химическом смысле)	ва´нна
баня водяная	ва´нна вадзяна´я
баня воздушная	ва´нна паве´траная
баня масляная	ва´нна але´йная
баня песочная	ва´нна пескава´я
барий	ба´ры
барий азотистокислый	нітры´т ба´рыю
барий азотнокислый	нітра´т ба´рыю
барий бромистый	бромі´д ба´рыю
барий бромноватокислый	брома´т ба´рыю
барий иодистый	ёды´д ба´рыю
барий иодноватокислый	ёда´т ба´рыю
барий карбид	карбі´д ба´рыю
барий марганцовистокислый	мангана´т ба´рыю
барий пирофосфорнокислый	пірафосфа´т ба´рыю
барий платиносинеродистый	плятынацыяну´р ба´рыю
барий серистокислый	сульфі´т ба´рыю
барий серистый	сульфі´д, сярча´к ба´рыю
барий сернокислый	сульфа´т ба´рыю
барий сульфгидрат	сульфагідра´т ба´рыю
барий углекислый	карбона´т ба´рыю
барий уксуснокислый	ацэта´т ба´рыю
барий фосфорнокислый трехметаллический	фосфа´т ба´рыю трохмэталі´чны
барий фосфорнокислый двухметаллический	фосфа´т ба´рыю двохмэталі´чны
барий фосфорнокислый однометаллический	фосфа´т ба´рыю аднамэталі´чны
барий фтористый	флюёры´д ба´рыю
барий хлористый	хлёры´д ба´рыю
барий хлорноватокислый	хлёра´т ба´рыю
барий хлорнокислый	надхлёра´т ба´рыю
барий хромовокислый	хрома´т ба´рыю
барий цианистый	цыяні´д ба´рыю
барий щавелевокислый	оксаля´т ба´рыю
барит	бары´т
баритовая вода	бары´тавая вада´
бария гидрат окиси	гідра´т тле´ньніка ба´рыю
едкий барий	гідра´т тле´ньніка ба´рыю
бария окись	тле´ньнік ба´рыю
бария перекись	надтле´ньнік ба´рыю
бария перекись водная	надтле´ньнік ба´рыю во´дны
башня Гей-Люссака	ве´жа Гей-Люса´кава
башня Гловера	ве´жа Глё´вэрава
безводный	бязво´дны
безвоздушный	беспаве´траны
бездымный поpox	бязды´мны по´рах
бесцветный	бескаляро´вы
белила баритовые	бялі´ла бары´тавае
белила постоянные	бялі´ла нязьме´ннае
белила свинцовые	бялі´ла валавя´нае
белила цинковые	бялі´ла цын´кавае
белильная известь	хлё´рак
белок	бяло´к
бемское стекло (богемское стекло)	бэ´мскае шкло
бенгальский огонь	бэнга´льскі аго´нь
бензин	бэнзы´на
бензол	бэнзо´ль
берилл	бэры´ль
бериллий	бэры´лі
бериллий азотнокислый	нітра´т бэры´лію
бериллий бромистый	бромі´д бэры´лію
бериллий иодистый	ёды´д бэры´лію
бериллий сернокислый	сульфа´т бэры´лію
бериллий хлористый	хлёры´д бэры´лію
бериллия группа	бэры´льлева гру´па
бериллия окись	тле´ньнік бэры´лію
берлинская лазурь	бэрлі´нская сі´нька
бертолетава соль	бэртале´тавая соль
бессемерование	бэсэмэрава´ньне
бетон	бэто´н
бикарбонаты	бікарбона´ты
бисульфаты	бісульфа´ты
бисульфиты	бісульфі´ты
бихроматы	біхрома´ты
благородный газ	добраро´дны газ
благородный металл	добраро´дны мэта´л
блеск висмутовый	блішча´к бі´смутавы
блеск железный	блішча´к жале´зны
блеск кобальтовый	блішча´к ко´бальтавы
блеск медный	блішча´к медзяны´
блеск молибденовый	блішча´к молібдэ´навы
блеск никелевый	блішча´к ні´келевы
блеск свинцовый	блішча´к валавя´ны
блеск серебряный	блішча´к срэ´браны
блеск сурьмяный	блішча´к антымо´навы
бликование	адсьве´чваньне
блуждающий огонь	блука´льны аго´нь
болотная руда	бало´тная руда´
болотный газ	бало´тны газ
бомба калориметрическая	бо´мба калёрымэтры´чная
бор	бор
бора окись, борный ангидрид	тле´ньнік бо´ру, бо´рны ангідры´д
бор бромистый	бромі´д бо´ру
бор иодистый	ёды´д бо´ру
бороводород	бо´рны вадаро´д
боркарбид	карбі´д бо´ру
боро-фтористоводородная кислота	флюё´ра-бо´рная кіслата´
борная кислота	бо´рная кіслата´
борная кислота мета	бо´рная кіслата´ мэ´та
борная кислота пиро	бо´рная кіслата´ пі´ро
бор сернистый	сульфі´д бо´ру
бор фтористый	флюёры´д бо´ру
бор хлористый	хлёры´д бо´ру
бражка	бра´жка
брикеты	брыке´ты
брильянт	брыля´нт
бродить	бру´зьнуць
брожение	брузава´ньне
брожение второе	брузава´ньне друго´е
брожение главное	брузава´ньне гало´ўнае
брожение лимоннокислое	брузава´ньне цытры´навае
брожение маслянокислое	брузава´ньне масьлянакі´слае
брожение молочнокислое	брузава´ньне малочнакі´слае
брожение спиртовое	брузава´ньне сьпіры´тусавае
брожение уксусное	брузава´ньне во´цатнае
бром	бром
бром иодистый	ёды´д бро´му
бромистая кислота	бро´містая кіслата´
бромистоводородная кислота	броміставадаро´дная кіслата´
бромистоводородной кислоты соль	бромі´д
бромистое серебро	бромі´д срэ´бра
бромистый водород	бро´місты вадаро´д
бромистый калий	бромі´д ка´лію
бромистый натрий	бромі´д на´трыю
бромная вода	бро´мавая вада´
бромная кислота	надбро´мавая кіслата´
бромноватая кислота	бро´мавая кіслата´
бромноватистая кислота	падбро´містая кіслата´
бронза	бро´нза
броуновское движение	бро´ўнаўскі pyx
бумага конго	папе´ра ко´нго
бумага куркумовая	папе´ра курку´мавая
бумага лакмусовая	папе´ра ля´кмусавая
бумага реактивная	папе´ра рэакты´ўная
бумага фильтровальная	папе´ра фільтрава´льная
бура	бо´ракс
бутан	бута´н
бутил	буты´ль
бюретка	бюрэ´тка
вагранка	вагра´нка
вазелин	вазалі´на
вазелиновое масло	вазалі´на ва´дкая
вакса	ва´кса
валентность	вале´нтнасьць
ванадий	вана´ды
ванадий двухлористый	хлёры´д вана´дыю
ванадий четыреххлористый	чатыроххлёры´д вана´дыю
ванадиевая кислота	вана´дыевая кіслата´
ванадиевой кислоты соль	ванада´т
ванадиевый ангидрид	вана´дыевы ангідры´д
ванадил	ванады´ль
ванадил сернокислый	сульфа´т ванады´лю
ванадил треххлористый	троххлёры´д ванады´лю
ванна пневматическая	пнэўматы´чная ва´нна
вар	смала´
варочный котел	ва´рачны кацё´л
вата	ва´та
вентиль	вэнты´ль
вентилятор	вэнтыля´тар
вес	вага´
вес абсолютный	вага´ абсолю´тная
вес атомный	вага´ а´томная
вес молекулярный	вага´ молекуля´рная
веселящий газ	весялу´шны газ
весить	ва´жыць
весовая часть	вагава´я часьць
весовой анализ	вагавы´ ана´ліз
весовое отношение	вагавы´ стасу´нак
вес удельный	адно´сная вага´
весы	ва´гі
вещество	матэ´рыя
взаимодействие	узаемадзе´яньне
взбалтывание	узбо´ўтваньне
взвесить	узва´жыць
взвешивание	узва´жваньне
взрыв	вы´бух
взрывать	узрыва´ць
взрывчатое вещество	выбухна´я матэ´рыя
видоизменение	адме´на
винная кислота	ві´нная кіслата´
виноградный сахар	ві´нны цу´кер
винокурение	брава´рства
винокуренный завод	бро´вар
винный камень	ві´нны ка´мень
винный спирт	ві´нны сьпіры´тус, этылё´вы сьпіры´тус, звыча´йны сьпіры´тус
висмут	бі´смут
висмута гидрат окиси	гідра´т тле´ньніка бі´смуту
висмут азотнокислый	нітра´т бі´смуту
висмут азотнокислый основной	нітра´т бі´смуту асно´ўны
висмута метагидрат окиси	мэтагідра´т тле´ньніка бі´смуту
висмута окись	тле´ньнік бі´смуту
висмута хлорокись	хлёратле´ньнік бі´смуту
висмутил	бісмуты´ль
висмутовая кислота мета	мэтабі´смутавая кіслата´
висмутовая кислота пиро	пірабі´смутавая кіслата´
висмутовый ангидрид	ангідры´д бі´смуту
висмут хлористый	хлёры´д бі´смуту
висмут сернистый	сульфі´д, сярча´к бі´смуту
висмут сернокислый	сульфа´т бі´смуту
витерит (минер.)	вітэры´т
вишневый клей	вішнё´вы клей
влага	ві´льгаць
влажность	вільго´тнасьць
влажный	вільго´тны
вода	вада´
вода баритовая	вада´ бары´тавая
вода бромная	вада´ бро´мавая
вода гигроскопическая	вада´ гіграскопі´чная
вода жесткая	вада´ жо´рсткая
вода известковая	вада´ вапе´нная
вода конституционная	вада´ констытуцы´йная
вода кристаллизационная	вада´ крышталізацы´йная
вода мягкая	вада´ мя´ккая
вода сероводородная	вада´ серкавадаро´дная
вода хлорная	вада´ хлё´рная
водка	гарэ´лка, во´дка
водка царская	ца´рская во´дка
водная окись	гідра´т
водный раствор	во´дны ро´шчын, раство´р
водород	вадаро´д
водорода перекись	надтле´ньнік вадаро´ду
водород двусернистый	двохсульфі´д вадаро´ду
водородное огниво	вадаро´дны запа´льнік
водоросль	во´дарасьць
водянистый	вадзяні´сты
водяной газ	вадзяны´ газ
водяной пар	вадзяна´я па´ра
возгонка	субліма´цыя
воздух	паве´тра
воздух жидкий	ва´дкае паве´тра
воздушный цемент	паве´траны цэ´мант
восстановительное пламя	рэдукцы´йнае по´лымя
восстановительный процесс	рэдукцы´йны працэ´с
восстановить	рэдукава´ць
восстановление	рэдукава´ньне
вольфрам	во´льфрам
вольфрама двуокись	двохтле´ньнік во´льфраму
вольфрамавая кислота	во´льфрамавая кіслата´
вольфрамовый ангидрид	ангідры´д во´льфраму
вольфрам пятибромистый	пяцібромі´д во´льфраму
вольфрам шестихлористый	шасьціхлёры´д вол´ьфраму
ворвань	во´рваль
воронка	ле´йка
воронка Бюхнера	ле´йка Бю´хнэрава
воронка делительная	ле´йка дзялі´льная
воск	воск
воспламенение	успалымле´ньне
воспламеняемость	запа´льнасьць
вощина	вашчы´на
впитывание	убіра´ньне
вспенивание	запе´ньваньне
вспучивание	успу´чваньне
вспышка	успы´шка
встряхивание	устраса´ньне
вторичная соль	друга´чная соль
вулканизация	вульканіза´цыя
вульфова склянка	ву´льфава шкля´нка
выбучить	вы´бучыць
выварочная соль	выва´рачная соль
выветривание	выве´трываньне
вывод	вы´вад
выгода химического процесса	кары´сьць хэмі´чнага працэ´су
выделяться	выдзяля´цца
выпаривание	выпа´рваньне
выпаривать	выпа´рваць
вытапливание	вытапля´ньне
вытеснение	выцясьне´ньне
вытравление	выяда´ньне
вытяжной шкаф	выцяжна´я ша´фа
выщелачивание	выжлу´кчваньне
вязкость жидкости	вя´зкасьць ва´дкасьці
гадолиний	гадолі´ні
газ	газ
газ водяной	газ вадзяны´
газ воздушный	газ паве´траны
газ генераторный	газ генэра´тарны
газгольдер	газго´льдар
газовый анализ	га´завы ана´ліз
газовая вода	га´завая вада´
газолин	газалі´на
газометр	газо´мэтр
газообразный	газападо´бны
газоприемник	газапрыма´льнік
газ рудничный	газ руднё´вы
газ светильный	газ сьвяці´льны
галенит	галені´т
галлий	га´лі
галлий сернокислый	сульфа´т га´лію
галлий хлористый	хлёру´р га´лію
галлий хлорный	хлёры´д га´лію
галлия окись	тле´ньнік га´лію
галмей	гальмэ´й
галоген	галёге´н
галоид	галё´ід
галоидные соединения	галё´ідныя злучэ´ньні
гальванопластика	гальванапля´стыка
гафний	га´фні
гашеная известь	ва´пна га´шаная
гашение извести	гашэ´ньне ва´пны
гексан	гэкса´н
гексаметилен	гэксамэтыле´н
гелий	гэ´лі
гемаглобин	гэмаглёбі´на
генератор	генэра´тар
гептан	гэпта´н
германий	герма´ні
германия двуокись	двохтле´ньнік герма´нію
германий двухлористый	хлёру´р герма´нію
германий четыреххлористый	хлёры´д герма´нію
гетеро-циклические соединения	гэ´тэра-цыклі´чныя злучэ´ньні
гигроскопический	гіграскопі´чны
гидразин	гідразы´на
гидразосоединения	гідразозлучэ´ньні
гидравлический цемент	гідраўлі´чны цэ´мант
гидрат окиси	гідра´т тле´ньніку
гидроксил	гідроксы´ль
гидроксиламин	гідроксы´ль-амі´на
гидроксиламин азотнокислый	нітра´т гідроксы´ль-амі´ны
гидроксиламин сернокислый	сульфа´т гідроксы´ль-амі´ны
гидроксиламин солянокислый	хлёр´ыд гідроксы´ль-амі´ны
гидролиз	гідралі´з
гидрохинон	гідрахіно´н
гипосульфит	гіпосульфі´т
гипотеза	гіпо´тэза
гипс	гіпс
гипс жженый	гіпс па´лены
гипс пережженый	гіпс перапа´лены
глазурь	палі´ва
глауберова соль	гля´ўбэравая соль
глет	глёт
гликоген	глікаге´н
гликол	гліко´ль
гликолевая кислота	гліко´левая кіслата´
глина	глі´на
глина гончарная	глі´на ганча´рная
глина желтая	глі´на жо´ўтая
глина кирпичная	глі´на цагляна´я
глина липкая	глі´на лі´пкая
глина сланцеватая	глі´на лупнякава´тая
глина сланцевая	глі´на лупняко´вая
глина фарфоровая	глі´на парцаля´навая
глина фаянсовая	глі´на фая´нсавая
глинистый	глі´ністы
глинозем	гліназе´м
глицерид	гліцэры´д
глицерин	гліцары´на
глицероза	гліцэро´за
глюкоза	глюко´за
глюкозид	глюкозы´д
гнездо стаканов	гняздо´ шкля´нак
гниение	гніцьцё´
гомологический ряд	гомалёгі´чны рад
гомология	гомалё´гія
горелка	па´льнік
горелка Бунзена	па´льнік Бу´нзэнаў
горение	гарэ´ньне
горное масло	на´фта, го´рны але´й
горный лен (азбест)	азбэ´ст
горный хрусталь	го´рны крышта´ль
горькая вода	го´ркая вада´
горькая соль	го´ркая соль
горчичное масло	гарчы´чны але´й
горючее вещество	гару´чая матэ´рыя
горючесть	гару´часьць
градирня	грады´рня
градуированный цилиндр	градуява´ны цылі´ндр
градуировать	градуява´ць
грамм	грам
грамм-атом	грам-а´том
грамм-молекула	грам-моле´кула
грамм-эквивалент	грам-эквівале´нт
гранение стекла	гране´ньне шкла
гранит	грані´т, зярня´к
гранулированное олово	гранулява´ная цы´на
графит	графі´т
гремучая смесь	выбухна´я су´месь
гремучее серебро	выбухно´е срэ´бра
гремучий газ	выбухны´ газ
группа элементов	гру´па элемэ´нтаў
гуано	гуа´на
губчатая платина	губкава´тая пляты´на
гумилак	гуміля´к
гуминовая кислота	гумі´навая кіслата´
гуммиарабик	гуміара´біка
гуммигут	гумігу´т
гумус	гу´мус
гутаперча	гутапэ´рча
давление осмотическое	ціск осмоты´чны
давление парциальное	ціск парцыя´льны
двойная соль	падво´йная соль
двойное замещение	падво´йная заме´на
двуосновная кислота	дзьвюхасно´ўная кіслата´
деготь	дзё´гаць
деготь березовый	дзё´гаць бяро´завы
деготь каменноугольный	дзё´гаць каменнаву´гальны
дезинфекция	дэзынфэ´кцыя
дезодорировать	дэзодорава´ць, зьнішча´ць пах
действующая масса	дзе´йная ма´са
декстрин	дэкстры´на
делимость материи	падзе´льнасьць матэ´рыі
денатурирование	дэнатурава´ньне
денатурированный спирт	дэнатурава´ны сьпіры´тус
депрессия	дэпрэ´сія, запа´дзіна
деревянное масло	алі´ва
держалка	дзяржа´лка, ру´чка
дефлегматор	дэфлегма´тар
дефлегмация	дэфлегма´цыя
деятельный элемент	акты´ўны элемэ´нт
диазосоединения	дыязозлучэ´ньні
диазотирование	дыязотава´ньне
диализ	дыялі´з
диастаз	дыяста´з
диафрагма	дыяфра´гма
диморфное вещество	дымо´рфная матэ´рыя
диморфный	дымо´рфны
динамит	дынамі´т
дисперсия	дыспэ´рсія
дисперсионная среда	дыспэрсі´йная асярэ´дзіна
дисперсоид	дыспэрсо´ід
диссоциация	дысоцыя´цыя
дистиллированная вода	дыстылява´ная вада´
дистилляция	пераго´нка, дыстыля´цыя
дистиллирование	пераго´нка, дыстыля´цыя
дистилляция сухая	суха´я дыстыля´цыя, суха´я пераго´нка
дитионовая кислота	дзьвюхсярча´ная кіслата´
дихлоруксусная кислота	двоххлёрво´цатная кіслата´
дифениламин	дыфэні´ль-амі´на
диффузия	дыфу´зія
дифоузоры	дыфузо´ры
дифоундировать	дыфундава´ць
дициан	двохцыя´н
доменная печь, домна	до´мна, до´менная печ
древесная смола	дрэ´ўная смала´
древесный спирт	дрэ´ўны сьпіры´тус
древесный уголь	дрэ´ўны ву´галь
древесный уксус	дрэ´ўны во´цат
дрожжи	дро´жджы
друмондов свет	дру´мондава сьвятло´
дубильная кислота	гарбава´льная кіслата´
дубильное вещество	га´рбнік
дубление	гарбава´ньне
дымящаяся серная кислота	дыму´чая сярча´ная кіслата´
дыхание	дыха´ньне
европий	эўро´пі
единица сродства	адзі´нка свая´цтва
естественная система элементов	натура´льная сыстэ´ма элемэ´нтаў
естественный	прыро´дны, натура´льны
жавелевая вода	жаве´левая вада´
жадность кислот	прагаві´тасьць кісло´т
желатин	жаляты´на
железа гидрат закиси	гідра´т падтле´ньніку жале´за
железа гидрат окиси	гідра´т тле´ньніку жале´за
железа группа	гру´па жале´за
железа закись	падтле´ньнік жале´за
железа закись-окись	тле´ньнік-падтле´ньнік жале´за
железа окись	тле´ньнік жале´за
железа соединения закиси	злучэ´ньні падтле´ньнікавага жале´за
железа соединения окиси	злучэ´ньні тле´ньнікавага жале´за
железисто-синеродисто-водородная кислота	жале´зіста-цыя´навая кіслата´
железисто-синеродистый калий	жале´зіста-цыяні´д ка´лію
железная руда	жале´зная руда´
железной кислоты ангидрид	ангідры´д жале´знае кіслаты´
железный колчедан	іскра´к жале´зны
железный купорос	жале´зны купарва´с
железный порошок	жале´зны парашо´к
железный шпат	жале´зны шпат
железняк бурый	жалязьня´к бу´ры
железняк красный	жалязьня´к чырво´ны
железняк магнитный	жалязьня´к ма´гнасавы
железняк хромистый	жалязьня´к хро´місты
железо	жале´за
железо азотнокислое закисное	нітра´т падтле´ньнікавага жале´за
железо азотнокислое окисное	нітра´т тле´ньнікавага жале´за
железобетон	жале´за-бэто´н
железо бромистое	бромю´р жале´за
железо бромное	бромі´д жале´за
железо иодистое	ёду´р жале´за
железо иодное	ёды´д жале´за
железа карбид	карбі´д жале´за
железо ковкое	жале´за ко´ўкае
железо мышьяковое закисное	арсэна´т падтле´ньнікавага жале´за
железо мышьяковое окисное	арсэна´т тле´ньнікавага жале´за
железо роданистое	родану´р жале´за
железо родановое	родані´д жале´за
железо серистое	сульфу´р, сярча´к жале´за
железо серное	сульфі´д жале´за
железо сернокислое закисное	сульфа´т падтле´ньнікавага жале´за
железо сернокислое окисное	сульфа´т тле´ньнікавага жале´за
железо сернокисло-аммонийное (соль Мора)	амонасульфа´т жале´за (соль Мо´рава)
железосинеродистая кислота	жалезацыя´навая кіслата´
железосинеродистый калий	жалезацыяні´д ка´лію
железо углекислое закисное	карбона´т падтле´ньнікавага жале´за
железо углекислое окисное	карбона´т тле´ньнікавага жале´за
железо фосфорнокислое закисное	фосфа´т падтле´ньнікавага жале´за
железо фосфорнокислое окисное	фосфа´т тле´ньнікавага жале´за
железо фтористое	флюёру´р жале´за
железо фторное	флюёры´д жале´за
железо хлористое	хлёру´р жале´за
железо хлорное	хлёры´д жале´за
железо хлорнокислое закисное	надхлёра´т падтле´ньнікавага жале´за
желтая кровяная соль	жо´ўтая крывяна´я соль
желтый сернистый аммоний	жоўты´ сульфі´д амо´нію
желть хромовая	хрома´т во´лава, жо´ўты хром
жемчужный	парло´вы
жесткость воды	жо´рсткасьць вады´
жесть	бля´ха
жженая известь	па´леная ва´пна
животные остатки	жывё´лінныя рэ´шткі
жидкий	ва´дкі
жидкость	ва´дкасьць
жир	тлушч
жирного ряда соединения	злучэ´ньні тлу´стага ра´ду
жирная кислота	тлу´стая кіслата´
жирный	тлу´сты
завод плавильный	гісэ´рня
зажим (Мора и др.)	сьціска´ч
закал	гарт
закаленная сталь	загарто´ваная сталь
закаливать	загарто´ўваць, гартава´ць
закись	падтле´ньнік
закон активных (действующих) масс	зако´н дзе´йных ма´саў
закон кратных отношений	зако´н кра´тных адно´сін
закон объемных отношений	зако´н аб'ё´мных адно´сін
закон периодичности	зако´н пэрыёды´чнасьці
закон постоянных весовых отношений	зако´н ста´лых вагавы´х адно´сін
закон распределения	зако´н разьмеркава´ньня
закон скорости диффузии газов	зако´н ско´расьці дыфу´зіі га´заў
закон сохранения материи	зако´н захава´ньня матэ´рыі
закон сохранения энергии	зако´н захава´ньня энэ´ргіі
залежь	пакла´д
замещение	заме´на
заплесневение	забрасьне´ньне
зародыш кристалла	заро´дак крышталя´
застывать	застыва´ць
затор	зато´р
зеленое мыло	зялё´нае мы´ла
зелень Гюинетова	зе´лень Гюінэ´тава
зелень медная	зе´лень медзяна´я
зелень парижская	зе´лень пары´ская
зелень Шеле	зе´лень Шэ´ле
земельные металлы	земляны´я мэта´лы
земли	глінякі´
зернистый	зернава´ты
змеевик	зьмеяві´к
знак химический	хэмі´чны знак
значность (валентность)	вале´нтнасьць
зола	по´пел
зола костная	по´пел касьцяны´
золота гидрат закиси	гідра´т падтле´ньніку зо´лата
золота гидрат окиси (золотая кислота)	гідра´т тле´ньніку зо´лата
золота закись	падтле´ньнік зо´лата
золота окись	тле´ньнік зо´лата
золотая кислота	залата´я кіслата´
золото	зо´лата
золото бромистое	бромю´р зо´лата
золото гремучее	выбухно´е зо´лата
золото иодистое	ёду´р зо´лата
золотой кислоты соли	аўра´ты
золото муссивное, или сусальное	шту´чнае зо´лата
золотоносные россыпи	золатаро´дныя пяскі´
золото серистое	сульфі´д, сярча´к зо´лата
золото трехцианистое	трохцыяні´д зо´лата
золото хлористое	хлёру´р зо´лата
золото хлорное	хлёры´д зо´лата
золото цианистое	цыяну´р зо´лата
золочение	пазало´та
известковая вода	вапе´нная вада´
известковая печь	вапе´льня, вапе´нная печ
известковое молоко	вапе´ннае малако´
известковое мыло	вапе´ннае мы´ла
известковый раствор (технич. смесь)	ва´пна-муля´рка
известковый шпат	шпат вапняко´вы, карбона´т ва´пеню
известняк	вапня´к
известь	ва´пна
известь белильная или хлорная	хлё´рка, хлё´ркавая ва´пна
известь венская	ва´пна ве´нская
известь гашеная	ва´пна га´шаная
известь едкая	гідра´т тле´ньніка ва´пеню
известь негашеная или жженая	ва´пна па´леная, няга´шаная
изменение химическое	хэмі´чная зьме´на
измерительная посуда	выме´рная пасу´дзіна
излом	злом
изомерия	ізамэ´рыя
изоморфизм	ізаморфі´зм
изотоп	ізато´п
изотропность	ізатро´пнасьць
изотропное вещество	ізатро´пная матэ´рыя
исследование химическое	хэмі´чнае дасьле´дваньне
изумруд	смара´гд
инверсия	інвэ´рсія
инвертированный сахар	інвэртава´ны цу´кер
индиго	і´ндыга
индий	і´нды
индий хлористый	хлёры´д і´ндыю
индикатор	індыка´тар
индифферентный окисел	індыфэрэ´нтны тле´ньнік
иод	ёд
иодистая кислота	ё´дзістая кіслата´
иодистый азот	ёды´д азо´ту
иодная кислота	над'ё´дная кіслата´
иодная настойка	ё´дная насто´йка
иодноватая кислота	ё´дная кіслата´
иодноватистая кислота	пад'ё´дзістая кіслата´
иодноватистой кислоты соли	пад'ёды´ты
иодноватой кислоты соли	ёда´ты
иодноватый ангидрид	ё´дны ангідры´д
иодной кислоты соли	над'ёда´ты
иодоводород (иодистоводородная кислота)	ёдавадаро´д, ёдавадаро´дная кіслата´
иодоводородной кислоты соли	ёды´ды
иод треххлористый	троххлёры´д ё´ду
иод хлористый	хлёру´р ё´ду
ион	іё´н
ионизировать	іёнізава´ць
иридий	іры´ды
иридий треххлористый	троххлёры´д іры´дыю
иридий четыреххлористый	чатыроххлёры´д іры´дыю
иридия окись	тле´ньнік іры´дыю
искусственное удобрение	шту´чнае ўгнае´ньне
исландский шпат	ісьля´ндзкі шпат
испарение	парава´ньне
испытание	выпрабава´ньне
исходный материал	выто´чны матар'я´л
итербий	ітэ´рбі
итрий	і´тры
кадмий	ка´дмі
кадмий азотнокислый	нітра´т ка´дмію
кадмий бромистый	бромі´д ка´дмію
кадмия гидрат окиси	гідра´т тле´ньніка ка´дмію
кадмий иодистый	ёды´д ка´дмію
кадмий иодноватокислый	ёда´т ка´дмію
кадмий сернистый	сульфі´д, сярча´к ка´дмію
кадмий сернокислый	сульфа´т ка´дмію
кадмий углекислый	карбона´т ка´дмію
кадмий фтористый	флюёры´д ка´дмію
кадмий хлористый	хлёры´д ка´дмію
кадмий хлорноватокислый	хлёра´т ка´дмію
кадмия окись	тле´ньнік ка´дмію
каление	напа´льваньне
калиевая селитра	ка´ліевая сале´тра, нітра´т ка´лію
калиевая слюда	ка´ліевы лушча´к
калий	ка´лі
калий азотистокислый	нітры´т ка´лію
калий азотнокислый	нітра´т ка´лію
калий антимонил виннокислый	ка´лі антымоні´л віннакі´слы
калий бромистый	бромі´д ка´лію
калий бромноватокислый	брома´т ка´лію
калий борнокислый мета	мэтабора´т ка´лію
калий борнокислый тетра	чатырохбора´т ка´лію
калий виннокислый	ка´лі віннакі´слы
калий двууглекислый	бікарбона´т ка´лію
калий двухромовокислый	біхрома´т ка´лію
калий едкий, калиевая щелочь	гідра´т тле´ньніка ка´лію, ка´лі пяку´чы, ка´ліевы луг
калий железисто-синеродистый	жале´зіста-цыяна´т ка´лію
калий железосинеродистый	жале´за-цыяна´т ка´лію
калий индигосернокислый	ка´лі і´ндыга-сярчанакі´слы
калий иодистый	ёды´д ка´лію
калий иодновато-кислый	ёда´т ка´лію
калий кислый виннокислый	ка´лі кі´слы віннакі´слы
калий кислый сернистокислый	бісульфі´т ка´лію
калий кислый сернокислый	бісульфа´т ка´лію
калий кобальтисто-азотистый	коба´льціста-нітры´т ка´лію
калий кремнекислый	сыліка´т ка´лію
калий кремнефтористоводородный	сы´ліка-флюёры´д ка´лію
калий марганцовистокислый	мангана´т ка´лію
калий марганцовокислый	надмангана´т ка´лію
калий мышьяковистокислый	арсэні´т ка´лію
калий мышьяковистокислый двуметаллический	арсэні´т ка´лію двухмэталё´вы
калий мышьяковистокислый однометаллический	арсэні´т ка´лію аднамэталё´вы
калий мышьяковокислый	арсэна´т ка´лію
калий мышьяковокислый двуметаллический	арсэна´т ка´лію двухмэталё´вы
калий мышьяковокислый однометаллический	арсэна´т ка´лію аднамэталё´вы
калий пиросернокислый	пірасульфа´т ка´лію
калий пиросурьмянокислый	піраантымона´т ка´лію
калий платиносинеродистый	плятынацыяну´р ка´лію
калий пятисернистый	пяцісульфі´д ка´лію
калий роданистый	родані´д ка´лію
калий серистокислый	сульфі´т ка´лію
калий сернистый	сульфі´д ка´лію, сярча´к ка´лію
калий серноватистокислый	падсульфі´т ка´лію
калий сернокислый	сульфа´т ка´лію
калий сурьмянокислый мета	мэтаантымона´т ка´лію
калий углекислый	карбона´т ка´лію
калий уксуснокислый	ацэта´т ка´лію
калий фосфорноватистокислый	падфосфі´т ка´лію
калий фосфорнокислый	фосфа´т ка´лію
калий фосфорнокислый двуметаллический	фосфа´т ка´лію двухмэталё´вы
калий фосфорнокислый мета	мэтафосфат´ ка´лію
калий фосфорнокислый однометаллический	фосфа´т ка´лію аднамэталё´вы
калий фосфорнокислый пиро	пірафосфа´т ка´лію
калий хлористоплатинат	плятынахлёру´р ка´лію
калий хлористый	хлёры´д ка´лію
калий хлорноватистокислый	падхлёры´т ка´лію
калий хлорноватокислый	хлёра´т ка´лію
калий хлорнокислый	надхлёра´т ка´лію
калий хлороплатинат	плятынахлёры´д ка´лію
калий хромовокислый	хрома´т ка´лію
калий цианистый	цыяні´д ка´лію
калий циановокислый	цыяна´т ка´лію
калий щавелевокислый	оксаля´т ка´лію
калильная лампа	палі´льная ля´мпа
калия алюминат	алюміна´т ка´лію
калия перекись	надтле´ньнік ка´лію
каломель	ка´лёмэль
калориметр	цепламе´р, калёры´мэтр
калория	калё´рыя
кальций	ва´пень
кальций азотистокислый	нітры´т ва´пеню
кальций азотнокислый	нітра´т ва´пеню
кальций бромистый	бромі´д ва´пеню
кальций бромноватокислый	брома´т ва´пеню
кальций иодистый	ёды´д ва´пеню
кальций иодноватокислый	ёда´т ва´пеню
кальций мышьяковокислый	арсэна´т ва´пеню
кальций пирофосфорнокислый	пірафосфа´т ва´пеню
кальций серистокислый	сульфі´т ва´пеню
кальций серистый	сульфі´д, сярча´к ва´пеню
кальций сернокислый	сульфа´т ва´пеню
кальций сульфгидрат	сульфагідра´т ва´пеню
кальций углекислый	карбона´т ва´пеню
кальций фосфорнокислый	фосфа´т ва´пеню
кальций фосфорнокислый однометаллический	фосфа´т ва´пеню аднамэталё´вы
кальций фосфорнокислый мета	мэтафосфа´т ва´пеню
кальций фтористый	флюёры´д ва´пеню
кальций хлористый	хлёры´д ва´пеню
кальций хлорнокислый	надхлёра´т ва´пеню
кальций хлорноватокислый	хлёра´т ва´пеню
кальций хромовокислый	хрома´т ва´пеню
кальций цианистый	цыяна´т ва´пеню
кальций щавелевокислый	оксаля´т ва´пеню
кальция гидрат окиси	гідра´т тле´ньніка ва´пеню
кальция карбид	карбі´д, вугля´к ва´пеню
кальция окись	тле´ньнік ва´пеню
камедь	смо´лка
каменная соль	каме´нная соль
каменноугольная смола	каменнаву´гальная смала´
каменный уголь	каме´нны ву´галь
камень винный	ка´мень ві´нны
камерный способ	камо´рны спо´саб
камфора	камфо´ра
камфорный спирт	камфо´равы сьпі´рытус
канифоль	каніфо´ля
каолин	каолі´на, парцаля´навая глі´на
карамель	карамэ´ль
карбид	карбі´д, вугля´к
карбинол	карбіно´л
карбоксил	карбоксы´л
карболовая кислота	карбо´лавая кіслата´
карбонаты	карбона´ты
карбонил	карбоні´л
карбонил хлористый	хлёры´д карбоні´лу
карборунд	карбору´нд
кармин	ка´рміна
карналит	карналі´т
карбюрировать	карбурава´ць
карбюратор	карбура´тар
катализ	каталі´з
катализатор	каталіза´тар
каталитическое действие	каталіты´чная дзе´йнасьць
катион	катыё´н
катод	като´д
качественный анализ	я´касны ана´ліз
каучук	каўчу´к
кварц	кварц
квасцы	галы´н
квасцы аммиачные	галы´н амонія´кавы
квасцы железноаммиачные	жале´зна-амонія´кавы галы´н
квасцы калиево-алюминиевые	ка´ліева-алюмі´ніевы галы´н
квасцы калиево-железные	ка´ліева-жале´зны галы´н
квасцы калиево-марганцовые	ка´ліева-манга´навы галы´н
квасцы калиево-хромовые	ка´ліева-хро´мавы галы´н
квасцы калиевые	галы´н ка´ліевы
керосин	га´за, карасі´на
кетон	кето´н
кизельгур	кізэльгу´р
кизерит	кізэры´т
киноварь	цыно´бра
кипение	кіпе´ньне
кислая соль	кі´слая соль
кислород	тлен
кислородная группа	гру´па тле´ну
кислота	кіслата´
кислота азотистая	кіслата´ азо´цістая
кислота азотная	кіслата´ азо´тная
кислота азотноватистая	кіслата´ падазо´цістая
кислота борная	кіслата´ бо´рная
кислота бромистоводородная	кіслата´ бро´міста-вадаро´дная
кислота бромноватая	кіслата´ бро´мная
кислота ванадиевая	кіслата´ вана´дыевая
кислота винная	кіслата´ ві´нная
кислота галловая	кіслата´ га´льлевая
кислота гидросернистая	кіслата´ гідрасярні´стая
кислота двуосновная	кіслата´ дзьвюхасно´ўная
кислота дитионовая	кіслата´ дзьвюхсярча´ная
кислота дихлороуксусная	кіслата´ двуххлёраво´цатная
кислота иодистоводородная	кіслата´ ё´дзіста-вадаро´дная
кислота иодноватая	кіслата´ ё´дная
кислота карболовая	кіслата´ карбо´лавая
кислота кремневая	кіслата´ сылі´цыевая
кислота кремнефтористоводородная	кіслата´ сылі´цыё-флюё´рыста-вадаро´дная
кислота лимонная	кіслата´ цытры´навая
кислота масляная	кіслата´ ма´сьляная
кислота метафосфорная	кіслата´ мэтафо´сфарная
кислота многоосновная	кіслата´ многаасно´ўная
кислота молочная	кіслата´ мало´чная
кислота монохлоруксусная	кіслата´ адно´хлёрво´цатная
кислота мочевая	кіслата´ мачава´я
кислота муравьиная	кіслата´ мураўі´ная
кислота надсерная	кіслата´ надсярча´ная
кислота нитрозилсерная	кіслата´ нітразы´ль-сярча´ная
кислота одноосновная	кіслата´ аднаасно´ўная
кислота олеиновая	кіслата´ але´йная
кислота осмиевая	кіслата´ о´сьміевая
кислота пентатионовая	кіслата´ пяцісярча´ная
кислота пикриновая	кіслата´ пікры´навая
кислота пиросерная	кіслата´ пірасярча´ная
кислота розоловая	кіслата´ розо´левая
кислота салициловая	кіслата´ саліцы´лавая
кислота свободная	кіслата´ во´льная
кислота селенистая	кіслата´ сэле´ністая
кислота селеновая	кіслата´ сэле´навая
кислота серная	кіслата´ сярча´ная
кислота сернистая	кіслата´ сярні´стая
кислота серноватистая	кіслата´ падсярні´стая
кислота соляная	кіслата´ саляна´я
кислота сульфаниловая	кіслата´ сульфані´лавая
кислота телуристая	кіслата´ тэлю´рыстая
кислота телуровая	кіслата´ тэлю´равая
кислота тетратионовая	кіслата´ чатырохсярча´ная
кислота тиоугольная	кіслата´ серкаву´гальная
кислота триосновная	кіслата´ трохасно´ўная
кислота трихлоруксусная	кіслата´ троххлёрво´цатная
кислота тритионовая	кіслата´ трохсярча´ная
кислота угольная	кіслата´ ву´гальная
кислота уксусная	кіслата´ во´цатная
кислота фосфористая	кіслата´ фо´сфарыстая
кислота фосфорная	кіслата´ фо´сфарная
кислота фосфорноватистая	кіслата´ падфосфо´рыстая
кислота фосфорно-вольфрамовая	кіслата´ фо´сфарна-вольфра´мавая
кислота фосфорно-молибденовая	кіслата´ фо´сфарна-молібдэ´навая
кислота фтористоводородная	кіслата´ флюё´рыста-вадаро´дная
кислота хлористая	кіслата´ хлё´рыстая
кислота хлористоводородная	кіслата´ хлё´рыста-вадаро´дная
кислота хлорная	кіслата´ надхлё´рная
кислота хлорноватая	кіслата´ хлё´рная
кислота хлорноватистая	кіслата´ падхлё´рыстая
кислота цианистоводородная	кіслата´ цыяні´ста-вадаро´дная
кислота четырехосновная	кіслата´ чатырохасно´ўная
кислота щавелевая	кіслата´ шчаўё´вая
кислотность	кісло´тнасьць
кислотный	кісло´тны
кислый	кі´слы
клей	клей
клей вишневый	клей вішнё´вы
клейковина	клейкаві´на
клей костяной	клей касьцяны´
клей растительный	клей расьлі´нны
клейстер	кле´йстар
клетчатка	абало´ніна, цэлюлё´за
ключ, источник	крыні´ца
ключевая вода	крыні´чная вада´
кобальт	ко´бальт
кобальта гидрат закиси	гідра´т падтле´ньніку ко´бальта
кобальта гидрат окиси	гідра´т тле´ньніку ко´бальта
кобальт азотнокислый	нітра´т ко´бальту
кобальта закись	падтле´ньнік ко´бальту
кобальта окись	тле´ньнік ко´бальту
кобальт бромистый	бромю´р ко´бальту
кобальт мышьяковокислый	арсэна´т ко´бальту
кобальт серистый	сульфі´д ко´бальту
кобальт сернокислый	сульфа´т ко´бальту
кобальт углекислый	карбона´т ко´бальту
кобальт уксуснокислый	ацэта´т ко´бальту
кобальт фосфорнокислый	фосфа´т ко´бальту
кобальт хлористый	хлёру´р ко´бальту
кобальт хлорный	хлёры´д коб´альту
кобальт цианистый	цыяну´р ко´бальту
кокс	кокс
коксование	коксава´ньне
колба	ко´ўба
количественный анализ	ко´лькасны ана´ліз
коллодий	колё´ды
коллоидальное золото	колё´іднае зо´лата
коллоидальное серебро	колё´іднае срэ´бра
коллоиды	колё´іды
колориметр	коляры´мэтр
колчедан	іскра´к
комовая сера	грудкава´тая се´рка
компонент	компонэ´нт
конвертор	конвэ´ртар, гру´ша Бэсэмэ´рава
конденсацыя	кондэнса´цыя
конопляное масло	канапля´ны але´й
конституциональные свойства	констытуцыяна´льныя ўласьці´васьці
конституционная вода	констытуцы´йная вада´
контактный способ	конта´ктны спо´саб
концентрированная кислота	концэнтрава´ная кіслата´
концентрирование	концэнтрава´ньне
корунд	кору´нд
корица	цынамо´н
коричное масло	цынамо´навы але´й
костяной уголь	касьцяны´ ву´галь
кофеин	кофэі´на
коэффициент растворения	коэфіцые´нт рашчы´ннасьці
коэффициент расширения	коэфіцые´нт пашырэ´ньня
краска	фа´рба
красная медная руда	чырво´ная медзяна´я руда´
краснобурые пары	чырвонабу´рая па´ра
красящее вещество	фа´рбнік
крахмал	крухма´л
крахмал картофельный	крухма´л картапля´ны
крахмал пшеничный	крухма´л пшані´чны
крахмал рисовый	крухма´л ры´жавы
кремневая кислота	сылі´цыевая кіслата´
кремневой кислоты соли	сыліка´ты
силикаты	сыліка´ты
кремневый ангидрид	сылі´цыевы ангідры´д
кремневый водород, моносидан	сылі´цыевы вадаро´д
кремне-фтористоводородная кислота	сылі´цыё-флюё´рыста-вадаро´дная кіслата´
кремнезем	крамнязе´м
кремний	сылі´цы
кремний углеродистый	карбі´д, вугля´к сылі´цыю
кремний фтористий	флюёры´д сылі´цыю
кремний хлористый	хлёры´д сылі´цыю
кремния окись	тле´ньнік сылі´цыю
крезол	крэзо´ль
криолит	крыёлі´т
криптон	кры´птон
кристалл	крышта´ль
кристаллизационная вода	крышталізацы´йная вада´
кристаллизация	крышталізава´ньне
кристаллический	крышталі´чны
кристаллоид	крышталё´ід
критическая температура	крыты´чная тэмпэрату´ра
кровяная соль желтая	жо´ўтая крывяна´я соль
кровяная соль красная	чырво´ная крывяна´я соль
кронглас	кро´нгляс
крон желтый	крон жо´ўты
крон оранжевый	крон ара´нжавы
ксенон	ксэно´н
ксилол	ксылё´ль
кулон	кулё´н
купелляция	купэля´цыя
купорос железный	вітрыё´ль (купарва´с) жале´зны
купорос медный	вітрыё´ль (купарва´с) медзяны´
купоросное масло	купарва´сная алі´ва
купорос цинковый	вітрыё´ль (купарва´с) цы´нкавы
куркума	курку´ма
лаборатория	ляборато´рыя
лазурь берлинская	бэрлі´нскі лазу´рак
лазурь медная	медзяны´ лазу´рак
лакмус	ля´кмус
лакмусовая бумага	ля´кмусавая папе´ра
лакмусовая тинктура	ля´кмусавая тынкту´ра
лактоза	лякто´за
лампа Деви	ля´мпа Дэ´ві
лантан	лянта´н
лантан сернокислый	сульфа´т лянта´ну
латунь	мо´сенж
левулоза	левулё´за
легкий металл	лё´гкі мэта´л
легковоспламеняемый	лёгказапа´льны
легкоплавкий	лёгкато´пкі
лед	лёд
лен горный	го´рны лён
летучее масло	ляту´чы але´й
лигнит	лігні´т
лигроин	лігроі´на
лимонная кислота	цытры´навая кіслата´
лимонной кислоты соль	цытра´т
липкий	лі´пкі
листовое олово	а´ркушавая цы´на
литий	лі´ты
литий азотнокислый	нітра´т лі´тыю
литий бромистый	бромі´д лі´тыю
литий сернокислый	сульфа´т лі´тыю
литий углекислый	карбона´т лі´тыю
литий фосфорнокислый	фосфа´т лі´тыю
литий хлористый	хлёры´д лі´тыю
лития гидрат окиси	гідра´т тле´ньніка лі´тыю
лития окись	тле´ньнік лі´тыю
литографский камень	літаграфі´чны ка´мень
лодочка фарфоровая	чаўначо´к парцаля´навы
лудить	цынава´ць
лужение	цынава´ньне
ляпис	ля´піс
магнезит	магнэзы´т
магнезия	магнэ´зія
магнезия белая (жженая)	магнэ´зія бе´лая
магниевая лента	ма´гніевая сту´жка
магниевая проволока	ма´гніевы дрот
магний	ма´гні
магний азотнокислый	нітра´т ма´гнію
магний бромистый	бромі´д ма´гнію
магний иодистый	ёды´д ма´гнію
магний кремнекислый	сыліка´т ма´гнію
магний пирофосфорнокислый	пірафосфа´т ма´гнію
магний серистый	сульфі´д ма´гнію
магний сернокислый	сульфа´т ма´гнію
магний углекислый	карбона´т ма´гнію
магний углекислый основной	карбона´т ма´гнію асно´ўны
магний фосфорнокислый двуметальный	фосфа´т ма´гнію двохмэталё´вы
магний хлористый	хлёры´д ма´гнію
магнит	ма´гнас
магнитный железняк	ма´гнасавы жалязьня´к
магния гидрат окиси	гідра´т тле´ньніка ма´гнію
магния окись	тле´ньнік ма´гнію
мазь	мазь
малахит	маляхі´т
мальтоза	мальто´за
марганец	манга´н
марганец двухлористый	хлёру´р манга´ну
марганец карбид	карбі´д, вугля´к манга´ну
марганец сернокислый закись	сульфа´т падтле´ньнікавага манга´ну
марганец сернокислый окись	сульфа´т тле´ньнікавага манга´ну
марганец углекислый	карбона´т манга´ну
марганец фосфорнокислый закись	фосфа´т падтле´ньнікавага манга´ну
марганец фосфорнокислый окись	фосфа´т тле´ньнікавага манга´ну
марганец четырехфтористый	чатырохфлюёры´д манга´ну
марганец четыреххлористый	чатыроххлёры´д манга´ну
марганца гидрат закиси	гідра´т падтле´ньніка манга´ну
марганца гидрат окиси	гідра´т тле´ньніка манга´ну
марганца закись	падтле´ньнік манга´ну
марганца закись-окись	падтле´ньнік-тле´ньнік манга´ну
марганца окись	тле´ньнік манга´ну
марганца перекись	надтле´ньнік манга´ну
марганцовистая кислота	манга´навая кіслата´
марганцовистой кислоты соль	мангані´т
марганцовистый ангидрид	манга´навы ангідры´д
марганцовая кислота	надманга´навая кіслата´
марганцовой кислоты соль	надмангана´т
марганцовый ангидрид	надманга´навы ангідры´д
марказит	марказы´т
масло животное	ма´сла
масло минеральное	алі´ва
масло растительное	але´й
маслородный газ	алеяро´дны газ
масло сивушное	сіву´шны алей
масляная краска	але´йная фа´рба
маслянистый	алівава´ты
масляный	масьляны´; але´йны
масса	ма´са
массивность	масы´ўнасьць
массикот	масыко´т
материал горючий	матар'я´л гару´чы
материя	матэ´рыя
маточный paствор	ма´тачны ро´шчын (раствор)
машинное масло	машы´нная алі´ва
меди гидрат закиси	гідра´т падтле´ньніку ме´дзі
меди гидрат окиси	гідра´т тле´ньніку ме´дзі
меди закись	падтле´ньнік ме´дзі
меди окись	тле´ньнік ме´дзі
медный блеск	медзяны´ блішча´к
медный колчедан	медзяны´ іскра´к
медный купорос	медзяны´ вітрыё´ль (купарва´с)
медь	медзь
медь азотнокислая	нітра´т ме´дзі
медь бромистая	бромю´р ме´дзі
медь бромная	бромі´д ме´дзі
медь иодистая	ёду´р ме´дзі
медь иодная	ёды´д ме´дзі
медь мышьяковистая	арсэні´т ме´дзі
медь полусернистая	сульфу´р ме´дзі
медь серистая	сульфі´д, сярча´к ме´дзі
медь серистокислая	сульфі´т ме´дзі
медь сернокислая	сульфа´т ме´дзі
медь углекислая	карбона´т ме´дзі
медь углекислая основная	карбона´т ме´дзі асно´ўны
медь уксуснокислая	ацэта´т ме´дзі
медь фтористая	флюёру´р ме´дзі
медь фторная	флюёры´д ме´дзі
медь фосфорнокислая	фосфа´т ме´дзі
медь хлористая	хлёру´р ме´дзі
медь хлорная	хлёры´д ме´дзі
медянка (зеленая краска)	мядзя´нка (зялё´ная фар´ба)
междумолекулярное пространство	міжмолекуля´рная прасто´ра
мел	крэ´йда, мел
меласса	мэля´са
мелинит	мэліні´т
мелкозернистый	дробнакрупкава´ты
мельхиор	мэльхіё´р
мензурка	мэнзу´рка
ментол	мэнто´ль
мергель	маргі´ль
меркаптан	мэркапта´н
металл	мэта´л
металл благородный	мэта´л добраро´дны
металлический	мэталі´чны
металлоид	металё´ід
металлургия	мэталю´ргія
металлы земель	мэта´лы земляны´я
металлы щелочно-земельные	мэта´лы лу´жна-земляны´я
металлы щелочные	мэта´лы лу´жныя
метан	мэта´н
метил	мэты´ль
метил-оранж	мэты´ль-ора´нж
метиловый спирт	мэтылё´вы сьпіры´тус
механическая смесь	мэхані´чная су´месь
мешалка	ме´шалка
микрон	мікро´н
миллимикрон	мілімікро´н
миндальное масло	мігдалё´вы але´й
минерал	мінэра´л
минеральная вода	мінэра´льная вада´
минеральное масло	алі´ва
минеральное удобрение	мінэра´льнае ўгнае´ньне
минеральные туки	мінэра´льныя ту´кі
минеральный хамелеон	мінэра´льны хамэлео´н
многоатомность	многаа´томнасьць
многоосновная кислота	многаасно´ўная кіслата´
многосернистые соединения	многасярча´ныя злучэ´ньні
мокрый способ	мо´кры спо´саб
молекула	моле´кула
молекулярная гипотеза	молекуля´рная гіпо´тэза
молекулярная поверхность	молекуля´рная паве´рхня
молекулярная формула	молекуля´рная фо´рмула
молекулярное преломление	молекуля´рны перало´м
молекулярное строение	молекуля´рная будо´ва
молекулярный вес	молекуля´рная вага´
молекулярный объем	молекуля´рны аб'ё´м
моль, грам-молекула	моль, грам-моле´кула
молибден	молібдэ´н
молибден двухлористый	двуххлёры´д молібдэ´ну
молибденовая двуокись	двухтле´ньнік молібдэ´ну
молибденовая кислота	молібдэ´навая кіслата´
молибденовой кислоты соль	молібда´т
молибден пятихлористый	пяціхлёры´д молібдэ´ну
молибденовый ангидрид	молібдэ´навы ангідры´д
молоко известковое	вапе´ннае малако´
молоко серное	сярча´нае малако´
молочная кислота	мало´чная кіслата´
молочный сахар	мало´чны цу´кер
моногидрат серной кислоты	монагідра´т сярча´най кіслаты´
моно-хлоруксусная кислота	монахлёрво´цатная кіслата´
Мора соль	соль Мо´рава
морская пенка	морска´я пе´нка
морфин	морфі´на
мочевая кислота	мачава´я кіслата´
мочевина	мачаві´на
мрамор	ма´рмар
мрамор белый	ма´рмар бе´лы
мрамор пестрый	ма´рмар страка´ты
мрамор раковистый	ма´рмар чарапа´шкавы
мрамор флорентинский	ма´рмар флёрэ´нскі
мука костяная	мука´ касьцяна´я
мука фосфоритная	мука´ фосфары´тавая
мука селитренная	мука´ сале´траная
мука томасовая	мука´-тамашо´ўка
муравьиная кислота	мураўі´ная кіслата´
мыло	мы´ла
мыловарение	мылаварэ´ньне
мыльный пузырь	мы´льная бу´лбатка
мышьяк	аршэ´нік
мышьяка хлорокись	хлёратле´ньнік аршэ´ніку
мышьяк белый	аршэ´нік белы
мышьяковая кислота	аршэ´нікавая кіслата´
мышьяковая кислота мета	мэтааршэ´нікавая кіслата´
мышьяковая кислота орто	ортааршэ´нікавая кіслата´
мышьяковая кислота пиро	пірааршэ´нікавая кіслата´
мышьяковистая кислота	падаршэ´нікавая кіслата´
мышьяковистой кислоты соль	арсэні´т
мышьяковистый ангидрид	падаршэ´нікавы ангідры´д
мышьяковистый водород	аршэ´нікавы вадаро´д
мышьяковой кислоты соль	арсэна´т
мышьяковое зеркало	аршэ´нікавае лю´стра
мышьяковый ангидрид	аршэ´нікавы ангідры´д
мышьяк пятисернистый	сульфі´д аршэ´ніку
мышьяк пятифтористый	флюёры´д аршэ´ніку
мышьяк пятихлористый	хлёры´д аршэ´ніку
мышьяк трехбромистый	бромю´р аршэ´ніку
мышьяк трехиодистый	ёду´р аршэ´ніку
мышьяк трехсернистый	сульфу´р аршэ´ніку
мышьяк трехфтористый	флюёру´р аршэ´ніку
мышьяк треххлористый	хлёру´р аршэ´ніку
мягкая вода	мя´ккая вада´
наблюдать	назіра´ць
навоз	гной
нагревание	награва´ньне
надсерная кислота	надсярча´ная кіслата´
надхромовая кислота	надхро´мавая кіслата´
наждак	нажда´к, шмэ´ргель
накаливать	напа´льваць
накипь	на´кіп
налет	павало´ка
насыщенный раствор	насы´чаны ро´шчын, paство´р
натриевая щелочь	на´трыевы луг
натриевое мыло	на´трыевае мы´ла
натриевое соединение	на´трыевае злучэ´ньне
натриевое стекло	на´трыевае шкло
натриевые квасцы	на´трыевы галы´н
натрий	на´тры
натрий азотистокислый	нітры´т на´трыю
натрий азотнокислый	нітра´т на´трыю
натрий аммонийно-фосфорно-кислый	амонафосфа´т на´трыю
натрий борнокислый	бора´т на´трыю
натрий бромистый	бромі´д на´трыю
натрий бромноватокислый	брома´т на´трыю
натрий вольфрамовокислый	вольфрама´т на´трыю
натрий двууглекислый	бікарбона´т на´трыю
натрий двухромовокислый	біхрома´т на´трыю
натрий железистосинеродистый	жалезіста-цыяні´д на´трыю
натрий иодистый	ёды´д на´трыю
натрий иодноватокислый	ёда´т на´трыю
натрий кислый сернистокислый	бісульфі´т на´трыю
натрий кислый сернокислый	бісульфа´т на´трыю
натрий кремнекислый	сыліка´т на´трыю
натрий кремнефтористоводородный	сыліцыёфлюёры´д на´трыю
натрий марганцовистокислый	мангана´т на´трыю
натрий мышьяковистокислый	арсэні´т на´трыю
натрий надсернокислый	надсульфа´т на´трыю
натрий нитропруссидный	нітрапрусы´д на´трыю
натрий оловянокислый	стана´т на´трыю
натрий пиросурьмянокислый	піраантымона´т на´трыю
натрий пирофосфорнокислый	пірафосфа´т на´трыю
натрий серистый	сульфі´д, сярча´к на´трыю
натрий серноватистокислый	падсульфі´т на´трыю
натрий сернокислый	сульфа´т на´трыю
натрий сульфгидрат	сульфагідра´т на´трыю
натрий сульфомышьяковокислый	сульфаарсэна´т на´трыю
натрий сульфосурьмянокислый	сульфаантымона´т на´трыю
натрий углекислый	карбона´т на´трыю
натрий уксуснокислый	ацэта´т на´трыю
натрий фосфорноватистокислый	падфосфі´т на´трыю
натрий фосфорнокислый	фосфа´т на´трыю
натрий фосфорнокислый мета	мэтафосфа´т на´трыю
натрий фтористый	флюёры´д на´трыю
натрий хлористый	хлёры´д на´трыю
натрий хлорноватистокислый	падхлёры´т на´трыю
натрий хлорнокислый	надхлёра´т на´трыю
натрий хромовокислый	хрома´т на´трыю
натрий цианистый	цыяні´д на´трыю
натрий щавелевокислый	оксаля´т на´трыю
натрия алюминат	алюміна´т на´трыю
натрия гидрат окиси	гідра´т тле´ньніка на´трыю
едкий натр	гідра´т тле´ньніка на´трыю
натрия окись	тле´ньнік на´трыю
натрия перекись	надтле´ньнік на´трыю
натрия хлороплатинат	хлёраплятына´т на´трыю
натронная известь	натро´нная ва´пна
нафталин	нафталі´на
нафтол	нафто´ль
нахождение	знахаджэ´ньне
нашатырь	нашаты´р, хлёры´д амо´нію
нашатырный спирт	нашаты´рны сьпіры´тус
неблагородные металлы	нядобраро´дныя мэта´лы
недеятельный элемент	нядзе´йны элемэ´нт
недокись	падпадтле´ньнік
нейзильбер	но´вае срэ´бра, нэйзы´льбэр
нейтрализация	нэўтраліза´цыя
нейтральный раствор	нэўтра´льны раство´р, ро´шчын
неметалы	немэта´лы
ненасыщенный раствор	ненасы´чаны ро´шчын, раство´р
неодим	нэады´м
неоднородное тело	неаднаро´днае це´ла
неон	нэ´он
неорганический	неоргані´чны
непостоянность	няста´ласьць, непастая´ннасьць
непрерывный спектр	бесьперары´ўны спэ´ктар
непрозрачность	непразры´стасьць
непроницаемость	непраніка´льнасьць
нерастворимость	нераспушча´льнасьць
неуничтожаемость материи	нязьнішча´льнасьць матэ´рыі
нефть	на´фта
нефтяной источник	на´фтавая крыні´ца
нефтяной эфир	на´фтавы э´тар
никелирование	нікелява´ньне
никель	ні´кель
никель азотнокислый	нітра´т ні´келю
никель бромистый	бромі´д ні´келю
никель иодистый	ёды´д ні´келю
никель иодноватокислый	ёда´т ні´келю
никель сернистый	сульфі´д, сярча´к ні´келю
никель сернокислый	сульфа´т ні´келю
никель хлористый	хлёры´д ні´келю
никель фосфорнокислый	фосфа´т ні´келю
никель цианистый	цыяні´д ні´келю
никеля гидрат закиси	гідра´т падтле´ньніка ні´келю
никеля гидрат окиси	гідра´т тле´ньніка ні´келю
никеля закись	падтле´ньнік ні´келю
никеля карбонил	карбоні´ль ні´келю
никеля окись	тле´ньнік ні´келю
никотин	нікоты´на
ниобий	ніо´бі
нитрат	нітра´т
нитрит	нітры´т
нитробензол	нітрабэнзо´ль
нитроглицерин	нітрагліцары´на
нитрозил-серная кислота	нітразы´ль-сярча´ная кіслата´
нитрозилхлорид	нітразы´ль-хлёры´д
нитроклетчатка	нітрацэлюлё´за
номенклатура солей	номэнкляту´ра сол´яў
норвежская селитра	нарвэ´ская сале´тра
нордгаузенская кислота, дымящаяся серная кислота	дыму´чая сярча´ная кіслата´, Нордга´ўзэнская кіслата´
нормальный раствор	норма´льны ро´шчын, paство´р
обезуглероживание	абязву´гліваньне
обесцвечивание	абескалё´рваньне
обжигание	абпа´льваньне
обманки (марганцовая, роговая, цинковая)	падабнякі´
обмен (веществ)	паме´н
обменная реакция	паме´нная рэа´кцыя
обменное разложение	паме´нны раскла´д
оболочка	абало´нка
образование солей	утварэ´ньне со´ляў
обратимая реакция	зваро´тная рэа´кцыя
обратимый круговой процесс	кругазваро´тны працэ´с
обратная реакция	адваро´тная рэа´кцыя
обугливание	абву´гліваньне
объем атомный	а´томны аб'ё´м
объем молекулярный	молекуля´рны аб'ё´м
объемный анализ	аб'ё´мны ана´ліз
объем удельный	адно´сны аб'ё´м
огниво Доберейнерово	запа´льнік Добэрэ´йнэраў
одноатомный	аднаа´томны
одноосновная кислота	аднаасно´ўная кіслата´
однородный	аднаро´дны, адная´кі
озерная руда	азё´рная руда´
озерная соль	азё´рная соль
озон	озо´н
озонатор	озона´тар
окалина	дзы´ндра
окисел, окись	тле´ньнік
окисел индифферентный	тле´ньнік бязьдзе´йны
окисел кислотный	тле´ньнік кісло´тны
окисел металла	тле´ньнік мэта´лу
окисел основной	тле´ньнік асно´ўны
окисел промежуточный	тле´ньнік праме´жны
окисление	атляня´ньне
окислитель	атляня´льнік
окислительное пламя	атляня´льнае по´лымя
окисное соединение	тле´ньнікавае злучэ´ньне
окклюзия	оклю´зія
оксиазосоединение	оксыазозлучэ´ньне
олеиновая кислота	але´йная кіслата´
олефин	олефі´на
оливин	оліві´на
олифа	пако´ст
олова гидрат закиси	гідра´т падтле´ньніку цы´ны
олова двуокись	двохтле´ньнік цы´ны
олова закись	падтле´ньнік цы´ны
олово	цы´на
олово бромистое	бромю´р цы´ны
олово бромное	бромі´д цы´ны
олово иодистое	ёду´р цы´ны
олово иодное	ёды´д цы´ны
олово сернистое	сульфі´д, сярча´к цы´ны
олово сернокислое	сульфа´т цы´ны
олово фтористое	флюёру´р цы´ны
олово фторное	флюёры´д цы´ны
олово хлористое	хлёру´р цы´ны
олово хлорное	хлёры´д цы´ны
оловянная бумага	цы´навая папе´ра
оловянная кислота	цы´навая кіслата´
оловянная кислота мета	мэтацы´навая кіслата´
оловянная фольга	цы´навая фо´льга
оловянный камень	цы´навы ка´мень
опилки железные	пілаві´ны жале´зныя
опиум	о´піюм
определение молекулярного веса	азначэ´ньне молекуля´рнай вагі´
опыт (научн.)	до´сьлед
опытные данные	здабы´ткі до´сьледу
органический	органі´чны
органическое сжигание	органі´чнае спа´льваньне
осадок	аса´дак
осаждение	асаджэ´ньне
осмиевый ангидрид	о´сьміевы ангідры´д
осмий	о´сьмі
осмий иодистый	ёду´р о´сьмію
осмий хлорный	хлёры´д о´сьмію
основание	асно´ва
основной	асно´ўны
основность кислоты	асно´ўнасьць кіслаты´
основные гидраты	асно´ўныя гідра´ты
основные соли	асно´ўныя со´лі
остатки (радикалы)	пасьле´дкі (радыка´лы)
остатки содовые	пасьле´дкі со´давыя
остудить	астудзі´ць
отвар	вы´вар
открытие (элемента)	вынахо´д
отмучивание	адкаламу´чваньне
относительный вес	адно´сная вага´
отношение	адно´сіны
отпущенная сталь	адпу´шчаная сталь
отстой	адсто´й, фуз
охладительная смесь	ахаладжа´льная су´месь
охра	во´хра
пай	пай
палладиевая чернь	паля´дыевы парашо´к
палладий	паля´ды
палладий азотнокислый	нітра´т паля´дыю
палладий бромистый	бромю´р паля´дыю
палладий губчатый	губкава´ты паля´ды
палладий иодистый	ёду´р паля´дыю
палладий сернистый	сульфі´д, сярча´к паля´дыю
палладий сернокислый	сульфа´т паля´дыю
палладий хлористый	хлёру´р паля´дыю
палладия закись	падтле´ньнік паля´дыю
палладия окись	тле´ньнік паля´дыю
пар	па´ра
парафин	парафі´на
парижская зелень	пары´ская зе´лень
пальмитиновая кислота	пальміты´навая кіслата´
паяльная лампа	літава´льная ля´мпа
паяльная трубка	літава´льная тру´бка
паять	літава´ць
пена	пе´на
пентан	пэнта´н
пентатионовая кислота	пяцісярча´ная кіслата´
пепел	по´пел
первичная соль	пярша´чная соль
первичный спирт	пярша´чны сьпіры´тус
пергамент	пэрга´мін
пергаментная бумага	пэрга´мінная папе´ра
перегонка	пераго´нка
перегонка фракционированная	пераго´нка дро´бная
перегонный куб	пераго´нны куб
перегреватель	пераграва´ч
передвижная лаборатория	рухо´мая ляборато´рыя
перекал	перага´рт
перекись	надтле´ньнік
перекись водорода	надтле´ньнік вадаро´ду
перекристаллизация	перакрышталізава´ньне
переменная валентность	пераме´нная вале´нтнасьць
переохлаждение	перастуджэ´ньне
пересыщенный раствор	перасы´чаны ро´шчын, раство´р
перетапливание	перато´пліваньне
периодический закон	пэрыёды´чны зако´н
периодическая система Менделеева	пэрыёды´чная сыстэ´ма Мендзяле´ева
перл	пэ´рла
перламутровый	пэрляму´травы
пестик	таўка´чык
песчаная баня	пяшча´ная ва´нна
песчаник	пяшча´нік
петролейный эфир	на´фтавы э´тар
печь известковая	вапе´льня, вапе´нная печ
печь плавильная	гама´рня
печь пудлинговая	пу´длінгавая печ
пигмент	фа´рбнік, пігмэ´нт
пикриновая кислота	пікры´навая кіслата´
пиперидин	піпэрыды´на
пипетка	піпэ´тка
пирит	піры´т
пирогаллол	пірагалё´ль
пирогалловая кислота	пірага´левая кіслата´
пироксилин	піраксылі´на
пиролюзит	піралюзы´т
пирометр	пірамэ´тр
плавиковая кислота	тапняко´вая кіслата´
плавиковый шпат	тапняко´вы шпат
плавиться	тапі´цца
плавкий	то´пкі
плавни	тапнякі´
пламя	по´лымя
пламя восстановительное	по´лымя рэдукцый´нае
пламя несветящееся	по´лымя нябліску´чае
пламя окислительное	по´лымя ўтляня´льнае
пламя светящееся	по´лымя бліску´чае
пластинка	пласто´к
платина	пляты´на
платина бромистая	бромю´р пляты´ны
платина бромная	бромі´д пляты´ны
платина двусернистая	двохсульфі´д пляты´ны
платина губчатая	губкава´тая пляты´на
платиновая чернь	пляты´навы парашо´к
платина иодистая	ёду´р пляты´ны
платина сернистая	сульфу´р пляты´ны
платина хлористая	хлёру´р пляты´ны
платина хлорная	хлёры´д пляты´ны
платина цианистая	цыяну´р пля´тыны
платинистохлористоводородная кислота	пляты´ніста-хлё´рыста-вадаро´дная кіслата´
платинохлористоводородная кислота	пляты´на-хлё´рыста-вадаро´дная кіслата´
платины гидрат закиси	гідра´т падтле´ньніку пляты´ны
платины гидрат окиси	гідра´т тле´ньніку пляты´ны
платины окись	тле´ньнік пляты´ны
плесень	пле´сьня; на цьвё´рдых — цьвіль; на ва´дкіх — бро´сьня
плодовый сахар	фрукто´вы цу´кер
плоскодонная колба	плоскадо´нная ко´ўба
плотность (газов и жидкостей)	сьці´сласьць (га´заў і ва´дкасьцяй)
пневматическая ванна	пнэўматы´чная ва´нна
побочный продукт	пабо´чны праду´кт
поваренная соль	спажыўна´я соль
поглощение	паглына´ньне
подвижное равновесие	рухо´мая роўнава´га
подкислить	падкісьлі´ць
подсолнечное масло	сланэ´чны але´й
подщелачивать	падлу´жваць
полива	палі´ва
поликремневые кислоты	многасылі´цыевыя кісло´ты
полимерия	полімэ´рыя
полнота сгорания	паўната´ згарэ´ньня
полоний	полё´ні
полуда	цынава´ньне
полудить	ацынава´ць
полупроницаемые перепонки	напаўпраніка´льныя бало´нкі
помутнеть	памутне´ць
пористость	сітава´тасьць
порода (горная)	паро´да
порох	по´рах
порошкообразный	парашкава´ты
порошок	парашо´к
портландский цемент	портля´ндзкі цэ´мант
порфир	порфі´р
посеребрение	пасрабрэ´ньне
построение химическое	хэмі´чная пабудо´ва
посуда	по´суд, начы´ньне
поташ	пата´ш
поташевый завод	пата´шня
празеодимий	празэоды´мі
превращение	ператварэ´ньне
предохранитель	забясьпе´чнік
прение	прэ´ньне
прибор	прыла´да
признак	азна´ка, прыме´та
приемник (посуда)	прыма´льнік
прилипание	прыліпа´ньне
применение	прыстасава´ньне
пример	пры´клад
примесь	пры´мешка
припаять	прылітава´ць
припой (материал для паяния)	літ
приспособление (к прибору)	прыла´дак
проба для анализа	про´ба для ана´лізу
пробирка	про´баўка
пробка	ко´рак
пробкомялка	коркамя´льніца
проволока	дрот
проволочная сетка	драцяна´я се´тка
проверочная реакция	правяра´льная рэа´кцыя
прогоркнуть	зьялча´ць, праго´ркнуць
прожигание	прапяка´ньне
прозрачный	празры´сты
производные	вытво´рныя
прокаливать	прапа´льваць
промывалка	прамыва´лка
проницаемость	праніка´льнасьць
пропан	пропа´н
пропилен	пропіле´н
пропиловый спирт	пропі´лавы сьпіры´тус
пропитать	нася´кнуць
пропускная бумага	прапускна´я папе´ра
противоядие	проціатру´та
протрава	пратра´ва
протравливание	пратра´ўліваньне
процеживание	працэ´джваньне
проявитель	вы´яўнік
пудлингование	пудлінгава´ньне
пузырек	пузыро´к
пульверизатор	пы´рскаўка
пушечный металл	гарма´тны мэта´л
равенство химическое	хэмі´чная ро´ўнасьць
равновесие химическое	хэмі´чная роўнава´га
радий	ра´ды
радикал	радыка´л
радиоактивность	радыёакты´ўнасьць
разбавленный раствор	разьве´дзены ро´шчын, раство´р
разбавлять	разво´дзіць
разбухать	набрака´ць
разжижать	разрэ´джваць
разложение	расклада´ньне
размельчать	драбі´ць, крышы´ць
разновес	дробнав´ага, дро´бныя гі´ры
разредить	разрэ´дзіць
рассол	расо´л
раковина (водопроводная)	вадазьлі´ў
раскаливать	распа´льваць
раскисление	абястле´ньваньне
распад	распа´д
распаивать	разьліто´ўваць
расплавить	растапі´ць
расплываться	расплыва´цца
расплющить	распляска´ць
раствор	ро´шчын, раство´р
растворение	рашчыне´ньне
растворимое стекло	раство´рнае шкло
растворимость	ро´шчыннасьць, раство´рнасьць
растворитель	ро´шчыньнік, раство´рнік
растительные кислоты	расьлі´нныя кісло´ты
рафинирование	рафінава´ньне
рафиноза	рафіно´за
рвотный камень	вані´тны ка´мень
реагент	рэаге´нт
реактив	рэакты´ў
реакция	рэа´кцыя
реакция двойного замещения	рэа´кцыя падво´йнай замен´ы
реакция замещения	рэа´кцыя заме´ны
реакция каталитическая	рэа´кцыя каталіты´чная
реакция обмена	рэа´кцыя паме´ну
реакция разложения	рэа´кцыя расклада´ньня
реакция соединения	рэа´кцыя злучэ´ньня
регенеративная печь	рэгенэраты´ўная печ
регенерация	рэгенэра´цыя, аднаўле´ньне
регенерирование	аднаўля´ньне
резервуар	магазы´н, вадаста´ў, рэзэрвуа´р
резина	гу´ма
резорцин	рэзорцы´на
реторта	рэто´рта
рефрактометр	рэфрактамэ´тр
рецепт	рэцэ´пт
ржавление	іржа´ўленьне
ржавчина	іржа´
ринманова зелень	ры´нманава зе´лень
роговая обманка	ро´гавы падабня´к
роговое серебро	ро´гавае срэ´бра
родановые соединения	рода´навыя злучэ´ньні
родий	ро´ды
розовое масло	ружа´ны але´й
розоловая кислота	розо´левая кіслата´
романский цемент	рома´нскі цэ´мант
ртути закись	падтле´ньнік жыво´га срэ´бра
ртути окись	тле´ньнік жыво´га срэ´бра
ртутный сплав (амальгама, сортучка)	амальга´ма
ртуть	жыво´е срэ´бра
ртуть азотнокислая закись	нітра´т падтле´ньнікавага жыво´га срэ´бра
ртуть азотнокислая окись	нітра´т тле´ньнікавага жыво´га срэ´бра
ртуть бромистая	бромю´р жыво´га срэ´бра
ртуть бромная	бромі´д жыво´га срэ´бра
ртуть иодистая	ёду´р жыво´га срэ´бра
ртуть иодная	ёды´д жыво´га срэ´бра
ртуть сернистая (киноварь)	сульфі´д, сярча´к жыво´га срэ´бра
ртуть сернокислая закись	сульфа´т падтле´ньнікавага жыво´га срэ´бра
ртуть сернокислая окись	сульфа´т тле´ньнікавага жы´вога срэ´бра
ртуть углекислая	карбона´т жыво´га срэ´бра
ртуть хлористая	хлёру´р жыво´га срэ´бра
ртуть хлорная	хлёры´д жыво´га срэ´бра
ртуть хромовокислая	хрома´т жыво´га срэ´бра
ртуть цианистая	цыяну´р жыво´га срэ´бра
рубидий	рубі´ды
рубидий азотнокислый	нітра´т рубі´дыю
рубидий сернокислый	сульфа´т рубі´дыю
рубидий углекислый	карбона´т рубі´дыю
рубидий хлористый	хлёры´д рубі´дыю
рубидия гидрат окиси	гідра´т тле´ньніка рубі´дыю
рубин	рубі´н
руда	руда´
рудничная лампа	руднё´вая ля´мпа
рудничные газы	руднё´выя га´зы
рутениевый ангидрид	рутэ´ніевы ангідры´д
рутений	рутэ´ні
рутил	руты´ль
ряд ароматический	рад араматы´чны
ряд ацетиленовый	рад ацэтыле´навы
ряд олефиновый	рад олефі´навы
ряд парафиновый	рад парафі´навы
ряд жирный	рад тлу´сты
сажа	са´жа
салицин	саліцы´на
сало (свиное внутреннее)	здор
сало (свиное кусковое)	сала
сало (лошадей, рогатого скота, овец, коз и др.)	лой
самарий	сама´ры
самовозгорание	самазапале´ньне
самовоспламеняющийся	самазапа´льны
самородок	самаро´дак
самородный металл	самаро´дны мэта´л
сатурация	сатура´цыя
сатурново дерево	сату´рнава дрэ´ва
сахар	цу´кер
сахараты	цукры´ны
сахариметр	цукраме´р
сахарин	сахары´на
сахарный тростник	цукро´вае трысьцё´, цукро´вая трысьці´на
сахар свекловичный	цу´кер бура´чны
сахар свинцовый	цу´кер валавя´ны
сахар солодовый	цу´кер саладо´вы
сахар тростниковый	цу´кер трысьці´нны
сваривание	зва´рваньне, зва´рка
сверло пробочное	сьвярдзё´лак ко´рачны
свертывание	зьвіна´ньне
свет Друммондов	сьвятло´ Друмо´ндава
свинца гидрат окиси	гідра´т тле´ньніку во´лава
свинец азотнокислый	нітра´т во´лава
свинца окись	тле´ньнік во´лава
свинца окись-перекись	тле´ньнік-надтле´ньнік во´лава
свинца перекись	надтле´ньнік во´лава
свинец	во´лава
свинец бромистый	бромі´д во´лава
свинец иодистый	ёды´д во´лава
свинец пирофосфорнокислый	пірафосфа´т во´лава
свинец серистый	сульфі´д во´лава, сярча´к во´лава
свинец сернокислый	сульфа´т во´лава
свинец сернокислый основной	сульфа´т во´лава асно´ўны
свинец углекислый	карбона´т во´лава
свинец углекислый основной	карбона´т асно´ўны
свинец уксусно-кислый	ацэта´т во´лава
свинец фосфорно-кислый	фосфа´т во´лава
свинец фтористый	флюёры´д во´лава
свинец хлористый	хлёру´р во´лава
свинец хлорновато-кислый	хлёра´т во´лава
свинец хлорный	хлёры´д во´лава
свинец хромовокислый	хрома´т во´лава
свинец цианистый	цыяні´д во´лава
свинец циановокислый	цыяна´т во´лава
свинцовое мыло	валавя´ны пля´стыр
свинцовый блеск	валавя´ны блішча´к
свойство	уласьці´васьць
связь двойная	су´вязь падво´йная
связь тройная	су´вязь патро´йная
сгорание	згара´ньне
сгущать	згушча´ць
сгущение	згушчэ´ньне
сдавливание	сьціска´ньне
селен	сэле´н
селен бромистый	бромю´р сэле´ну
селенистая кислота	сэле´ністая кіслата´
селенистый ангидрид (двуокись)	сэле´ністы ангідры´д (двохтле´ньнік)
селенистый водород	сэле´ністы вадаро´д
селеновая кислота	сэле´навая кіслата´
селеновый ангидрид	сэле´навы ангідры´д
селен хлористый	хлёру´р сэле´ну
селен четырехбромистый	чатырохбромі´д сэле´ну
селен четыреххлористый	чатыроххлёры´д сэле´ну
селитра	сале´тра
сера	се´рка
сера аморфная	се´рка амо´рфная
сера бромистая	бро´мюр се´ркі
сера двухлористая	двоххлёры´д се´ркі
сера диморфная	се´рка дымо´рфная
сера комовая	се´рка ў гру´дках
сера хлористая	хлёру´р се´ркі
сера пластическая	се´рка плясты´чная
сера черенковая	се´рка ў па´лачках
сера четыреххлористая	чатыроххлёры´д се´ркі
сера шестииодистая	шасьціёды´д се´ркі
сера шестифтористая	шасьціфлюёры´д се´ркі
серебра гидрат окиси	гідра´т тле´ньніку срэ´бра
серебра закись (недокись)	падтле´ньнік срэ´бра
серебра окись	тле´ньнік срэ´бра
серебра перекись	надтле´ньнік срэ´бра
серебро	срэ´бра
серебро азотистокислое	нітры´т срэ´бра
серебро азотнокислое	нітра´т срэ´бра
серебро ацетиленистое	ацэтылі´д срэ´бра
серебро бромистое	бромі´д срэ´бра
серебро бромноватокислое	брома´т срэ´бра
серебро двухромовокислое	біхрома´т срэ´бра
серебро иодистое	ёды´д срэ´бра
серебро иодноватокислое	ёда´т срэ´бра
серебро мышьяковистокислое	арсэні´т срэ´бра
серебро мышьяковокислое	арсэна´т срэ´бра
серебро пирофосфорнокислое	пірафосфа´т срэ´бра
серебро роговое	ро´гавае ср´эбра
серебро роданистое	родані´д срэ´бра
серебро серистое	сульфі´д, сярча´к срэ´бра
серебро сернистокислое	сульфі´т срэ´бра
серебро сернокислое	сульфа´т срэ´бра
серебро углекислое	карбона´т срэ´бра
серебро фосфорнокислое	фосфа´т срэ´бра
серебро фтористое	флюёры´д срэ´бра
серебро хлористое	хлёры´д срэ´бра
серебро хлорноватокислое	хлёра´т срэ´бра
серебро хлорнокислое	надхлёра´т срэ´бра
серебро цианистое	цыяні´д срэ´бра
серная кислота	сярча´ная кіслата´
серная кислота пиро	пірасярча´ная кіслата´
сернистая кислота	сярні´стая кіслата´
сернистая ртуть	сульфі´д жыво´га срэ´бра
сернистой кислоты соль	сульфі´т
сернистые соединения	сульфі´ды, серчакі´
сернистый ангидрид (двуокись)	сярні´сты ангідры´д
серноватистая кислота	падсярні´стая кіслата´
серное молоко	сярча´нае малако´
серной кислоты соль	сульфа´т
серный ангидрид	сярча´ны ангідры´д
серный цвет	сярча´ная кра´ска
сероводород	серкавадаро´д
сероуглерод	серкавугляро´д
серпентин	сэрпэнты´н
сетка азбестовая	се´тка азбэ´ставая
сжатие	сьціск, сьціска´ньне
сжижение	звадкава´ньне
сжимаемость	сьціска´льнасьць
силикат	сыліка´т
силиций	сылі´цы
сильвин	сыльві´н
символ химический	сымбо´ль хэмі´чны
синерод	сіняро´д, цыя´н
синеродистый водород	сіняро´дзісты вадаро´д, цыя´ністы вадаро´д
синтез	сы´нтэз
синькали желтое	сінька´лі жо´ўтае
синькали красное	сінька´лі чырво´нае
сироп	сыро´п
сифон	сыфо´н, лі´вар
скандий	ска´нды
скипидар	тарпаты´на, шпікіна´р
склеивание	скле´йваньне
склянка	шкля´нка, сло´ік
скорость реакции	ско´расьць рэа´кцыі
сложная частица	склада´ная ча´стачка, часьці´нка
сложные эфиры	склада´ныя э´тары
слюда	сьлюда´
смесь	мешані´на, су´месь
смешение	зьме´шваньне
смола	смала´
смола газовая	смала´ га´зная
смолистый	смо´льны
смолка урановая	смо´лка ўра´навая
сода	со´да
сода кальцинированная	со´да кальцынава´ная
сода питьевая	со´да пітна´я
содовая вода	со´давая вада´
соединение	злучэ´ньне
соединительный вес	злуча´льная вага´
солеобразующие окислы	солеўтвара´льныя тле´ньнікі
солероды	соляро´ды, галёге´ны
галогены	соляро´ды, галёге´ны
солод	со´лад
солончак	саланча´к
соль	соль
соль каменная	соль каме´нная
соль поваренная	соль спажыўна´я
соль самосадочная	соль самааса´дная
соляные копи	саляны´я капа´льні
состав	склад
составная часть	сустаўна´я ча´стачка, часьці´нка
состояние выделения	стан нараджэ´ньня
сосуд	пасу´дзіна
спай	зьліто´ўка
спаивание	зьліто´ўваньне
спектр	спэ´ктар
спектральный анализ	спэктра´льны ана´ліз
спектроскоп	спэктраско´п
спинтерископ	сьпінтэрыско´п
спирт	сьпіры´тус
спирт абсолютный	сьпіры´тус абсолю´тны
спирт амиловый	сьпіры´тус амілё´вы
спирт бутиловый	сьпіры´тус бутылё´вы
спирт метиловый	сьпіры´тус мэтылё´вы
спиртокислота	сьпіры´туса-кіслата´
спирт пропилевый	сьпіры´тус пропілё´вы
спирт этиловый (винный)	сьпіры´тус этылё´вы
спички	запа´лкі, сярні´чкі
сплав	сто´пак
сплав Вуда	сто´пак Ву´да
сплавление	сто´пліваньне
сплав Розе	сто´пак Ро´зэ
сплющивание	сплю´шчваньне
способность	здо´льнасьць
способ приготовления	спо´саб прыгатава´ньня
спутники платины	спадаро´жнікі пляты´ны
среда	асяро´дзьдзе
средняя соль	сярэ´дняя, нэўтра´льная соль
сродство химическое	хэмі´чнае свая´цтва
стакан	шкля´нка
сталь	сталь
станиоль	валавя´ная папе´ра, станіё´ль
стеарин	стэары´на
стекло	шкло
стекловидный	шклі´сты, падо´бны да шкла
стекло растворимое	шкло раство´рнае
стекло свинцовое	шкло валавя´нае
стеклянная вата	шкляна´я ва´та
стереохимия	стэрэахэ´мія
стехиометрия	стэхіёмэтры´я
строение	будо´ва
строение пламени	будо´ва по´лымя
стронций	стро´нцы
стронцианит	стронцыяні´т
стронций азотнокислый	нітра´т стро´нцыю
стронций бромистый	бромі´д стро´нцыю
стронций иодистый	ёды´д стро´нцыю
стронций сернистый	сульфі´д, сярча´к стро´нцыю
стронций сернокислый	сульфа´т стро´нцыю
стронций углекислый	карбона´т стро´нцыю
стронций хлористый	хлёры´д стро´нцыю
стронция гидрат окиси	гідра´т тле´ньніка стро´нцыю
стронция окись	тле´ньнік стро´нцыю
структура	структу´ра, будо´ва
струя	струме´нь
студень	сту´дзень
ступка	мажджэ´рчык, сту´пка
сублимация	субліма´цыя
сулема	суля´ма
сульфангидриды	сульфаангідры´ды
сульфат	сульфа´т
сульфгидраты	сульфагідра´ты
сульфкарбонаты	сульфакарбона´ты
сульфкислоты	сульфакісло´ты
сульфмышьяковая кислота	сульфааршэ´нікавая кіслата´
сульфоловянная кислота	сульфацы´навая кіслата´
сульффосфорная кислота	сульфафо´сфарная кіслата´
сульфурилгидроксилхлорид	сульфуры´ль-гідроксыль-хлёры´д
сульфурил хлористый	сульфуры´ль-хлёры´д
суперфосфат	супэрфосфа´т
сурик свинцовый	су´рык валавя´ны
сурьма	антымо´н
сурьма пятисернистая	сульфі´д, сярча´к антымо´ну
сурьма пятифтористая	флюёры´д антымо´ну
сурьма пятихлористая	хлёры´д антымо´ну
сурьма трехбромистая	бромю´р антымо´ну
сурьма трехиодистая	ёду´р антымо´ну
сурьма трехсернистая	сульфу´р антымо´ну
сурьма трехфтористая	флюёру´р антымо´ну
сурьма треххлористая	хлёру´р антымо´ну
сурьма хлорокись	хлёратле´ньнік антымо´ну
сурьмы окись (сурьмянистый ангидрид)	тле´ньнік антымо´ну
сурьмы пятиокись (сурьмяный ангидрид)	антымо´навы ангідры´д
сурьмяная кислота мета	мэтаантымо´навая кіслат´а
сурьмяная кислота орто	ортаантымо´навая кіслата´
сурьмяная кислота пиро	піраантымо´навая кіслата´
сурьмянистая кислота	антымо´ністая кіслата´
сурьмянистый водород	антымо´навы вадарод´
сфера	сфэ´ра
сцепление	шчапле´ньне, сушчэ´пнасьць
сыпучесть	сы´пкасьць
сырость	ві´льгаць
талий	та´лі
талий азотнокислый	нітра´т та´лію
талий однобромистый	аднабромі´д та´лію
талий одноиодистый	аднаёды´д та´лію
талий односернистый	аднасульфі´д та´лію
талий однохлористый	аднахлёры´д та´лію
талий сернокислый закись	сульфа´т падтле´ньнікавага та´лію
талий сернокислый окись	сульфа´т тле´ньнікавага та´лію
талий трехбромистый	трохбромі´д та´лію
талий трехсернистый	трохсульфі´д та´лію
талий треххлористый	троххлёры´д та´лію
талий углекислый	карбона´т та´лію
талия гидрат закиси	гідра´т падтле´ньніка та´лію
талия гидрат окиси	гідра´т тле´ньніка та´лію
талия закись	падтле´ньнік та´лію
талия окись	тле´ньнік та´лію
тальк	тальк
танин	тані´на, га´рбнік
тантал	танта´ль
теллур	тэлю´р
теллуристая кислота	тэлюры´стая кіслата´
теллуристый ангидрид	тэлю´рысты ангідры´д
теллуристый водород	тэлю´рысты вадаро´д
теллуровая кислота	тэлю´равая кіслата´
теллуровый ангидрид	тэлю´равы ангідры´д
температура	тэмпэрату´ра
теобромин	тэабромі´на
теория	тэо´рыя
теплоемкость	цёплаё´мнасьць
теплота	цяплыня´
тербий	тэ´рбі
термический пай	тэрмі´чны пай
термометр	тэрмо´мэтр, гра´дусьнік
термохимия	тэрмахэ´мія
терпентин	тарпаты´на
терпкий	цё´рпкі, да´ўкі
терракот	тэрако´та
тетра-борная(тетраборная) кислота	чатырохбо´рная кіслата´
тетратионовая кислота	чатырохсярча´ная кіслата´
тигель	ты´гель
тигельная сталь	тыглё´вая сталь
тинктура	тынкту´ра
тимол	тымо´ль
тиосоединения	серказлучэ´ньні
тиоугольная кислота	серкаву´гальная кіслата´
типографский металл	друка´рскі мэта´л
типографская краска	друка´рская фа´рба
титан	тыта´н
титановый ангидрид	тыта´навы ангідры´д
титан хлористый	хлёры´д тыта´ну
титрование	тытрава´ньне
тление	тле´ньне
тождественно	тожса´ма
толуидин	толюіды´на
толуол	толюё´ль
томасирование	томасава´ньне
томас-шлак	то´мас-шляк
томпак	томпа´к
торий	то´ры
топливо	апа´л
торф	торф
трейбование	трайбава´ньне
трение	трэ´ньне
треножник	трыно´жак
трепел	трэ´пэль
третичный	траця´чны
трехатомный	троха´томны
трехосновная кислота	трохасно´ўная кіслата´
триада	трыя´да
триолеин	трыолеі´на
трипальмитин	трыпальміты´на
тристеарин	трыстэары´на
тритионовая кислота	трохсярча´ная кіслата´
трихлоруксусная кислота	троххлёрво´цатная кіслата´
трубка	ру´рка, тру´бка
трубка паяльная	рурка літава´льная
трут	цыр, трут
тубулатная реторта	тубуля´тная рэто´рта
тубулус	ту´булюс
тугоплавкий	тугато´пкі
тулий	ту´лі
турнбулевая синь	турнбулё´вая сінь
турмалин	турмалі´н
тусклый	цьмя´ны
тяга	ця´га
тягучий	цягу´чы
тяжелые металлы	ва´жкія мэта´лы
тяжелый шпат	ва´жкі шпат
увлажнять	увільго´чваць
угар	чад
углевод	вугляво´д
углеводород	вуглявадаро´д
углеводороды насыщенные или предельные	вуглявадаро´ды поў´ныя, насы´чаныя
углекислота	ву´гальная кіслата, вуглякіслата´
углекислоты соль	карбона´т
углекислый газ	двохтле´ньнік вугляро´ду, ангідры´д ву´гальнай кіслаты´
углерод	вугляро´д
углерода окись	тле´ньнік вугляро´ду
углерод четыреххлористый	чатыроххлёры´д вугляро´ду
уголь	ву´галь
уголь аморфный	ву´галь амо´рфны
уголь бурый	ву´галь бу´ры
уголь древесный	ву´галь дрэ´ўны
уголь животный	ву´галь жывё´лінны
уголь каменный	ву´галь каме´нны
уголь каменный жирный	ву´галь каме´нны тлу´сты
уголь каменный тощий	ву´галь каме´нны нятлу´сты
уголь костяной	ву´галь касьцяны´
уголь кровяной	ву´галь крывяны´
уголь ретортный	ву´галь рэто´ртны
удельная теплоемкость	адно´сная цёплаё´мнасьць
удельный вес	адно´сная вага´
удельный объем	адно´сны аб'ё´м
удобрение	угнае´ньне
узорчатая сталь	узо´рчастая сталь
уксус	во´цат
уксусная кислота	во´цатная кіслата´
уксусной кислоты соль	ацэта´т
уксусный ангидрид	во´цатны ангідры´д
ультрамарин	ультрамары´на
уплотнение	згушчэ´ньне
упругость	пру´гасьць
уравнение химическое	хэмі´чнае раўна´ньне
уран	ура´н
уран сернокислый	сульфа´т ура´ну
уранил	урані´ль
уранил азотнокислый	нітра´т урані´лю
уранил сернокислый	сульфа´т урані´лю
уранил уксуснокислый	ацэта´т урані´лю
уранил фосфорнокислый	фосфа´т урані´лю
уранил хлористый	хлёры´д урані´лю
уран уксуснокислый	ацэта´т ура´ну
уран хлористый	чатыроххлёры´д ура´ну
утфель	у´тфель
фаза	фа´за
фарфор	парцаля´на
фарфоровая глина	парцаля´навая глі´на
фаянс	фая´нс
фаянсовый	фая´нсавы
фейерверк	фаервэ´рк
фелингов раствор	фэ´лінгаў раство´р
фенантрен	фэнантрэ´н
фенацетин	фэнацэты´на
фенилгидразин	фэні´ль-гідразы´на
фенилгидроксиламин	фэні´ль-гідраксы´ль-амі´на
фенилуксусная кислота	фэнільво´цатная кіслата´
фенол	фэно´ль, карбо´лавая кіслата´
фенолокислоты	фэнолёкісло´ты
фенолоспирты	фэнолёсьпіры´тусы
фенолфталеин	фэно´ль-фталеі´на
фермент	фэрмэ´нт
ферроманган	жалезаманга´н
фиксирование	фіксава´ньне
фильтр	фі´льтар
фильтрат	фільтра´т
фильтровальная бумага	фільтрава´льная папе´ра
фильтрование	фільтрава´ньне
фильтровать	фільтрава´ць
фитиль	кнот
флогистон	флёгісто´н
флуоресценция	флюёрэсцэ´нцыя
флюс	флюс
фольга	фо´льга, мэталі´чная папер´а
формалин	формалі´на
формальдегид	мураўё´вы альдэгі´д, формальдэгі´д
формула	фо´рмула
фосген	фосге´н
фосфоний	фосфо´ні
фосфоний бромистый	бромі´д фосфо´нію
фосфоний иодистый	ёды´д фосфо´нію
фосфоний хлористый	хлёры´д фосфо´нію
фосфора хлорокись	хлёратле´ньнік фо´сфару
фосфор белый	фо´сфар бе´лы
фосфор двухиодистый	двох'ёды´д фо´сфару
фосфоресценция	фосфорэсцэ´нцыя
фосфор красный	фо´сфар чырво´ны
фосфористая кислота	фо´сфарыстая кіслата´
фосфористой кислоты соль	фосфі´т
фосфористый ангидрид	ангідры´д фо´сфарыстае кіслаты´
фосфористый водород газообразный	фо´сфарысты вадаро´д га´завы
фосфористый водород жидкий	фо´сфарысты вадаро´д ва´дкі
фосфористый водород твердый	фо´сфарысты вадаро´д цьвё´рды
фосфориты	фосфары´ты
фосфорический	фосфары´чны
фосфорная кислота	фо´сфарная кіслата´
фосфорная кислота-мета	мэтафо´сфарная кіслата´
фосфорная кислота-орто	ортафо´сфарная кіслата´
фосфорная кислота-пиро	пірафо´сфарная кіслата´
фосфорно-ванадиевая кислота	фо´сфарна-вана´дыевая кіслата´
фосфорноватая кислота	падфо´сфарная кіслата´
фосфорноватистая кислота	падфо´сфарыстая кіслата´
фосфорноватистой кислоты соль	падфосфі´т
фосфорноватой кислоты соль	падфосфа´т
фосфорноватистой кислоты ангидрид	ангідры´д падфо´сфарыстай кіслаты´
фосфорноватый ангидрид	ангідры´д падфо´сфарнай кіслаты´
фосфорновольфрамовая кислота	фо´сфарна-вольфра´мавая кіслата´
фосфорной кислоты ангидрид	ангідры´д фо´сфарнай кіслаты´
фосфорной кислоты соль	фосфа´т
фосфорно-молибденовая кислота	фо´сфарна-молібдэ´навая кіслата´
фосфор пятибромистый	пяцібромі´д фо´сфару
фосфор пятииодистый	пяціёды´д фо´сфару
фосфор пятисернистый	пяцісульфі´д фо´сфару
фосфор пятифтористый	пяціфлюёры´д фо´сфару
фосфор пятихлористый	пяціхлёры´д фо´сфару
фосфор сульфобромистый	сульфабромі´д фо´сфару
фосфор сульфотриамид	сульфатрыамі´д фо´сфару
фосфор сульфохлорид	сульфахлёры´д фо´сфару
фосфор трехбромистый	трохбромі´д фо´сфару
фосфор трехиодистый	трох'ёды´д фо´сфару
фосфор трехсернистый	трохсульфі´д фо´сфару
фосфор трехфтористый	трохфлюёры´д фо´сфару
фосфор треххлористый	троххлёры´д фо´сфару
фотоген-керосин	га´за
фотография	фотагра´фія
фотохимия	фотахэ´мія
фракционировка	фракцыянава´ньне
фраунгоферовы линии	фраўнго´фэравыя лі´ніі
фруктовый сахар	фрукто´вы цу´кер
фруктоза	фрукто´за
фталевая кислота	фта´левая кіслата´
фтор	флюё´р
фтористоводородная кислота	флюёрыставадаро´дная кіслата´
фтористый водород	флюё´рысты вадаро´д
фтористый кремний	флюёры´д сылі´цыю
фтороборная кислота	флюёрабо´рная кіслата´
фуксин	фуксы´на
фумаровая кислота	фума´равая кіслата´
фумарола	ды´мніца
фурфуран	фурфура´н
фурфурол	фурфуро´ль
халцедон	хальцэдо´н
хамелеон минеральный	мінэра´льны хамэлео´н
химическая реакция	хэмі´чная рэа´кцыя
химический	хэмі´чны
химия	хэ´мія
химия аналитическая	хэ´мія аналіты´чная
химия биологическая	хэ´мія біялёгі´чная
химия коллоидная	хэ´мія колё´ідная
химия неорганическая	хэ´мія неоргані´чная
химия органическая	хэ´мія органі´чная
химия техническая	хэ´мія тэхні´чная
химия физическая	хэ´мія фізы´чная
хинин	хіні´на, хі´на
хинная кислота	хі´нная кіслата´
хинон	хіно´н
хладноломкое железо	халоднало´мкае жале´за
хлопок	баво´ўна
хлопчатобумажный порох	баваўня´ны по´рах
хлопьевидный осадок	клоччападо´бны асад´ак
хлор	хлёр
хлораль	хлёра´ль
хлора двуокись	двохтл´еньнік хлё´ру
хлора окись	хлёратле´ньнік, тле´ньнік хлё´ру
хлорангидрид	хлёрангідры´д
хлорбензол	хлёрабэнзо´ль
хлорирование	хлёрава´ньне
хлористая кислота	хлё´рыстая кіслата´
хлористоводородная кислота	хлёрыставадаро´дная кіслата´
хлористоводородной кислоты соль	хлёры´д
хлористой кислоты соль	хлёры´т
хлористые соединения	хлё´рыстыя злучэ´ньні
хлористый азот	хлёры´д азо´ту
хлористый водород	хлёры´д вадаро´ду
хлористый тионил	хлёры´д тыёні´лю
хлористый углерод	хлёры´д вугляро´ду
хлорная вода	хлё´рная вада´
хлорная кислота	надхлё´рная кіслата´
хлорная известь	бялі´льная хлё´рка, хлё´рная ва´пна
хлорноватая кислота	хлё´рная кіслата´
хлорноватистая кислота	падхлё´рыстая кіслата´
хлорноватистой кислоты соль	падхлёры´т
хлорноватой кислоты соль	хлёра´т
хлорной кислоты соль	надхлёра´т
хлорный ангидрид	надхлё´рны ангідры´д
хлорозамещенный	хлёразасту´плены
хлорокись углерода	хлёратле´ньнік вугляро´ду
хлорпикрин	хлёрапікры´на
хлороплатинаты	хлёраплятына´ты
хлорофилл	хлёрафі´ль, лістазе´лень
хлороформ	хлёрафо´рм
хмель	хмель
холин	холі´на
холодильник	халадзі´льнік
холодильник воздушный	халадзі´льнік паве´траны
холодильник водяной	халадзі´льнік вадзяны´
холодильник обратный	халадзі´льнік адваро´тны
хром	хром
хрома гидрат закиси	гідра´т падтле´ньніка хро´му
хрома гидрат окиси	гідра´т тле´ньніка хро´му
хрома окись	хроматле´ньнік
хром бромный	бромі´д хро´му
хромил хлористый	хромі´ль хлё´рысты
хром иодистый	ёду´р хро´му
хром иодный	ёды´д хро´му
хромистый железняк	хро´місты жалязьня´к
хромовая кислота	хро´мавая кіслата´
двухромовая кислота	двоххро´мавая кіслата´
хромовой кислоты соль	хрома´т
двухромовой кислоты соль	біхрома´т
хромовые квасцы	хро´мавы галы´н
хромовый ангидрид	хро´мавы ангідры´д
хромпик	хро´мпік
хром сернистый	сульфі´д хро´му
хром сернокислый	сульфа´т хро´му
хром фтористый	флюёру´р хро´му
хром фторный	флюёры´д хро´му
хром хлористый	хлёру´р хро´му
хром хлорный	хлёры´д хро´му
хрупкий	кро´хкі
хрусталь	хруста´ль
царская водка	ца´рская во´дка
цвет	ко´лер
цветной	каляро´вы
цвет серный	сярча´ная кра´ска
цветные металлы	каляро´выя мэта´лы
цедить	цадзі´ць
цезий	цэ´зі
цезий азотнокислый	нітра´т цэ´зію
цезий сернокислый	сульфа´т цэ´зію
цезий углекислый	карбона´т цэ´зію
цезий хлористый	хлёры´д цэ´зію
цезия гидрат окиси	гідра´т тле´ньніка цэ´зію
цезия окись	тле´ньнік цэ´зію
цезия хлороплатинат	плятынахлёры´д цэ´зію
целлулоид	цэлюлё´ід
целлюлоза	цэлюлё´за
цельное молоко	цэ´льнае малако´
цемент	цэ´мант
цементирование	цамантава´ньне
цементит	цэманты´т
церезин	цэрэзы´на
церий	цэ´ры
церий сернистый	сульфі´д цэ´рыю
церий сернокислый	сульфа´т цэ´рыю
церий углекислый	карбона´т цэ´рыю
церий фосфорнокислый	фосфа´т цэ´рыю
церий хлористый	хлёры´д цэ´рыю
церия двуокись	двохтле´ньнік цэ´рыю
церия карбид	карбі´д, вугля´к цэ´рыю
церия окись	тле´ньнік цэ´рыю
церусит	цэрусы´т
циан (синерод)	цыя´н
цианистая ртуть	цыяні´д жыво´га срэ´бра
цианистая соль	цыяні´д
цианистый бром	цыянбромі´д
цианистый водород	цыяні´д вадаро´ду
цианистый иод	цыян'ёды´д
цианистый калий	цыяні´д ка´лію
цианистый хлор	цыянхлёры´д
циановая кислота	цыя´навая кіслата´
циановокислая соль	цыяна´т
циановокислый калий	цыяна´т ка´лію
цилиндр	цылі´ндар
цинк	цынк
цинка гидрат окиси	гідра´т тле´ньніка цы´нку
цинк азотнокислый	нітра´т цы´нку
цинка окись	тле´ньнік цы´нку
цинкаты	цынка´ты
цинк бромистый	бромі´д цы´нку
цинк иодистый	ёды´д цы´нку
цинковая обманка	цы´нкавы падабня´к
цинковые белила	цы´нкавыя бялі´лы
цинковый блеск	цы´нкавы блішча´к
цинковый купорос	цы´нкавы вітрыё´ль (купарва´с)
цинк серистый	сульфі´д, сярча´к цы´нку
цинк сернокислый	сульфа´т цы´нку
цинк углекислый	карбона´т цы´нку
цинк уксуснокислый	ацэта´т
цинк хлористый	хлёры´д цы´нку
циркон	цырко´н
цирконий	цырко´ні
цирконий фтористый	флюёры´д цырко´нію
цирконий хлористый	хлёры´д цырко´нію
циркония гидрат окиси	гідра´т тле´ньніка цырко´нію
циркония окись	тле´ньнік цырко´нію
часовое стекло	гадзі´ньнікавае шкло
частица	ча´стачка, часьці´нка
часть	часьць
чашка	мі´ска
чернила	атрамэ´нт, чарні´ла
чернильные орешки	галя´с
черпак	чарпа´к
чилийская селитра	чылі´йская сале´тра
чрен	патэ´льня
чугун	чыгу´н
чугун белый	чыгу´н бе´лы
чугун серый	чыгу´н шэ´ры
шамот	шамо´т
швейнфуртская зелень	швэйнфу´рцкая зе´лень
шестифтористая сера	шасьціфлюёры´д се´ркі
шипение	шыпе´ньне
шипучий	шыпу´чы
шкаф вытяжной	ша´фа выцяжна´я
шкаф сушильный	ша´фа сушы´льная
шлак	жу´жаль
шлифовать	шліхава´ць
шмальта	шма´льта
шпат	шпат
шпатель	лапа´тачка, шпа´тэль
штатив	штаты´ў
щавелевая кислота	шчаўё´вая кіслата´
щелок	луг
щелочная реакция	лу´жная рэа´кцыя
щелочно-земельные металлы	лу´жна-земляны´я мэта´лы
щелочность	лу´жнасьць
щелочные металлы	лу´жныя мэта´лы
щелочь	луг, асно´ва
щипцы	шчыпцы´
эбонит	эбоні´т
эвдиометр	эўдыё´мэтр
эквивалент	роўнава´ртнік, эквівале´нт
эквивалентность	роўнава´ртнасьць, эквівале´нтнасьць
эквивалентный	роўнава´ртны, эквівале´нтны
экзотермическая реакция	экзотэрмі´чная рэа´кцыя
эксикатор	сушы´льнік, эксыка´тар
экстракт	экстра´кт
эластичность	элясты´чнасьць
электролиз	электралі´з, электрараскла´д
электролит	электралі´т
электролитическая диссоциация	электраліты´чная дысоцыя´цыя
электрон	электро´н
электрохимия	электрахэ´мія
элемент	элемэ´нт, пярве´стак
эмаль	эма´ль
эмпирический	эмпіры´чны, дасьле´дчы
эмульсия	эму´льсія
эндотермическая реакция	эндотэрмі´чная рэа´кцыя
энзимы	энзы´мы
энергия химическая	энэ´ргія хэмі´чная
эозин	эозы´на
эрбий	э´рбі
эритрит	эрытры´т
Эрленмейера колба	Эрленмэ´йерава коўба
эссенция	эсэ´нцыя
этан	эта´н
этил	эты´ль
этиламин	эты´ль-амі´на
этилат	этыля´т
этилбензол	эты´ль-бэнзо´ль
этилен	этыле´н
этиловый спирт	этылё´вы сьпіры´тус
этиловый эфир	этылё´вы эта´р
этилосерная кислота	этылесярча´ная кіслата´
эфир	эта´р
эфир петролейный	эта´р на´фтавы
эфир серный	эта´р сярча´ны
эфир уксусно-этиловый	этар во´цатна-этылё´вы
яблочная кислота	я´блычная кіслата´
явление	зья´вішча
яд	атру´та
ядовитый	атру´тны
янтарная кислота	буршты´навая кіслата´
янтарь	буршты´н
ярь-медянка	яр-мядзя´нка
