##Title: Тэрмінолёгія права (БНТ)
##HTMLDescription_BEGIN
<div>
	<p class="dictdesc-st">Створана на падставе:</p>
	<p><b>Тэрмінолёгія права</b>. Менск: Інбелкульт, 1926.</p>
</div>
<div>
	<p class="spoiler">Прадмова</p>
	<p>Апрацаваньне тэрмінолёгіі права Навукова-Тэрмінолёгічная Камісія даручыла ў верасьні 1921 году Члену Камісіі Міколу Гуткоўскаму; апрацаваны ім проект тэрмінолёгіі быў першы раз разгледжаны і прыняты ў Тэрмінолёгічнай Камісіі Гуманітарнае Сэкцыі Інстытуту Беларускае Культуры у ліпні 1924 году ў складзе членаў ІБК: Івана Луцэвіча (Янкі Купалы), Канстантына Міцкевіча (Якуба Коласа), Язэпа Лёсіка, Сьцяпана Некрашэвіча, Уладыслава Чаржынскага і Міколы Гуткоўскага.</p>
	<p>Пасьля рэорганізацыі Інстытуту тэрмінолёгія права была другі раз перагледжана ў Камісіі дзеля вывучэньня савецкага будаўніцтва, у чэрвені-ліпні 1925 году. У часе перагляду былі зроблены некаторыя папраўкі, у васнову якіх паклалі досьлед удзельнікаў камісіі, практычных працаўнікоў у галіне савецкага будаўніцтва, які яны сабралі за часы сваёй працы ў дзяржаўных установах Беларусі. Разам з гэтым Камісія імкнулася, каб тэрмінолёгія адпавядала жывой мове народа і была зразумелай усім кутком Беларусі.</p>
	<p>Пасьля рэдакцыйнага перагляду тэрмінолёгіі ў Правапісна-Тэрмінолёгічнай Камісіі Інстытуту Беларускае Культуры тэрмінолёгія яшчэ раз была перагледжана Праўнаю Сэкцыяй ІБК, дапоўнена новымі тэрмінамі, і гэтыя дапаўненьні, а таксама спрэчныя пытаньні, былі канчальна ўзгоднены з памянёнай Правапісна-Тэрмінолёгічнай Камісіяй.</p>
	<p> </p>
	<p>Менск. Май, 1926 г.</p>
</div>
##HTMLDescription_END
##ArticleLang: ru/be

##Chapter: 1. Сьпіс дзяржаўных устаноў
Административно-Финансовое Управление	Адміністрацыйна-Фінансавая Ўправа
Арбитражная Комиссия при Экономическом Совещании	Арбітражная Камісія пры Экономічнай Нарадзе
Белорусская Контора Государственного Банка	Беларуская Кантора Дзяржаўнага Банку
Бюджетное Управление	Бюджэтная Ўправа
Бюро по Нормализации Труда	Бюро па Нормалізацыі Працы
Валютный Отдел	Валютны Аддзел
Ветеринарное Управление	Вэтэрынарная Ўправа
Высший Совет Народного Хозяйства	Вышэйшая Рада Народнае Гаспадаркі
Главный Комитет по контролю за репертуаром	Галоўны Камітэт па контролі за рэпэртуарам
Главный Политико-Просветительный Комитет (Главполитпросвет)	Галоўны Політычна-Асьветны Камітэт (Галоўпалітасьвет)
Главное Управление по делам литературы и издательств (Главлит)	Галоўная Ўправа па справах літаратуры і выдавецтваў
Главное Управление Профессионально-Технического и Специально-Научного Образования (Главпрофобр)	Галоўная Ўправа Прафэсыянальна-Тэхнічнае і Спэцыяльна-Навуковае Асьветы
Главное Управление Социального Страхования	Галоўная Ўправа Соцыяльнага Страхаваньня
Городской Совет	Гарадзкі Савет
Государственное Издательство	Дзяржаўнае Выдавецтва
Государственная Плановая Комиссия	Дзяржаўная Плянавая Камісія
Государственное Политическое Управление (ГПУ)	Дзяржаўная Політычная Ўправа
Земельно-Плановая Комиссия	Зямельна-Плянавая Камісія
Информационная часть	Інформацыйная часьць
Концессионная Комиссия	Концэсыйная Камісія
Лесное Управление	Лясная Ўправа
Местечковый Совет	Местачковы Савет
Налоговое Управление	Падатковая Ўправа
Народный Комиссариат Внутренних Дел	Народны Камісарыят Унутраных Спраў
Народный Комиссариат Внешней Торговли	Народны Камісарыят Замежнага Гандлю (Замежнае Таргоўлі)
Народный Комиссариат Внутренней Торговли	Народны Камісарыят Унутранага Гандлю (Таргоўлі)
Народный Комиссариат Военных и морских Дел	Народны Камісарыят Ваенных і марскіх Спраў
Народный Комиссариат Здравоохранения	Народны Камісарыят Аховы здароўя
Народный Комиссариат Земледелия	Народны Камісарыят Земляробства, Рольніцтва
Народный Комиссариат Иностранных Дел	Народны Камісарыят Замежных Спраў
Народный Комиссариат Почт и Телеграфов	Народны Камісарыят Поштаў і Тэлеграфаў
Народный Комиссариат Просвещения	Народны Камісарыят Асьветы
Народный Комиссариат Путей Сообщения	Народны Камісарыят Шляхоў Зносін
Народный Комиссариат Рабоче-Крестьянской Инспекции	Народны Камісарыят Рабоча-Сялянскае Інспэкцыі
Народный Комиссариат Социального Обеспечения	Народны Камісарыят Соцыяльнае Забясьпекі
Народный Комиссариат Труда	Народны Камісарыят Працы
Народный Комиссариат Финансов	Народны Камісарыят Фінансаў
Народный Комиссариат Юстиции	Народны Камісарыят Юстыцыі
Научно-Методологический Комитет	Навукова-Мэтодолёгічны Камітэт
Нотариальный Отдел	Нотарыяльны Аддзел
Общий Отдел	Агульны Аддзел
Окружной Исполнительный Комитет	Акружны Выканаўчы Камітэт
Организационно-Административное Управление	Організацыйна-Адміністрацыйная Ўправа
Организационно-Инспекторский Отдел	Організацыйна-Інспэктарскі Аддзел
Отдел Охраны материнства и младенчества и здоровья детей	Аддзел Аховы мацярынства і здароўя дзяцей
Отдел Охраны Труда	Аддзел Аховы Працы
Отдел Прокуратуры	Аддзел Прокуратуры
Отдел Рынка Труда	Аддзел Рынку Працы
Плановая Комиссия	Плянавая Камісія
Правление Белорусских Союзов Кооперативных Об’единений (Белкоопсоюз)	Кіраўніцтва Беларускага Саюзу коопэрацыйных Аб’яднаньняў
Правление Белорусского Союза Сельско-Хозяйственной Кооперации (Белсельсоюз)	Кіраўніцтва Беларускага Саюзу Сельска-Гаспадарчае Коопэрацыі
Президиум Центрального Исполнительного Комитета	Прэзыдыум Цэнтральнага Выканаўчага Камітэту
Правление Белорусского Сельско-Хозяйственного Банка (Белсельбанк)	Кіраўніцтва Беларускага Сельска-Гаспадарчага Банку
Приписная Приходо-Расходная Касса	Прыпісная Прыхода-Расходная Каса
Промышленно-Экономическое Управление	Прамыслова-Экономічная Ўправа
Районный Исполнительный Комитет	Раённы Выканаўчы Камітэт
Ревизионная Комиссия	Рэвізійная Камісія
Съезд Советов	Зьезд Саветаў
Сельский Совет	Сельскі Савет
Совет Народных Комиссаров	Савет Народных Камісараў
Совет Национальностей	Рада Нацыянальнасьцяй
Совет по делам Высших Учебных Заведений	Рада па справах Вышэйшых Школ
Совет по делам просвещения на железнодорожном и водном транспорте БССР	Рада па справах асьветы на чыгуначным і водным транспарце БССР
Тарифно-Конфликтный Отдел	Тарыфна-Конфліктны Аддзел
Управление Делами	Кіраўніцтва Справамі
Управление Землеустройства, Мелиорации и Государственных земельных Имуществ	Управа Зямляўпарадкаваньня, Мэліорацыі і Дзяржаўнае Зямельнае Маемасьці
Управление Коммунального Хозяйства	Управа Комунальнае Гаспадаркі
Управление Местами Заключения	Управа Месцамі Зьняволеньня
Управление Милиции и Уголовного Розыска	Управа Міліцыі і Крымінальнага Розыску
Управление Сельского Хозяйства	Управа Сельскай Гаспадаркі
Ученый Медицинский Совет	Вучоная Мэдыцынская Рада
Управление Государственными Доходами	Управа Дзяржаўнымі Даходамі
Финансово-Контрольное Управление	Фінансава-Кантрольная Ўправа
Финансово-Материальный Отдел	Фінансава-Матар’яльны Аддзел
Финансово-Счетный Отдел	Фінансава-Рахунковы Аддзел
Финансово-Хозяйственный Отдел	Фінансава-Гаспадарчы Аддзел
Финансово-Экономическое Бюро	Фінансава-Экономічнае Бюро
Центральное Бюро Жалоб	Цэнтральнае Бюро Скаргаў
Центральное Бюро по Просвещению Национальных Меншинств	Цэнтральнае Бюро па Асьвеце Нацыянальных Меншасьцяй
Центральный Исполнительный Комитет	Цэнтральны Выканаўчы Камітэт
Центральный Комитет Коммунистической Партии (большевиков) Белоруссии	Цэнтральны Камітэт Комуністычнай Партыі (бальшавікоў) Беларусі
Центральный Совет Профессиональных Союзов	Цэнтральная Рада Профэсыянальных Саюзаў
Центральное Статистическое Управление	Цэнтральная Статыстычная Ўправа
Экономическое Совещание (Экосо)	Экономічная Нарада
Юридическая часть	Юрыдычная часьць
##Chapter: 2. Слоўнік
абзац	абзац
абонемент	перадплата, абонэмэнт
аборт	аборт
аванс	аванс
авантюрист	авантурнiк
автентичный	аўтэнтычны
автономия	аўтономiя, самаўрад
авторское право	аўтарскае права
агент	агент
агентство	агенцтва
агитатор	агiтатар
агитация	агiтацыя
адвокат	адвакат
административный	адмiнiстрацыйны
администратор	адмiнiстратар
администрация	адмiнiстрацыя
адрес	адрас
адресант	адрасант
адресат	адрасат
ажиотаж	ажыятаж
азарт	азард
академия	акадэмiя
аккредитив	паўнамоцтва
акт (действие)	дзейнасьць
акт (документ)	акт
актив	актыў
акцепт	прыняцьце, акцэпт
акцептант	акцэптант
акциз	акцыз
акционер	пайшчык, акцыянэр
акционерное товарищество	акцыйнае таварыства, паявое таварыства
акция	пай, акцыя
алименты	алiмэнты
алфавит	альфабэт
амбар	сьвiран
амнистия	амнiстыя
амортизация	амортызацыя
анкета	анкета
аннексия	анэксiя
аннулировать	скасаваць, ануляваць
анонимное общество	анонiмнае таварыства
апелятор	апэлятар
апеляция	апэляцыя
аппарат	апарат
арбитр	пасрэднiк
арбитраж	пасрэднiцтва
арбитражная комиссия	арбiтражная камiсiя
аренда	арэнда
арендатор	арандатар
арест	арышт
арестант	арыштант
арестный дом	арыштны дом
артель	арцель
артельщик	арцельшчык
артикул	артыкул
архив	архiў
архивариус	архiварыус
ассигнация	асыгнацыя
ассигновка	асыгноўка
аттестат	атэстат
аттестация	атэстацыя
аукцион	лiцытацыя, аўкцыён
афера	афэра
аферист	афэрысты
афиша	афiша
багаж	багаж
базар	рынак
баланс	балянс
балл	бал, ацэнка
баллотировка	галасаваньне
банда	банда
бандероль	бандэроля
бандит	бандыт
бандитизм	бандыцтва
банк	банк
банкир	банкiр
банкирская контора	банкiрская кантора
банкрот	банкрут
банкротство	банкруцтва
барыш	прыбытак
барышник	перакупшчык
барьер	застава, бар'ер
батрак	батрак
беглец	уцякач
беглый	зьбеглы
бедствие	няшчасьце
бедствовать	гiбець
беженец	бежанец
безбожник	бязбожнiк
безбрачие	няшлюбнасьць
безвестность	безьвесьць
безвестный	нямаведамы, невядомы
безвинность	бязьвiннасьць
безвластие	бязуладзьдзе
безвозвратный	беззваротны
безвозмездно	безнагародна, дарма
безвыходность	бязвыхаднасьць
безграмотность	няпiсьменнасьць
бездействие	бязьдзейнасьць
безделие	гультайства
бездельник	гультай
безденежность	безграшоўе
бездетность	бязьдзетнасьць
бездоказательность	недаведзенасьць, бездаказальнасьць
бездомность	бяздомнасьць
беззаконие	беззаконьне
беззащитность	безабароннасьць
безземельность	безьзямельле
безлюдность	бязьлюдзьдзе
безнадежность	безнадзейнасьць
безнадежный	безнадзейны
безнаказанность	бяскарнасьць
безначалие	бязуладзьдзе
безнравственность	распуства
безобидность	бяскрыўднасьць
безоговорочность	безагаворанасьць
безопасность	бясьпечнасьць
безостановочность	бязупыннасьць
безответственность	безадказнасьць
безотлагательность	безадкладнасьць
безотлагательный	безадкладны
безотлучность	неадлучнасьць
безотчетность	безрахубнасьць
безочередность	нечарговасьць
безошибочность	непамылковасьць
безработица	безрабоцьце
безраздельность	беспадзельнасьць
безразличие	абыякасьць
безрассудность	неразважнасьць
безукоризненность	бездакорнасьць
безумие	шаленства, вар'яцтва
безупречность	беззаганнасьць
безусловность	бязумоўнасьць
безучастие	бязудзельнасьць
безыменность	бязыменнасьць
бережливость	ашчаднасьць
беременность	цяжарнасьць
беречь	сьцерагчы, пiльнаваць, ахоўваць
беспамятство	бяспамяцьце
беспартийный	беспартыйны
беспаспортный	бяспашпартны
беспечность	нядбайнасьць
бесплатность	бясплатнасьць
бесплодность	бясплоднасьць
бесповоротность	беспаваротнасьць, раз назаўсёды
беспокойство	непакой, турбота
беспомощность	поўная слабасьць, бяспомачнасьць
беспорочность	беззаганнасьць
беспорядок	непарадак
беспошлинность	бязмытнасьць
беспощадность	бязьлiтаснасьць
бесправие	бяспраўе
беспрекословие	бясспрэчнасьць
беспрекословный	бясспрэчны
беспрепятственность	бесьперашкоднасьць
беспрепятственный	бесьперашкодны
беспрерывность	бязупыннасьць
беспрестанность	бязупыннасьць
бесприбыльность	беспрыбытковасьць
беспристрастность	бесстароннасьць
беспричинность	бяспрычыннасьць
беспутность	распуства
бессилие	бясьсiльле
бесславие	няслава
бессменность	нязьменнасьць
бессмысленность	бяссэнсовасьць
бессовестность	нясумленнасьць
бессознательность	няпрытомнасьць
бессомненность	пэўнасьць
бесспорность	бясспрэчнасьць
бессрочность	бестэрмiновасьць, бяссрочнасьць
бесстыдство	бясстыдзтва
бестолковость	бесталковасьць
бесхозяйственность	негаспадарлiвасьць
бесчеловечность	бесчалавечнасьць
бесчестие	зьнявага
бесчестность	нячэснасьць
бесчинство	бусаваньне
бесчувственность	няпрытомнасьць
бечевник	паўзрэчак
бешенство	шаленства
библиотека	бiблiотэка
билет	бiлет
биметаллизм	бiмэталiзм
биржа труда	бiржа працы
бирка	бiрка
благодарность	падзяка
благодетель	дабродзей
благодеяние	дабрачыннасьць
благонадежность	добранадзейнасьць
благонамеренность	добры намер
благопристойность	прыстойнасьць
благоприятствовать	спрыяць
благоразумие	разважлiвасьць
благосостояние	дабрабыт
благотворительность	дабрачыннасьць
благоустроенность	упарадкаванасьць, дабраладнасьць
бланк	блянк
блок	блёк
блокада	аблога
блуд	блуд
блудодейство	блудадзейства
блюститель	дазорца
бобыль	бабыль
богатство	багацьце
бойкот	байкот
боковая линия	стрэчная лiнiя
большевизм	бальшавiзм
большинство	большасьць
борьба	змаганьне, барацьба
брак (негодность)	брак
брак	шлюб
брань	лаянка
братоубийство	братазабойства
братство	братэрства
брачный	шлюбны
бред	брэд
бродяга	валацуга, бадзяка
бродяжничество	валацуства, бадзяньне
бросовые земли	нескарыстаныя землi
брошюра	брошура
буйство	буянства
бумага	папера
бумажный	паперавы
бунт	бунт
бухгалтер	бухгальтар
бухгалтерия	бухгальтэрыя
буян	буян
бывший	былы, мiнулы
быт	быт
бюджет	бюджэт
бюлетень	бюлетэнь
бюро	бюро
бюрократизм	бюрократызм
важность	важнасьць
вакансия	ваканцыя
вакантное наследство	вольная спадчына
вакантный	вольны, вакантны
вакация	вакацыя
валовой	валавы, агульны
валюта	валюта
варварство	барбарства
вариант	адменьнiк, варыянт
вахта	варта
введение	уводзiны
вверение	даручэньне
ввод	увод
ввод во владение	перадача на ўладаньне
вводный	уводны
ввоз	увоз
ввозный	увозны
вдова	удава
вдовец	удавец
вдовство	удоўства
въезд	уезд
ведомость	ведамасьць
ведомство	ведамства
векселедатель	вэксалядаўца
векселедержатель	вэксалядзяржаўца
векселеприниматель	вэксаляпрымальнiк
вексель	вэксаль
вексельная бумага	вэксалявая папера
великодержавие	вялiкадзяржаўнасьць
величина	велiчыня
вельможа	магнат
вено	пасаг
веновая запись	пасажны запiс
венчание	шлюб, вянчаньне
вера	вера
вербовать	набiраць
вердикт	прысуд
веритель	даручнiк
верительная грамота	даручная грамата
верность	вернасьць
верование	вераваньне, вызнаваньне
вероисповедание	вызнаньне
вероломство	вераломства
веротерпимость	верацерпнасьць
вероятность	праўдападобнасьць
верхняя палата	верхняя палата
верховенство	вярхоўнасьць
верховная власть	найвышэйшая ўлада
верховное управление	найвышэйшае кiраўнiцтва
верховный суд	найвышэйшы суд
верющее письмо	паўнамоцны лiст
веский	важкi, грунтоўны
весовой	вагавы
вестник	весьнiк
вестовой	пасланец
весы	вага, бязьмен
ветвь	галiна
вехи	тычкi
вечная аренда	чынш, вечная арэнда
вечность	вечнасьць
вещественное доказательство	рэчавы довад
вещество	матэрыя
вещное право	рэчавае права
вещный	рэчавы
вещь	рэч
взаимность	узаемнасьць
взаимоотношение	узаемаадносiны
взаимопомощь	узаемная дапамога
взвешивание	узважваньне
взимание	зысканьне
взлом	узлом
взнос на хранение	адданьне на перахоў
взрослый	дарослы
взрыв	выбух
взыскание	сысканьне, спагнаньне
взыскатель	спаганяты
взыскательность	спаганяльнасьць
взятие	забраньне
взятка	хабар
взяточник	хабарнiк
взяточничество	хабарнiцтва
вид	вiд, выгляд
вид на жительство	вiд на пражываньне
видимость	вiдочнасьць
видовое обязательство	вiдавое абавязаньне
видоизменение	перайначваньне
виза	вiза
визит	вiзыта, адведзiны
вина	вiна, прычына
виновник	вiнавайца
високосный	пераступны
вице-председатель	намесьнiк старшынi
вклад	уклад, фундуш
вкладной	укладны
вкладчик	укладчык, фундатар
включение	уключэньне, улучэньне
включительно	уключна, улучна
включить	уключыць, улучыць
вкратце	каротка
владелец	уладар
владельческий	уладарскi
владение	уладаньне
владетельный	уладарны
владеть	уладаць
властвование	уладарства
властелин	уладар, дзяржаўца
властитель	уладар
властный	уладны
властолюбие	уладалюбства
власть	улада
влечение	цягненьне
влияние	уплыў
вменяемость	прытомнасьць
вменяемый	прытомны
вместимость	зьмяшчальнасьць
вмешательство	умяшаньне
внебрачный	па-зашлюбны (пазашлюбны)
внезапность	раптоўнасьць
внеочередность	нечарговасьць
внесение	здача (падатку)
внесение	паданьне (проекту закону)
внешний	надворны, вонкавы
внешность	надворнасьць
внимание	увага
внимательность	уважлiвасьць
внимательный	уважлiвы
вноска	дапiска
внук	унук
внутренность	нутро
внутриселенное землеустройство	унутрыпасельнае зямляўпарадкаваньне
внушение	намова, навядзеньне
внятность	выразнасьць
вовлечение	уцягненьне
во-время(вовремя)	упору
во главе	на чале
водворение	усяленьне
водный путь	водны шлях
воевода	ваявода
воеводство	ваяводзтва
военнопленный	ваеннапалонны
военнослужащий	вайсковец
военный	вайсковы, ваенны
возбудитель	узбуджальнiк
возбудительность	узбуджальнасьць
возбуждение	узбуджэньне
возбуждение дела	падняцьце справы
возведение (построек)	пабудаваньне
возвещение	апавяшчэньне
возврат	зварот, зьвярненьне
возвращение	зварот, аддача
возвышение наказания	павышэньне кары
воздействие	уплыў
возделывание	абрабляньне
воздушный	паветраны
воззвание	адозва
воззрение	погляд
возложение	даручэньне
возмездие	адплата
возместить	сплацiць
возмещение	адплата
возможность	мажлiвасьць, магчымасьць
возмужалость	памужнеласьць
возмутительный	абурлiвы
возмущать	абураць
возмущение	абурэньне
вознаграждение	узнагарода
возникновение	вынiкненьне
возобновить	аднавiць
возобновление	аднаўленьне
возражать	пярэчыць
возражение	пярэчаньне
возраст	век, узрост
возрастание	узрастаньне
возрастный	узросны
возрождение	адраджэньне
воссоединение	злучэньне
воинская повинность	вайсковая павiннасьць
воинский	вайсковы
война	вайна
волнение	узбурэньне
волокита	валакiта, цяганiна
волость	воласьць
вольнонаемный	вольнананяты
вольность	вольнасьць
воля	воля
воображаемый	выабражальны
вооружение	узбраеньне
вопреки	наперакор
вопрос	пытаньне
вор	злодзей
воровской	зладзейскi
воровство	крадзеж
воспитание	выхаваньне
воспитанник	выхаванец
воспитатель	выхаваўца
воспитательный дом	выхаваўчы дом
воспрепятствовать	перашкодзiць
воспрещать	забараняць
воспрещение	забарона
восприимчивость	успрымальнасьць
восприятие	успрыманьне
воспроизведение	аднаўленьне
восстание	паўстаньне
восстановление	адбудаваньне, аднаўленьне
востребование	запатрабаваньне
вотчина	бацькаўшчына
впечатление	уражаньне
впечатлительность	уражлiвасьць
вписание	упiска
вражда	сварка, варожасьць, злосьць
враждебность	варожасьць
враждебный	варожы
враждовать	сварыцца
вразумление	уразумленьне
врач	доктар, лекар
врачебный	лекарскi
вред	шкода
вредитель	шкоднiк
вредность	шкоднасьць
временный	часовы
время	час, пара
врожденность	прыроджанасьць
вручение	уручэньне
всеобщий	усеагульны
выборщик	выбiральнiк
вскрытие	раскрыцьце
вспомогательный	дапаможны
вспоможение	дапамога
вспыльчивость	запальчывасьць
вспышка	запал
вставка	дапiска
встречный	сустрэчны
вступительный	уступны
вступление	уступленьне
вторжение	уварваньне
вход	уваход, увойсьце
входной	уваходны
входящий журнал	журнал прынятых папер
вхождение	уваход
выбирать	выбiраць
выборка	выбарка
выборный	выбарны
выборщик	выбiральнiк
выборы	выбары
выбытие	выбыцьце
выведывание	выведваньне
вывеска	вывеска
вывод	вывад, вынiк
вывоз	вываз
выговаривать	выгаварваць
выговор	выгавар
выгода	выгада, карысьць
выгодность	выгаднасьць
выгодоприобретатель	выгаданабыўца
выгон	выган
выдача	выдача
выдающийся	выдатны
видвиженец	вылучэнец
выдел	выдзел
выделение	выдзяленьне
выдержка	вынятка
выезд	выезд
выемка	выняцьце
вызов	позва
вызовное производство	пазыўнае справавядзеньне
вызывать	выклiкаць
выигрыш	выгрыш
выкидывание	выкiданьне
выкидыш	выкiдак
выключать	выключаць, вылучаць
выключение	выключэньне, вылучэньне
выкуп	выкуп
выкупной	выкупны
выманивание	выманьваньне
выменивание	выменьваньне
выметка	выметка
вымогатель	зьдзiрца
вымогательство	зьдзiрства
выморочное имущество	адмерлая маемасьць
вымысел	выдумка
выноска	вынаска
вынуждать	вымушаць
вынужденный	вымушаны
выпись	выпiс
выплата	выплата
выполнение	выкананьне
выправление	выпраўленьне
выпуск	выпуск
выпускной	выпускны
выработок	выработак
выражение	выражэньне
вырытие	адкапаньне
выселение	высяленьне
выселок	выселак
выслуга	выслуга
выставка	выстаўка
выступление	выступленьне
высшее учебное заведение	вышэйшая школа
высылка	высылка
выход	выхад
выходец	выхадзец
выходной день	дзень адпачынку
вычет	вылiк
вычитать	вылiчаць
вышеозначенный	зазначаны вышэй
вышеупомянутый	вышэйпамянёны
галлюцинация	здань
гарантия	гарантыя
генеральный	генэральны
герб	гэрб
гербовый сбор	гэрбавы збор
гибель	пагiбель
гильдия	гiльдыя
глава	разьдзел
главная книга	галоўная кнiга
гласность	публiчнасьць
глумиться	глумiцца
глумление	глумленьне
глухонемой	глуханямы
гнев	гнеў
гнет	уцiск
годность	годнасьць
годный	годны
годовщина	гадавiна
головной	галоўны
голос	голас
голословность	галаслоўнасьць
голосование	галасаваньне
гонец	ганец, пасланец
горнопромышленность	горная прамысловасьць
горный	горны
городской	гарадзкi
горожанин	мястовец
госпиталь	шпiталь
господский	панскi
господство	панаваньне
гостиница	гасьцiнiца
государственный	дзяржаўны
государство	дзяржава
грабеж	грабеж, рабунак
грабитель	грабежнiк, рабоўнiк
гражданин	грамадзянiн
гражданский	грамадзянскi
гражданский иск	грамадзянскi iск
гражданское судопроизводство	грамадзянскае судавядзеньне
гражданственность	грамадзянскасьць
гражданство	грамадзянства
грамота	грамата
грамотность	пiсьменнасьць
грамотный	пiсьменны
граница	гранiца, мяжа
граничить	гранiчыць, межаваць
графа	графа
график	графiк
гроб	труна
громоздкость	грамоздкасьць
грубить	грубiянiць
грубиян	грубiян
грубость	грубасьць
груз	цяжар, груз
грузовой	цяжаравы
грунт	грунт
группа	група
группировать	групаваць
группировка	групаваньне
губерния	губэрня
губительство	згуба
гуж	гуж
гурт	гурт
давность	даўнасьць
дальний	далёкi
данный	дадзены, даны
дар	дар
дарение	дарэньне
дарование	дараваньне
даровитый	здатны
даровой	падараваны
даром	дарма
дарственная запись	даравальны запiс
дата	дата
дача	дача
движение	рух
движимость	рухомасьць
движимый	рухомы
двоебрачие	двушлюбнасьць
двоеженство	двужонства
двойной	падвойны
двойня	блiзьняты, блiзьнюкi
двойственность	падвойнасьць
двор	двор, сельская гаспадарка
дворец	палац
дворник	дворнiк
дворовый	дваровы
дворянин	дваранiн, шляхцiц
дворянство	дваранства, шляхецтва
двоюродный брат	стрэчны брат
двоякий	дваякi
двукратный	двухразовы
двусторонний	двухбаковы
дебет	дэбэт
девальвация	дэвальвацыя
девер	дзевер
девиз	дэвiз
девица	дзеўчына
девственность	дзявоцтва
дед	дзед
дееспособность	дзеяздольнасьць
дежурство	дзяжурства
дезертир	дэзэртыр
дезорганизация	разлад, дэзорганiзацыя
дезорганизованность	разладзьдзе, дэзорганiзаванасьць
действие	чыннасьць, учынак
действительно	сапраўды
действительность	сапраўднасьць
действительный член	правадзейны член
действовать	дзейнiчаць, дзеяць
декларация	дэклярацыя
декрет	дэкрэт
делегация	дэлегацыя
деление	падзел
дележ	дзяльба
делимость	падзельнасьць
делимый	падзельны
дело	справа
деловой	дзелавы
делопроизводитель	дзелавод, справавод
делопроизводство	дзелаводзтва, справаводзтва
демаркационная линия	дэмаркацыйная лiнiя
демократический	дэмократычны
демократия	дэмократыя
демонстрация	дэмонстрацыя
денежное взыскание	спагнаньне грошай, штраф
деноминация	дэномiнацыя
деньги	грошы
департамент	дэпартамант
депозит	дэпозыт
депутат	дэпутат
депутация	дэпутацыя
держава	дзяржава
державность	дзяржаўнасьць
державный	дзяржаўны
держание	трыманьне
держатель	дзяржаўца
дерзость	дзёрзасьць
деспот	дэспот
деспотизм	дэспотызм
деспотия	дэспотыя
десятина	дзесяцiна
десятник	дзесятнiк
деталь	драбнiца, дэталь
детоубийство	дзетагубства
детский дом	дзiцячы дом
детство	дзяцiнства
дефект	ганьба, недахват
дефективность	дэфэктыўнасьць
дефицит	недастача, дэфiцыт
деяние	дзеяньне, учынак
деятель	дзеяч
деятельность	дзейнасьць, чыннасьць
дивидент	прыбытак, дывiдэнт
диктатор	дыктатар
динамика	дынамiка, рух
динамический	дынамiчны
диплом	дыплём
дипломат	дыплёмат
дипломатический корпус	дыплёматычны корпус
директива	дырэктыва
директор	дырэктар
директория	дырэкторыя
дисконт	адлiчэньне, дысконт
дисконтировать	адлiчаць, дысконтаваць
дискуссия	дыскусiя
диспут	дыспут
дисциплина	дысцыплiна, парадак
дисциплинарный	дысцыплiйны, карны
добавка	дабаўка
добавление	дадатак, дабаўленьне
добавочный	дадатковы
добровольный	дабравольны
добродетель	дабрачыннасьць
добросовестность	сумленнасьць
добыча	здабыча
доведение	давядзеньне
доверенность	даверанасьць
доверенный	давераны
доверие	вера
доверитель	давернiк
довершение	давяршэньне
доверять	верыць
довод	довад
довольствие	харчаваньне, утрыманьне
догадка	дагадка
догматический	догматычны
договор	дагавор, умова
договорный	дагаворны, умоўны
дозволение	дазвол, дазваленьне
дозволенный	дазволены
дозволительный	дазвольны, дапушчальны
дознание	дазнаньне
дозор	дазор, дагляд
доискивать	дашукваць
доказательство	довад
доклад	даклад
докладная записка	дакладная запiска
докладчик	дакладчык
документ	дакумант
долг	доўг, абавязак
долговой документ	даўгавы дакумант
долевой	долевы
должник	даўжнiк
должность	пасада
должностное лицо	службовая асоба
должный	павiнны
доля	доля, частка
домашний договор	хатнi дагавор
домовладелец	дамаўласьнiк
домогательство	дамаганьне
донесение	данясеньне
донос	уданьне, данос, навод
доноситель	даносьнiк
доносчик	даносьнiк
доплата	даплата
доплатной	даплатны
дополнение	дапаўненьне, дадатак
дополнительный	дадатковы
допрашивать	выпытваць
допризывник	дапрызыўнiк
допрос	выпыт, допыт
допускать	дапушчаць, дазваляць
допущение	дапушчэньне, дазваленьне
дороговизна	дарагоўля
дорожный	дарожны, шляхавы
досаждать	дакучаць
доследование дела	дасьледваньне справы
дословный	лiтаральны, даслоўны
досмотр	дагляд
досмотрщик	даглядчык
досрочный	дасрочны, датэрмiновы
доставка	дастаўка
достаток	дастатак
достаточное основание	выстарчальная падстава
достаточность	выстарчальнасьць
достаточный	выстарчальны
достижение	дасягненьне
достоверность	пэўнасьць, верагоднасьць
достоинство	гонар, годнасьць
доступ	доступ
доступность	даступнасьць
доход	даход, прыбытак
доходный	даходны, прыбытковы
дочь	дачка
драгоман	тлумач, перакладчык
драгоценность	каштоўнасьць
драка	бойка
древний	старажытны
древность	старажытнасьць
дробный	дробны
дряхлость	друзласьць
дубликат	дублiкат
духовное завещание	духоўнiца
духовный	духоўны
душевная болезнь	душэўная хвароба
душевнобольной	душэўнахворы
душеприказчик	выканавец духоўнiцы
дуэль	паядынак, дуэль
дядя	дзядзька
единица	адзiнка
единобрачие	аднашлюбнасьць
единовластие	аднаўладзьдзе
единогласие	аднагалосьсе
единокровный	аднакроўны
единоличный	аднаасабовы
единоначалие	аднаначальнасьць
единообразие	аднастайнасьць
единость	адзiнасьць
единоутробный	адналонны, аднаўтробны
единственный	адзiны
единство	адзiнства
ежегодный	штогодны
ежедневный	штодзенны
ежемесячник	штомесячнiк
естественное право	прыроднае права
жалоба	скарга, жальба
жалобщик	жальбiт
жалованье	пэнсiя, заработак
желание	жаданьне
жена	жонка
женитьба	жанiцьба
женщина	жанчына, кабета
женский	жаночы
жертва	афяра
жестокое обращение	лютае абхаджэньне
жестокость	лютасьць
жетон	жэтон
животное	жывёлiна
жилище	жылiшча
жилищный	кватэрны
житель	жыхар, насельнiк
жительство	пражываньне
жребий	жэрабя
журнал	часопiс, журнал
журналист	часапiсец, журналiсты
забастовка	забастоўка
забвение	забыцьцё
заблуждение	заблуджэньне
заборная книжка	наборная кнiжка
забота	клопат
заботиться	клапацiцца
заботливый	клапатлiвы
забронировать	замацаваць, забясьпечыць
заведение	заклад
заведение дела	завядзеньне справы
заведывание	загадваньне
заведывающий	загадчык, кiраўнiк
завещание	духоўнiца, адказаньне, тэстамант
завещатель	адказальнiк, тэстатар
зависимость	залежнасьць
зависть	зайздрасьць
завладение	заўладаньне
завод	завод
заговор	змова
заговорщик	змоўца
заготовка	загатоўка
заготовление	загатаўленьне
заграничный	загранiчны
загрязнять	забруджваць
задаток	задатак
задача	заданьне, задача
задержание	затрыманьне
задержка	задзержка, затрыманьне
задолженность	задоўжанасьць
заем	пазычка
заемное письмо	пазычковы лiст
заемщик	пазычковец
заимка	заiмка
заимствовать	запазычаць
заимодавец	пазычкадавец
заимообразно	пазычкова
заинтересованность	зацiкаўленасьць
закабалить	заняволiць
заказ	заказ
заказное письмо	заказны лiст
заказчик	заказчык
заклад	застава
закладной	застаўны
заключение (брака, дела)	заключэньне (шлюбу, справы)
заключение (лишение свободы)	зьняволеньне
заключенный	зьняволены
заключительное объяснение	заключальнае аб'ясьненьне
закон	закон
законная оборона	законная абарона
законность	законнасьць
законодатель	законадаўца
законодательство	законадаўства
закономерность	законамернасьць
закрепление	замацаваньне
закрытие	закрыцьце
закупка	закупка
зала	саля
залог	залог
залоговой	залогавы
залоговое свидетельство	залогавае пасьведчаньне
залогодатель	залогадаўца
залогодержатель	залогадзяржаўца
залогоприниматель	залогапрымальнiк
замена	замена
заместитель	намесьнiк
заметка	заметка
замечание	увага
замешательство	замяшаньне
замещение	замяшчэньне
замужество	замуства
замысел	замысел
занятие	заняцьце
заочный приговор	завочны прыгавор
запальчивость	запальчывасьць
запас	запас
запасной	запасны
запашка	заворка
запирательство	адраканьне
запись	запiс
заповедный	ахоўны
запретительная статья	забаронны артыкул
запрещение	забарона
запрещенная игра	забароненая iгра
запродажа	запродаж
запрос	запытаньне
заработная плата	заработная плата
заработок	заработак
зараза	зараза
заражение	заражэньне
зародыш	зародак
засада	засада
засвидетельствование	засьведчаньне
заседание	пасяджэньне
заседатель	асэсар, засядаталь
заслуга	заслуга
застава (рогатка)	застава
застой	застой
застраховать	застрахаваць
застройка	забудоўка
заступник	абаронец, заступнiк
заступничество	заступнiцтва
затронуть	закрануць
затруднение	затрудненьне
захват	захват
зачеркнуть	закасаваць
зачет	залiк, залiчэньне
зачинщик	ушчыншчык
защита	абарона
защитник	абаронец
защитный лес	заслонны лес
заявка	заяўка
заявление	заяўленьне
заявочные знаки	капцы
звание	годнасьць
звонкая монета	звонкая монэта
здание	будынiна
здравоохранение	ахова здароўя
земельный	зямельны
землевладение	зямляўладаньне
землевладелец	зямляўладар
земледелец	рольнiк, земляроб
земледелие	рольнiцтва, земляробства
землемер	каморнiк
землепользование	зямлякарыстаньне
землесобственник	зямляўласьнiк
землеустройство	зямляўпарадкаваньне
землеустроитель	зямляўпарадчык
земский	земскi
земство	земства
зло	зло
злоба	злосьць
злонамеренность	злонамернасьць
злостность	злоснасьць
злоумышленник	злоўмысьленьнiк
злоупотребление	злоўжываньне
знак	знак
знамя	сьцяг, штандар
знание	веда
значение	значэньне
значительность	значнасьць
золотая валюта	залатая валюта
зрелость	даросласьць
зять	зяць
игра	iгра, гульня
иждивенец	утрыманец
иждивение	утрыманьне
избавление	вызваленьне, збавеньне
избиение	пабiцьцё
избиратель	выбiральнiк
избирательный	выбiральны
избирать	выбiраць
избрание	выбраньне
избыток	лiшак
известие	вестка
известность	вядомасьць
известный	вядомы, пэўны
извещение	паведамленьне
извинение	выбачэньне
извлечение прибыли	вызысканьне прыбытку
извоз	возьнiцтва
изгнание	выгнаньне
изгнание плода	выгнаньне плоду
изгнанник	выгнаньнiк
изготовление	выраб
издание	выданьне
издатель	выдавец
издательский	выдавецкi
издательство	выдавецтва
издевательство	зьдзекваньне
издержки	выдаткi
излишек	лiшак
изложение	выклад
измена	зрада
изменение	зьмена
изменник	зраднiк
изменчивость	зьменнасьць
изнасилование	згвалтаваньне
изношенность	зношанасьць
изобличение	высьведчаньне
изображение	адбiтак
изобретение	вынаходка
изоляция	адасабленьне, iзоляцыя
изувечить	абязьвечыць
изуродовать	ашпэцiць
изучение	вывучэньне
изыскание	вышуканьне
изъятие	вынятак, выняцьце, вылучэньне
изъять	выключыць
имение	маемасьць
именно	iменна
именной	iменны
имущество	маемасьць
имя	iмя
инвалид	iнвалiд
инвентарь	iнвэнтар
иностранец	чужаземец
иностранный	чужаземны
инстанция	iнстанцыя
институт	iнстытут
институция	установа, iнстытуцыя
инспектор	iнспэктар
инспекция	iнспэкцыя
инструктор	iнструктар
инструкция	iнструкцыя
инструмент	струмант
интерес	iнтэрас
интернат	iнтэрнат
интернационал	iнтэрнацыянал
интрига	iнтрыга
ипотека	гiпотэка
иск	iск
искать	шукаць
исключать	выключаць
исключение	выключэньне
исключительное положение	выключнае палажэньне
исключительность	выключнасьць
исковое прошение	iскавая просьба
ископаемый	выкапак
искусственность	штучнасьць, ненатуральнасьць
искусственный	штучны, ненатуральны
исполнение	выкананьне
исполнительное производство	выканаўчае справаводзтва
исполнительность	спраўнасьць
исполнительный лист	выканальны лiст
использование	скарыстаньне
исправительный дом	папраўчы дом
исправление	выпраўленьне
исправлять	выпраўляць, спраўляць
исправность	спраўнасьць
испытание	спроба
испытательный	выпрабавальны (тэрмiн)
исследование	дасьледваньне
исследовать	дасьледваць
истец	iсьцец
истина	iсьцiна
истолковать	вытлумачыць
источник	крынiца
истязание	мардаваньне
исход дела	вынiк справы
исходящий (№)	выхадны (№)
исчисление	вылiчэньне
кабак	шынок, карчма
кабала	кабала, няволя
кабальная сделка	кабальная ўгода
кабинет	габiнэт
кабинетный	габiнэтны
каботаж	каботаж
кадастр	зямельны перапiс
казарма	казарма
казенный	скарбовы
казна	скарб
казначей	скарбнiк
казначейство	скарбнiца
казнь	кара сьмерцю
казус	выпадак, казус
календарь	каляндар
камера	камэра
кандидат	кандыдат
каникулы	вакацыя, вакацыi
канитель	валакiта
канцелярия	канцэлярыя
капитал	капiтал
капитализация	капiталiзацыя
капиталист	капiталiсты
капитальный	грунтоўны
капитулярное право	капiтулярнае права
капитуляция	капiтуляцыя
карантин	карантына
караул	варта, каравул
карта	карта
картели	картэлi
карты игральные	карты iгральныя
касса	каса
кассация	касацыя
кассир	касiр
кассовая книга	касавая кнiга
каталог	кнiгасьпiс, каталёг
категория	катэгорыя
каторга	катарга
каторжник	катаржнiк
каторжные работы	катаржныя работы
кафедра	катадра
квартал (час)	квартал
квартира	кватэра
квитанция	квiток
клад	клад, скарб
кладбище	могiлкi
кладовая	камора
кладовщик	каморны
клас (общ.)	кляса
клевета	паклёп, абмова
клеветник	паклёпнiк, абмоўнiк
клеймение	кляймаваньне
клеймо	кляймо, знак
клиент	клiент
клуб	клюб
клятва	кляцьба
клятвопреступник	вераломнiк
книга	кнiга
кодекс	кодэкс
кодификатор	кодыфiкатар
кодификация	кодыфiкацыя
колдовство	чараўнiцтва, вядзьмарства
колебание курса	хiстаньне курсу
колено	калена
количество	колькасьць
коллегия	калегiя
коллектив	суполка, колектыў
коллективизм	супольнiцтва, колектывiзм
коллективная собственность	супольная ўласнасьць
коллизия	стычнасьць, колiзiя
колонизатор	колёнiзатар
колонизация	колёнiзацыя
колонист	колёнiсты
колония	колёнiя
командировка	командыроўка
комендант	комэндант
комивояжер	комiвояжэр
комиссар	камiсар
комиссариат	камiсарыят
комиссионер	комiсiянэр
комиссия	камiсiя
комитет	камiтэт
коммерция	комэрцыя
коммерческий суд	комэрцыйны суд
коммуна	комуна
коммунизм	комунiзм
компания	компанiя
компаньон	компаньён, супольнiк
компенсация	адплата, адшкадаваньне
компенсировать	адплачваць
компиляция	компiляцыя
комплект	комплект
комплектовать	комплектаваць
конвенция	конвэнцыя
конверсия	конвэрсiя
конвоир	канваiр
конвой	канвой
конгресс	конгрэс
кондиция	умова, кондыцыя
конкурент	конкурэнт
конкуренция	конкурэнцыя
конкурс	конкурс
конокрад	канакрад
коносамент	коносамэнт
консолидация	усталяваньне
конспирация	консьпiрацыя
конституция	констытуцыя
конструкция	пабудова, конструкцыя
консул	консул
консульство	консульства
консультация	парада, консультацыя
контора	кантора
конторская книга	канторская кнiга
контрабанда	контрабанда
контрабандист	контрабандысты
контракт	кантракт
контрассигнование	замацаваньне
контрреволюция	контррэволюцыя
контрибуция	контрыбуцыя
контролер	контролёр
контроль	контроль
контромарка	контрамарка
конфедерация	конфэдэрацыя
конференция	конфэрэнцыя, нарада
конфискация	конфiскацыя
конфликт	конфлiкт
концентрация	концэнтрацыя
концессия	концэсiя
кооператив	коопэратыў
кооперация	коопэрацыя
копия	копiя
кордон	кардон
коренной подел	грунтоўны падзел
кормилец	кармiцель
кормилица	мамка
кормовые деньги	харчовыя грошы
корневая стоимость	карнявая вартасьць
корпорация	корпорацыя
корпус	корпус
корректор	корэктар
корректура	выпраўка, корэктура
корреспонденция	допiс
корыстолюбие	хцiвасьць
корысть	карысьць
косвенный	пасрэдны
косвенный налог	пасрэдны падатак
кощунство	блюзьнерства, сьвятазьнявага
краденая вещь	крадзеная рэч
кража	крадзеж
крайняя необходимость	канечная патрэба
красноармеец	чырвонаармеец
красноречие	красамоўства
красный	чырвоны
кредит	павер, крэдыт
кредитив	крэдытыў
кредитная операция	крэдытная опэрацыя
кредитные бумаги	крэдытныя паперы
кредитор	павернiк, крэдытар
кредитоспособность	крэдытаздольнасьць
крепость	крэпасьць
крестьянин	селянiн
крестьянский	сялянскi
кризис	пералом, крызiс
криминалист	крымiналiсты
кровосмешение	кровазьмяшэньне
круглый сирота	круглы сiрата
круговая ответственность	кругавая адказнасьць
кружок	гурток
крупное производство	вялiкi выраб
крупный	буйны
культивировать	культываваць
культура	культура
купец	купец
купечество	купецтва
купля-продажа	купля-продаж
купон	купон
купчая крепость	купчая крэпасьць
курс	курс
курсы	курсы
курьер	кур'ер, пасланец
кустарь	саматужнiк
лавка	крама
лавочка	крамка
лавочник	крамнiк
легализация	узаканеньне, легалiзацыя
легкомыслие	лёгкамыснасьць
ленность	леннасьць
лесной сторож	лясьнiк, стражнiк
лесонарушение	лесапарушэньне
лжесвидетель	крывасьведка
лжесвидетельство	крывасьведзтва
лживость	iлжывасьць
лига	лiга
лигатура	лiгатура
ликвидация	лiквiдацыя
лимит	лiмiт
линия родства	лiнiя сваяцтва
лист	аркуш
лист закладной	лiст закладны
лист окладной	лiст акладны
литературная собственность	лiтаратурная ўласнасьць
лицензия	лiцэнзiя
лицо, личность	асоба, пэрсона
лицо физическое	фiзычная асоба
лицо юридическое	асоба юрыдычная
личная обида	асабiстая крыўда
лично	асабiста
личное задержание	асабiстае затрыманьне
личное обязательство	асабiсты абавязак
личный	асабовы
личный наем	асабiстыя наймы
лишение	пазбаўленьне
логическое толкование	лёгiчнае тлумачэньне
ложное показание	фальшывае паказаньне
ложные слухи	фальшывыя чуткi
ложный	фальшывы
ложь	мана, лганьнё
локаут	лёкаут
ломбард	лёмбард
лотерея	лётэрэя
любитель	аматар
магазин	магазын
магазинная книга	магазынавая кнiга
маклер	маклёр
маклерство	маклёрства
малоземельность	малазямельнасьць
малоимущий	незаможны
малолетний	малалетнi
малолетство	малалецтва
мандат	мандат
манифест	манiфэст
мародер	марадзёр
мародерство	марадзёрства
маршрут	падарожня
масса	маса
мастер	майстар
мастеровой	рамесьнiк
мастерская	майстэрня
материал	матар'ял
материальный	матар'яльны
мачеха	мачаха
мгновение	мiг, iмгненьне
мебелированная комната	мэбляваны пакой
медаль	мэдаль
медленность	павольнасьць
межа	мяжа
междоусобие	мiжусобiца
междуведомственный	мiжведамсьцьвены
международный	мiжнародны
междуселенный	мiжпаселiшчны
межевание	межаваньне
межевой план	межавы плян
мелиорация земель	асушка зямель
мелкий кредит	дробны павер
мелочная торговля	дробны гандаль
меморандум	мэморандум, напамiнак
мемориал	памятка, мэморыял
меньшинство	меншасьць
мертвец	мярцьвец
мертворожденный	няжывы ад роду
мертвый капитал	нескарыстаны капiтал
мена	мена
меняльная контора	мяняльная кантора
мера (веса)	мерка
мера наказания	мера кары
мероприятие	мерапрыемства
меры	захады
местный	мясцовы
место	месца
местожительство	месцапражываньне
местопребывание	месца побыту
месть	помста
метод	мэтод
метрика	мэтрыка
мещанин	мешчанiн
мздоимство	хабарнiцтва
милиция	мiлiцыя
милость	ласка
министерство	мiнiстэрства
министр	мiнiстар
минута	мiнута
мир (покой)	спакой
мир (свет)	сьвет
мировая сделка	мiравая ўгода
мировое соглашение	мiравая згода
мировой судья	мiравы судзьдзя
мирской капитал	грамадзкi капiтал
миссия	мiсiя, даручэньне
мнение	зданьне, пагляд
мнимая сделка	несапраўдная ўгода
многочисленность	многалiкасьць
множество	мноства
мобилизация	мобiлiзацыя
могущество	магутнасьць
модус	спосаб, норма, модус
молодежь	моладзь
молчание	маўчаньне
монета	монэта
монометализм	мономэталiзм
монополия	монополiя
мораль	мораль
мот	марнатратнiк
мотовство	марнатрацтва
мошенник	машэльнiк, ашуканец
мошенничество	машэльнiцтва
мощность	магутнасьць
муж	муж
мучение	мука, пакута
мучительство	мучэньне
мысль	мысьль, думка
мятеж	мяцеж
мятежник	мяцежнiк
наблюдатель	наглядальнiк
наблюдать	назiраць, наглядаць
наблюдение	назiраньне, нагляд
навлекать	наводзiць
наводнение	паводка
наговор	намова
награда	нагарода
нагрузка	нагрузка
надбавка	надбаўка
надел	надзел
надзиратель	наглядальнiк
надзор	нагляд
надлежащий	належны
надобность	патрэба
надпись	надпiс
надсмотрщик	даглядач
надувать	ашукваць
наемник	наймiт
наемный труд	наёмная праца
нажива	нажыва
назначение	прызначэньне, вызначэньне, назначэньне
наименование	назва
наказ	наказ
наказание	кара
накладная	накладная
наличие	прысутнасьць
наличный капитал	гатовы капiтал
налог	падатак
наложение	наклад
наложенный платеж	накладная плата
намерение	намер
наместник	намесьнiк
наниматель	наймальнiк
нанос	нанос
нападение	напад
народ	народ
народность	народнасьць
народный	народны
народовластие	народаўладзтва
направление	кiрунак
направлять	накiроўваць
напряжение	натуга, напружэньне
нарочный	наўмысны пасланец
нарушение закона	нарушэньне закону
наряд	нарад
население	насяленьне
насилие	гвалт
насильственный	гвалтоўны
наследие	спадчына
наследование	спадкаёмства
наследователь	спадчынаёмец
наследодатель	спадчынадавец
наследственность	пераймальнасьць
наследство	спадчына
настойчивость	настойнасьць
настольный реестр	настольны запiс
настоятельно	настойлiва
настоящий	сапраўдны, сучасны
натуральная повинность	натуральная павiннасьць
научный	навуковы
находка	знаходка
национализация	нацыяналiзацыя
национальность	нацыянальнасьць
начало	аснова, пачатак
начальник	начальнiк
начет	налiчэньне
неблагонадежность	ненадзейнасьць
небрежность	нядбайнасьць
неведение	няведаньне
невежество	цямнота
невеста	нявехна
невестка	нявестка
невинноосужденный	бяз вiны засуджаны
невменяемость	няпрытомнасьць
невнимательность	няўважлiвасьць
невозможность	немагчымасьць
невыгодный	нявыгадны
невыполнение	неспаўненьне, невыкананьне
негодность	нягоднасьць
неграмотность	няпiсьменнасьць
недвижимое имущество	нярухомая маемасьць
недвижимость	нярухомасьць
недвижимый	нярухомы
недействительность	несапраўднасьць
неделимость	непадзельнасьць
недобор	недабор
недобросовестность	нясумленнасьць
недобросовестный	нясумленны
недовольство	нездаваленьне
недоимка	нядоiмка
недоказанность	недаведзенасьць
недонесение	непаведамленьне
недоразумение	непаразуменьне
недостаток	недахват, недастача, загана, ганьба
недоступность	недаступнасьць, няпрыступнасьць
недочет	недалiк, недахват
недра земли	нетры зямлi
независимость	незалежнасьць
незаконность	незаконнасьць
незаслуженный	незаслужаны
незначительность	нязначнасьць
незыблемость	непарушнасьць
неизбежность	неадхiльнасьць
неизвестность	невядомасьць
неизменность	бязьзьменнасьць
неисправность	няспраўнасьць
нейтралитет	неўмяшаньне, нэйтралiтэт
нейтральность	нэйтральнасьць, неўмяшальнасьць
нелегальность	незаконнасьць, нелегальнасьць
немедленно	безадкладна
ненарушимый	непарушны
ненужный	непатрэбны
необеспеченный	незабясьпечаны
необходимая оборона	патрэбная абарона
необходимость	неабходнасьць
необыкновенный	нязвычайны
необязательный	неабавязковы
неограниченный	неабмежаваны
неоднократный	шматразовы
неожиданно	неспадзеўкi, неспадзявана, нечакана
неопределенность	няпэўнасьць
неопровержимость	неабвержнасьць
неосмотрительность	неабачлiвасьць
неосновательность	беспадстаўнасьць
неоспоримость	бясспрэчнасьць
неосторожность	неасьцярожнасьць
неотвратимость	неадхiльнасьць
неотъемлемый	неадоймлiвы
неплатеж	нявыплата, неаплата
неповиновение	непакорнасьць
непозволительный	недазволены
неполная собственность	няпоўная ўласнасьць
неполнота закона	няпоўнасьць закону
непосредственно	беспасрэдна
неправое владение	бяспраўнае ўладаньне
неправота	неправата
непреодолимая сила	непераможная сiла
непрерывно	бесьперарыву
неприкосновенность	недатыкальнасьць
непричастность	недачыненьне, недатычнасьць
неприятель	вораг, непрыяцель
непроизводительность	непродукцыйнасьць
неработоспособность	няздольнасьць да работы
неравенство	няроўнасьць
нерадение	нядбальства
нераздельное имущество	непадзельная маемасьць
нераздельность	непадзельнасьць
неразрывность	неразрыўнасьць
несвоевременность	несваячаснасьць
несение обязанностей	нясеньне абавязкаў
несовершеннолетний	недалетнi, недалетак
несогласие	нязгода
несогласованность	няўзгодненасьць
несознательность	несьвядомасьць
несомненность	пэўнасьць
несоответствие	неадпаведнасьць
несостоятельность	немаемнасьць, беспадстаўнасьць, няздольнасьць
неспособность	няздольнасьць
несправедливость	несправядлiвасьць
несчастный случай	няшчасны выпадак
нетрудоспособность	няздольнасьць да працы
неуважение	непашана
неудача	няўдача
неуклонность	няўхiльнасьць
неустой	няўстойка
неустойчивость	хiсткасьць
нечаянность	неспадзеўнасьць
неявка	няяўка, адсутнасьць
нисходящая линия	зыходная лiнiя
новое обстоятельство	новая акалiчнасьць
норма	норма
нормальная цена	нормальная цана
нормирование	нормаваньне
нотариальный	нотарыяльны
нотариус	нотариус
нужда	патрэба, бядота
обвес, обмер	недавага, недамер
обвинение	абвiнавачаньне
обвинитель	абвiнаваўца
обвинительный	абвiнавальны
обвиняемый	падвiноўны
обвинять	абвiнавачваць
обдуманное намерение	абдуманы намер
обдуманность	абдуманасьць
обезображение	ашпэчаньне
обезоружение	разбраеньне
обеспечение	забесьпячэньне
обеспечивать	забясьпечваць
обжалование	абжальваньне, абскарджаньне
обжаловать	абжалiць, абскардзiць
объединение	аб'яднаньне
объект	прадмет, об'ект
объективный	об'ектыўны
обещание	дэкляраваньне, абяцанка
обзаведение	абзавядзеньне
обзор	агляд
обида	крыўда
обидчик	крыўдзiцель
обиженный	пакрыўджаны
областной	краёвы
область	край
облегчение	палёгка
облигация	облiгацыя
облик	аблiчча
обложение	абкладаньне
обман	ашуканства
обманщик	ашуканец
обнародование	абнародваньне
обнаружение	выяўленьне, выкрыцьце
обновление	паднаўленьне
обобществление	аграмаджаньне
обогащение	абагачэньне
обозначение	абазначэньне
обозрение	агляд
обольститель	спакусiцель
обольщение	спакуса
оборона	абарона
оборот	зварот
оборотный капитал	зваротны капiтал
оборудование	абсталяваньне
обоснование	абгрунтаваньне
обоснованность	абгрунтованасьць
обособленность	адлюдненасьць, абасобленасьць
обрабатывать	абрабляць, апрацоўваць
обработка	апрацоўка
образец	узор
образование	адукацыя
образованность	адукаванасьць
образовательный	асьветны
образовать	утварыць
обратный	адваротны
обращаемость	зваротнасьць
обращаться	зварочвацца
обращение	зварот, зварачэньне
обряд	царамонiя, абрад
обрядность	абраднасьць
обследование	абсьледваньне
обстановка	абставiна
обстоятельный	грунтоўны
обстоятельство	акалiчнасьць
обсуждение	абмеркаваньне
обувь	абутак
обусловить	абумовiць
обучение	навучаньне
общегосударственный	агульнадзяржаўны
общедоступный	агульнадаступны
общее имущество	супольная маемасьць
общее собрание	агульны сход
общежитие	iнтэрнат
общение	яднаньне, зносiны
общественность	грамадзкасьць
общественный	грамадзкi
общество (земельное)	грамада
общество (общественное мнение)	грамадзянства
общество (уставное)	таварыства
общий	агульны, супольны
община	вобшчына
общность	супольнасьць
объявление	абвестка
объявлять	абвяшчаць
объяснение	аб'ясьненьне
обязанность	абавязак
обязательный	абавязковы
обязательство	абавязнасьць
обыкновенный	звычайны
обыск	вобыск
обыскивать	трэсьцi
обычай	звычай
обычное право	звычаёвае права
оглавление	зьмест
оговор	абгавор
оговорка	агаворка
ограбление	аграбленьне
ограничение	абмежаваньне
ограничить	абмежаваць
одиночное заключение	адзiночнае зьняволеньне
одновременно	адначасна
однообразность	аднастайнасьць
однообразный	аднастайны
односторонний	аднабочны
одобрение	ухваленьне
одолжать	пазычаць
ознакомиться	азнаёмiцца
ознакомление	азнаямленьне
ознаменование	адзначаньне
оклад	аклад
окладной лист	акладны лiст
оклеветать	ачарнiць, абмовiць
окончание	канец
окончательное решение	канчатковае вырашэньне
окончательный	канчатковы
окрестный	акалiчны
округ	акруга
окружение	атачэньне
окружной	акружны
опасность	небясьпека
опасный	небясьпечны
опека	апека
опекун	апякун
операция	опэрацыя
опечатка	друкарская памылка
описка	апiска
опись	опiс
оповещать	апавяшчаць
оповещение	апавяшчэньне
опоздание	спазьненьне
опорочение	аняслаўленьне
опорочить	аняславiць
оправдание	апраўданьне
оправдать	апраўдаць
определение	вызначэньне
определение (на службу)	прыняцьце, назначэньне (на службу)
определение суда	вызначэньне суду
определить	вызначыць
опровержение	абвяржэньне
опрос	апытваньне
опросный лист	апытальны лiст
опротестовать	апротэставаць
оптовый склад	гуртоўня, гуртовы склад
опубликование	агалашэньне
опьянение	ап'яненьне
опыт	досьлед
опытный	практычны, дасьледчы
оратор	прамоўца
организация	органiзацыя
организовать	органiзаваць
орден	ордэн
ордер	ордэр
ординарный размер	ордынарны разьмер
оригинал	орыгiнал
орудие преступления	прылады злачынства
орудие производства	прылады вырабу, начыньне
оружие	зброя
осведомление	асьведамленьне
освидетельствование	агледзiны
освидетельствовать	агледзець
освободить (из тюрьмы)	вызвалiць
освободить (от обязательств)	звольнiць
освободить (помещение)	апаражнiць
освобождение	вызваленьне, апаражненьне, звальненьне
оседлость	аселасьць
оскорбитель	абразьнiк
оскорбительный	абразьлiвы
оскорбить	абразiць
оскорбление	абраза
осмеяние	абсьмяяньне
осмотр	агляд
основа	аснова
основание	падстава
основатель	фундатар, закладчык
основательный	грунтоўны
основной закон	асноўны закон
особа	асоба
особенность	асаблiвасьць
особенный	асаблiвы
особое мнение	асобны погляд
оспаривание иска	аспрэчваньне iску
оставление в опасности	пакiданьне ў небясьпецы
оставление отечества	пакiданьне бацькаўшчыны, айчыны
остаток	астача, рэшта
осторожность	асьцярожнасьць
осудить	асудзiць
осуждение	асуджэньне
осуществление	зьдзяйсьненьне, збываньне
осуществлять	зьдзяйсьняць, ажыцяўляць
ответ	адказ
ответственность	адказнасьць
ответственный	адказны
ответчик	адказчык
отвлекать	адводзiць
отвод земли	адвод зямлi
отвод на суде	адвод на судзе
отводная запись	адводны запiс
отворить	адчынiць
отговорка	адмоўка
отграничение	адмежаваньне
отдаление	аддаленьне
отдача	аддача, зварот
отдел	аддзел
отделение	адлучэньне, аддзяленьне
отдельный	аддзельны, паасобны
отделять	адлучаць
отдолжать	пазычаць
отдых	адпачынак
отец	бацька, айцец
отеческий	бацькаўскi, айцоўскi
отечество	бацькаўшчына, айчына
отзыв	адозьвiны
отказ	адмова
отказывать	адмаўляць, адказваць
отклонение	адхiленьне
отклонить	адхiлiць
открыватель преступления	выяўнiк злачынства
открытие	вынаходка
открытие (собрания)	адкрыцьце (сходку)
отлагательство	адклад
отличие	адзнака
отличительный	адзначальны
отложение	адкладаньне
отлучка	адлучка
отмена	адмена
отмена (выборов)	скасаваньне (выбараў)
отметить	адзначыць, адмецiць
отметка	адметка, адзнака
отношение (бумага)	адносьнiк
отношение	адносiны
отобрание	адабраньне
отправитель	адсылальнiк
отправление	выправа, адасланьне
отпуск (средств)	выдача
отпуск (по службе)	адпачынак, водпуск
отравление	атручэньне
отрасль	галiна
отречение от наследства	адрачэньне ад спадчыны
отрицание	адмаўленьне
отрицательный	адмоўны
отруб	адруб
отсрочка	адсрочка
отставка	адстаўка
отстранение	адхiленьне
отстранение (от должности)	адстаўленьне
отступление	адступленьне
отступное	адступнае
отсутствие	адсутнасьць
отсутствующий	адсутны
отчет	справаздача
отчетность	справаздачнасьць
отчим	айчым
отчисление	адлiчэньне
отчуждение	адчужэньне
отыскание	адшуканьне, пашуканьне
официальное издание	офiцыяльнае выданьне
охота	паляваньне
охотно	ахвотна
охрана	абарона, ахова
охранительный	абаронны
оценка	ацэнка
оценщик	ацэншчык
очередь	чарга
очная ставка	навочныя зводзiны
ошибка	памылка
падеж скота	мор скацiны
падение курса	паданьне курсу
пай	пай
пайщик	пайшчык
пакет	пакет
палата	палата
палач	кат
памятка	памятка
памятная книжка	памятная кнiжка
памятник	помнiк, памятнiк
память	памяць
пансион	пансiён
параграф	параграф
парад	царамонiя
пари	заклад
партизан	партызан
партия	партыя
партия рабочих	гурт рабочых
пасквиль	пашквiль
паспорт	пашпарт
пассажир	пасажыр
пастьба	пасьба
пастбище	паша
патент	патэнт
патрон	апякун, патрон
патронат	апякунства, патронат
пеня	пеня
пенсионер	пэнсiянэр
пенсионная касса	пэнсiйная каса
пенсия	пэнсiя
первенство	пяршынства
первобытный	першабытны
первоначальный	першапачатковы
первородство	першародзтва
перебаллотировка	перагаласаваньне
перебор	перабор
переверка	пераверка
перевод (литературный)	пераклад
перевод (служебный)	перавод
переводчик	перакладчык
перевоз	перавоз
перевозка	перавозка
переговоры	перагаворы
передаточная надпись	перадатачны надпiс
передвижение	перасуваньне
передел земли	перадзел зямлi
передержка	перадзержка
передоверие	перадавер
передопрос	перавыпыт
перезаклад	перазастава
переизбирание	перавыбраньне
переименование	перайначваньне, пералiчэньне
перекличка	пераклiчка
перемена	перамена
перемещение	перамяшчэньне
перенесение	перанясеньне
перенос	перанос
переоценка	пераацэнка
переписка	перапiска
переписчик	перапiсчык
перепись	перапiс
переплав монеты	пералiцьцё монэты
переправа	пераправа
переправка	перапраўка
перепродажа	перапродаж
перепроизводство	перавыраб
перепутать	пераблутаць
переработать	перапрацаваць
перерыв	перапынак
переселенец	перасяленец
переселение	перасяленьне
пересмотр	перагляд
перестановка	перастаноўка
пересылка	перасылка
переторжка	ператорг
переучет	перападлiк
переход	пераход
перечень	пералiк
перечисление	пералiчэньне
период	пэрыод
периодическое издание	пэрыодычнае выданьне
перонный сбор	пэронная плата
печать	пячатка, друк
писарь	пiсар
письменное доказательство	пiсьмены довад
письмо	пiсьмо, лiст
письмоносец	пiсьманосец
питейный доход	пiтны даход
питомец	выхаванец
питомник	школка
плавание	плаваньне
плагиат	плягiят
плакат	плякат
план	плян
плата	плата
платеж	выплата
платежеспособность	платаздольнасьць
платежная расписка	выплатны квiток
плательщик	плацежнiк
платье	адзеньне
племенной скот	завадзкое быдла
племя	племя
племянник	пляменьнiк
плен	палон
пленный	палонны
плод	плод
плодотворная работа	плённая, карысная работа
пломба	плёмба
площадь	пляц, плошча
побег	уцёкi
побои	пабоi
побоище	бойка
поборы	зьдзiрства
побочный	пабочны
побуждение	пабуджаньне
повальный обыск	пагалоўны вобыск
повеление	павяленьне, загад
повелительный	загадны
поверенный	павераны
поверка	паверка
повестка	павестка
повинная	прызнаньне вiны, павiненьне
повинность	павiннасьць
повиновение	паслушэнства
повод достаточный	прычына выстарчаючая
повод к начатию дела	прычына да пачацьця справы
поворот	паварот
повреждение	ушкаджэньне
повторение	паўтарэньне
повышение	падвышэньне
повышение наказания	павялiчэньне кары
погасительная давность	касуючая даўнасьць
погасительный	касуючы
погашение	касаваньне, выплата
пограничная стража	прыгранiчная варта
погребение	пахаваньне
подарок	падарунак
податной инспектор	падатковы iнспэктар
подать	падатак
подбирать	падбiраць
подбор	падбор
подбрасывать	падкiдаць
подведомственный	падпарадкаваны
подвергать	накладваць (кару), ставiць (у небясьпеку)
подвода	хурманка, падвода
подворное владение	падворнае ўладаньне
подговорщик	намоўца
подготавливать	падгатаўляць, падрыхтоўваць
подготовка	падгатоўка
подделка	падробка
подделывать	падрабляць
поддержание	падтрыманьне
поддержка	падтрыманьне
поджог	падпал
подзащитный	падабаронны
подкидыш	падкiдак
подкрепление	падмацаваньне
подлинник	орыгiнал
подлинность	праўдзiвасьць
подлог	падлог
подложность	падробленасьць
подмастерье	чаляднiк
подмена	падмена
подметное письмо	падкiдны лiст
подмога	падмога
поднадзорный	паднадзорны
подозревать	падазраваць
подозрение	падазрэньне
подотдел	пададдзел
подотчетность	пададказнасьць
подоходный	падаходны
подписка	падпiска
подпись	подпiс
подражание	перайманьне
подразумевать	разумець
подробность	падробнасьць
подрыв	падрыў
подряд	падрад
подрядчик	падрадчык
подследственный	падсьледны
подстрекатель	падбухторнiк
подстрекательство	падбухторваньне
подсудимость	падсуднасьць
подсудимый	падсудны
подсудность	падсуднасьць
подсчет	падлiк, падлiчэньне
подтверждать	пацьвярджаць
подтверждение	пацьвярджэньне
подушная подать	падушны падатак
подчинение	падляганьне
подчиненность	падлежнасьць
подчиненный	падлежны
подчинять	узалежнiваць
подчистка	падчыстка
поезд	поезд
пожалование	надарэньне
пожертвование	ахвяраваньне
пожизненное владение	дажывотнае ўладаньне
позволение	дазвол
поздравление	прывiтаньне
поздравлять	вiтаць
позор	ганьба
позорить	ганьбiць
позорный	ганебны
поиски	шуканьне
поймать	злавiць
показание	паказаньне
показательный	паказальны
поклажа	паклажа
покойник	нябожчык
поколение	пакаленьне
покорный	пакорлiвы
покровительство	протэктарства
покрытие	пакрыцьце
покупатель	купец
покупка	купля
покушение	замах
пол	пол, род
полис	полiс
политический	полiтычны
полиция	полiцыя
положение	палажэньне (акт), стан, становiшча
положительный	дадатны
польза	карысьць
пользование	карыстаньне
получатель	палучацель
получка	палучка
полюбовный раздел	палюбоўны падзел
поместье	маёнтак, сядзiба
помешательство	памяшаньне
помещение	памяшчэньне
помещик	пан, абшарнiк
помилование	памiлаваньне
помощник	памоцнiк
помощь	помач, дапамога
понимание	разуменьне
понуждение	панука, пануканьне
понятие	разуменьне, паняцьце
понятность	зразумеласьць
понятой	паняты
поощрение	заахвочваньне
попенная плата	плата з пня
попечение	апекаваньне
попечитель	апякун
попечительство	апякунства
поправка	папраўка
попуститель	патуральнiк
попустительство	патураньне
попытка	спроба
поработить	зьняволiць
поражение прав	пазбаўленьне праў
порицание	ганьбаваньне
порнография	порнографiя
порок	ганьба, загана
порочное поведение	ганебны ўчынак
порубка	парубка
поругание	зьдзек
порука	парукi
поручение	даручэньне
поручитель	даручыцель
поручительство	парука
порционные деньги	харчовыя грошы
порча	псаваньне, глум
порядок	парадак, лад
поселенец	пасяленец, асаднiк
поселение	пасяленьне
поселок	выселкi
посессионное право	посэсiйнае права
посетитель	наведчык
посещение	наведваньне
посланник	пасланьнiк
последовательность	паступовасьць
последовательный	паступовы
последствие	вынiк
последующая документальная проверка	наступная дакумантальная праверка
послужной список	службовы сьпiс
пособие	дапамога, прылада, падручнiк
пособник	дапаможнiк
посол	пасол
посольство	пасольства
посредник	пасрэднiк
посредничество	пасрэднiцтва
пост	варта, пасада
поставка	дастаўка
поставщик	дастаўца
постановка	пастаноўка
постановление	пастанова
постепенность	паступовасьць
постоялый двор	карчма, заежджы двор
постоянно	заўсёды
постоянный	пастаянны, сталы
поступление	паступленьне
поступок	учынак
посылка	пасылка
посягательство	пасяганьне
потеря	страта
потерять	згубiць, страцiць
потомок	патомак
потомство	патомства
потрава	патрава, шкода
потребитель	спажывец
потребительский	спажывецкi
потребление	спажываньне
потребность	патрэба, патрэбнасьць
похвальба	хвальба
похвальный лист	пахвальны лiст
похититель	злодзей
похищение	крадзеж
похоронный	пахавальны
похороны	пахаваньне
почесть	пашана, ушанаваньне
почетный	пачэсны
почин	пачатак
почитать	шанаваць
почта	пошта
почтальон	паштальён
почтение	пашана
пошлина	мыт, пошлiна
поштучный	паштучны
пояснение	паясьненьне
правило	правiла
правильный	правiльны
правитель	управiцель
правительство	урад
правление	управа
право	права
правоведение	правазнаўства
правозащитник	правазаступнiк
правомерный	законны
правомочие	правамоцнасьць
правонарушение	нарушэньне права
правопонимание	праваразуменьне
правоспособность	праваздольнасьць
правоспособный	праваздольны
правосудие	правасудзьдзе
правота	правасьць
правотворчество	праватворчасьць
праздненство	сьвяткаваньне
праздник	сьвята
праздность	дзеньгубства, марнаваньне часу
пребывание	побыт
превышение власти	перавышэньне ўлады
преграда	перашкода
предание суду	адданьне пад суд
предварительное следствие	папярэдняе сьледзтва
предел	мяжа, гранiца
предельная норма	гранiчная норма
предисловие	прадмова
предложение	пропозыцыя
предложение и спрос	посул i попыт
предмет	прадмет
предназначение	прадназначэньне
преднамеренность	праднамер
предок	продак
представить	даць
предостережение	перасьцярога
предосудительный	асудны
предохранять	захоўваць
предписание	наказ
предписывать	наказваць
предположение	дапушчэньне
предпочтение	перавага
предприимчивость	прадпрыiмнасьць
предприниматель	прадпрыемец
предприятие	прадпрыемства
предрассудок	забабоны
председатель	старшыня
представитель	прадстаўнiк
представительство	прадстаўнiцтва
представление	паданьне
предстоящий	надыходзячы
предумышленность	наўмыснасьць
предупредительность	папярэдлiвасьць
предупреждение	папярэджаньне, перасьцярога
предыдущий	папярэднi
предъявитель	прад'яўнiк
предъявить	прад'явiць
предъявление	прад'яўленьне
преемник	заступнiк
преемственность	заступнасьць
преемство	заступнiцтва
президент	прэзыдэнт
преимущественность	пераважнасьць
преимущество	перавага
прекословие	супярэчаньне
прекращение	спыненьне
премия	прэмiя
прения	спрэчкi
преобразование	ператварэньне
преодолимый	пераможны
преподавание	выкладаньне
препроводительная бумага	адрасная папера
препровождение	пасылка
препятствие	перашкода
пререкание	супярэчваньне
пресечение преступления	спыненьне злачынства
преследование	прасьледваньне
преступление	злачынства
преступная среда	злачынная срада
преступник	злачынец
преступность	злачыннасьць
претендент	прэтэндэнт
претензия	прэтэнзiя
прецедент	выпадак, прэцэдэнт
прибыль	прыбытак, карысьць
приведение в исполнение	выкананьне
приветствие	прывiтаньне
приветствовать	вiтаць
прививать	прышчапляць
привилегия	прывiлей
привлекать	прыцягаць
привлечение	прыцягненьне
привод	прывод
привоз	прывоз
привычка	прывычка
приглашать	запрашаць
приглашение	запрашэньне
приговор	прыгавор, прысуд
приговоренный	прысуджаны
пригодность	прыгоднасьць
приготовление	прыгатаўленьне
пригульный скот	прыблудная жывёла
приданое	пасаг
придаток	прыдача
придирка	прычэпка
прием	прыём
приемный покой	прыёмны пакой
приемыш	прыймiт
приемщик	прыёмнiк
приз	прыз
призвание	прызваньне, здатнасьць
признак	прымета
признание	прызнаньне
признательность	удзячнасьць
призрение	дагляд
призыв	прызыў
приказ	загад
приказание	прыказаньне
приказчик	даручны
приключение	здарэньне
прикосновенность	датыкальнасьць
прикрепление	прымацаваньне
прилежание	стараннасьць, пiльнасьць
приличие	прыстойнасьць
приложение	дадатак
применение	ужытак, дапасаваньне
пример	прыклад
примета	прымета
примечание	увага
примирение	замiрэньне
принадлежность	прыналежнасьць
приниматель	прымальнiк
принудительное отчуждение	прымусовае адчужэньне
принудительный	прымусовы
принуждение	прымус
принцип	прынцып
принятие	прыняцьцё
приобретатель	набываўца
приобретательная давность	набывальная, набытковая даўнасьць
приобретательный	набытковы, набывальны
приобретать	набываць
приобретение	набыцьцё, набытак
приостанавливать	прыпыняць
приостановка	прыпыненьне
припасы	прыпасы
припасы съестные	харчы
приписка	прыпiска
приплод	прыплод
приращение	прырост
прирост	прырост
присваивать	прысвайваць
присвоение	прысваеньне
прислуга	слуга
присмотр	дагляд
присоединение	далучэньне
приспособить	дапасаваць
приспособление	дапасаваньне
пристанище	прытулак
присутствие	прысутнасьць
присутствовать	прысутнiчаць
присылка	прысылка
присяга	прысяга
притеснение	уцiск
приток	прыцёк
притон	прытон
притонодержатель	прытонатрымаўца
притязание	дамаганьне
приурочить	прыстасаваць
приход сумм	прыход сум
причина	прычына
причисление	прылiчэньне
приют	прытулак
проба	спроба, проба
проба металла	проба мэталю
пробел	пярэрва
пробирная палата	прабiрная палата
пробный	пробны
проведение	правядзеньне
проверка	праверка
провизия	харчы
провинция	провiнцыя
провозглашение	агалашэньне
прогоны	прагоны
прогул	прагул
продавец	прадавец
продавщик	прадавец
продажа	продаж
проделка	штука
продовольствие	спажыўнасьць, харчаваньне
продолжение	працяг
продолжительность	працяжнасьць
продукты	харчы, продукты
проезд	праезд
проект	проект
проживание	пражываньне
прожиточный минимум	пражытковы мiнiмум
произведение	твор
производитель	вытворнiк
производительный труд	продукцыйная праца
производство дел	справавядзеньне
производство (фабричное)	вытворчасьць, выраб, продукцыя
произвол	самавольства
происхождение	паходжаньне
происшествие	здарэньне
прокат	пракат
прокурор	прокурор
пролетарий	пролетары
промах	прамах
промедление	прабаўка
промен	прамен
промотание	прагуляньне
промысл	промысел
промысловый налог	прамысловы падатак
промышленность	прамысловасьць
пропаганда	пропаганда
пропажа	прапажа
прописка	прапiска
пропитание	пражытак
пропуск	пропуск
просвещение	асьвета
просмотр	перагляд
просрочка	прасрочка
простой	прастой
пространство	прастора
проступок	праступак
просчет	пралiк
просьба	просьба
протекция	протэкцыя
протекционизм	протэкцыянiзм
протест	протэст
протестант	протэстант
противная сторона	супрацiўная старана
противодействие	перашкода, працiвадзейнасьць
противозаконность	незаконнасьць
противоположность	процiлежнасьць
противоречие	супярэчнасьць
противоречить	супярэчыць
протокол	протокол
профессия	профэсiя
проход	праход
прохождение	прахаджэньне
процент	процант
прошедший	мiнулы
прошение	просьба, прашэньне
прощение	дараваньне
проявление	праява
прямой	просты
псевдоним	псэўдонiм
публикация	публiкацыя, апавяшчэньне
пункт	пункт
путеводитель	дарожнiк
пути сообщения	шляхi зносiн
путь	шлях, дарога
пытка	катаваньне
работа	работа
работать	рабiць
работник	работнiк
работодатель	работадаўца
рабочий	рабочы
рабство	няволя
равенство	роўнасьць
равновесие	роўнавага
равноправие	роўнапраўе
равноценность	роўнацэннасьць
разбирательство	разьбiраньне
разбой	разбой
разбойник	разбойнiк
разведка	разьведка
разверстание	раскладка, разьмеркаваньне
разверстка	раскладка, разьмеркаваньне
развод	развод
разврат	распуста
разглашение	разгалашэньне
разграничение	разьмежаваньне
раздача	раздача
раздел	падзел
разделение	падзяленьне
разделение дела	падзел справы
раздельное имущество	падзельная маемасьць
раздор	звада
раздражение	раздражненьне
различие	розьнiца
размежевание	разьмежаваньне
размен	разьмен
размер	разьмер
разногласие	рознагалоснасьць
разнообразие	рознастайнасьць
разнос	разнос
разность	розьнiца
разобщение	разлучэньне
разорение	руйнаваньне
разоружение	разбраеньне
разработка	распрацоўка
разрешать	дазваляць, вырашаць
разрешение	дазвол, дазваленьне
разрешение дела	вырашэньне справы
разрешительная статья	дазвольны артыкул
разрушать	разбураць, руйнаваць
разрушение	разбурэньне
разрушительный	руйнавальны
разряд	разрад
разыскание	адшуканьне
разъяснение	разьясьненьне
район	раён
рана	рана
раскаяние	пакаяньне
раскладка	раскладка, расклад
раскол	раскол
раскрытие	выкрыцьце
распорядитель	упраўнiчы
распорядительный	упраўны, распарадчы
распорядок	парадак
распоряжение имуществом	распараджэньне маемасьцю
расправа	расправа
распределение	разьмеркаваньне
распределительный	разьмеркавальны
распродажа	распродаж
распространение слухов	распаўсюджаньне чутак
распространять	пашыраць
рассмотрение	разгляд
рассрочка	рата
рассуждение	разважаньне
рассыльный	пасыльны
растление	растленьне
расторжение	парваньне
расточитель	марнатраўца
растрата	растрата
расхищение	раскраданьне
расход	выдатак, расход
расходование	расходваньне, выдаткаваньне
расценка	расцэнка
расчет	рашчот
реальность	сапраўднасьць, рэальнасьць
ребенок	дзiцё, дзіця
ревизия	рэвiзiя
ревизор	рэвiзор
ревность	рэўнасьць
регалия	рэгалiя
регистратор	рэгiстратар, запiсчык
регистратура	рэгiстратура
регистрация	рэгiстрацыя, перапiс
регламентация	рэглямантацыя
редактор	рэдактар
редакция	рэдакцыя
реестр	кнiга запiсу, рэестр
резерв	запас
резолюция	рэзолюцыя
результат	вынiк, рэзультат
реквизиция	рэквiзыцыя
религиозные убеждения	рэлiгiйныя перакананьнi
ремесленник	рамесьнiк
ремесло	рамяство
ремонт	рамонт
рента	рэнта
реставрация	адбудаваньне
реформа	рэформа
рецидив	рэцыдыў
рецидивист	рэцыдывiсты
речь	прамова
решающий голос	пастанаўляючы голас
решение	рашэньне
решимость	рашучасьць, сьмеласьць
решительность	рашучасьць
риск	рызыка
рисунок	рысунак
род	род
родители	бацькi
родительская власть	бацькаўская ўлада
родовое имущество	родавая маемасьць
родословие	радаслоўе
родственник	сваяк, родзiч
родство	сваяцтва
роды	роды
рождение	нараджэньне
розничный торг	розьнiчны торг
розыгрыш	розыгрыш
розыск	розыск
расписание	расклад
роспись	росьпiс
роспуск	роспуск
рост	рост
ростовщик	квотнiк
ростовщичество	квотнiцтва
ругательство	лаянка
руководитель	кiраўнiк
руководство	кiраваньне, падручнiк
ручательство	парука
рынок	рынак
ряд	рад
саботаж	саботаж
сальдо	сальдо
самовольная отлучка	самавольная адлучка
самодвижущийся	самарухомы
самозванство	самазванства
самоокупаемость	самаакупаемасьць
самоопределение	самавызначэньне
самопомощь	самапомач
самостоятельность	самастойнасьць, незалежнасьць
самоубийство	самагубства
самоуверенность	самаўпэўненасьць
самоуправление	самакiраўнiцтва
самоуправство	самапраўства
сберегательная касса	ашчадная каса
сбережение	ашчада
сбор	збор
сборище	зборышча
сборник	зборнiк
сборщик	зборшчык
сбыт	збыт
свадьба	вясельле
сведение	зьвестка
сведущее лицо	знаўца справы
свекр	сьвёкар
свекровь	сьвякроў
сверхсрочный	пазатэрмiновы
сверхурочный	звышмерны
сверхштатный	пазаштатны
свидетель	сьведка
свидетельство	пасьведчаньне
свидетельствование	сьведчаньне
свобода	воля, свабода
свободный	вольны, свабодны
свод законов	збор законаў
сводник	зводнiк
сводничество	зводнiцтва
сводный баланс	падрахованы балянс
свойственник	сваяк
свойство	уласьцiвасьць, сваяцтва
связь	сувязь
сговор	згавор, змова
сговориться	згаварыцца
сдача	рэшта, здача
сделка	угода, зьдзелка
сдельная плата	зьдзельная плата
сдельный	зьдзельны
съезд	зьезд
съестные припасы	харчы
секвестр	сэквэстр
секрет	сакрэт
секретарь	сакратар
село	сяло
семейство	сям'я
семя	насеньне
сенат	сэнат
сенатор	сэнатар
сервитут	сэрвiтут
сессия	сэсiя
сигнал	знак, сыгнал
сигнализация	сыгналiзацыя
сигнатура	сыгнатура
синдикат	сындыкат
система	сыстэма
склад	склад
склонять	схiляць, скланяць
скопище	зграмаджэньне
скот	быдла, скацiна, жывёла
скотоложство	скоталоства
скрепа	скрэпа
скупщик	скупшчык
слабоумие	прыдуркаватасьць
следование	сьледаваньне
следователь	сьледчы
следственный	сьледзкi
следствие	сьледзтва
слобода	слабада
словесное разбирательство	вуcны разбор
словесный договор	вусны дагавор
сложный	складаны
служащий	службовец
служба	служба
слухи	чуткi
случай	выпадак, здарэньне, прыгода
случайность	выпадковасьць
случиться	здарыцца
слушание дела	слуханьне справы
смертная казнь	кара сьмерцю
смертность	сьмертнасьць
смерть	сьмерць
смета	каштарыс
смешанная подсудность	мяшаная падсуднасьць
смешанный	мяшаны
смешение исков	мяшаньне iскаў
смотр	агляд
смотрины	агледзiны
смотритель	дазорца
смягчение	памягчэньне, зьмягчэньне
снабжение	аснада, дастаўленьне
снаряд	знарад
снисхождение	паблажлiвасьць
сношение	зносiны, адносьнiк
соблазн	спакуса
соблюдение	захаваньне
собрание	сход, збор
собственноручность	уласнаручнасьць
собственность	уласнасьць
собственный	уласны
совершение	учыненьне
совершиться	адбыцца
совершеннолетие	поўналецьце
совершеннолетний	поўналетнi
совершиться	адбыцца, учынiцца
совещание	нарада
совещательная комната	нарадны пакой
совещательный	дарадчы
совесть	сумленьне
совет	савет, рада
советник	райца
советчик	дарадчык
совместительство	сумяшчальнасьць
совместное владение	сумеснае ўладаньне
совместность	сумеснасьць
совокупность	злучнасьць
совпадение	зьбежнасьць
совращение	зьбiваньне
согласие	згода
согласование	узгадненьне
согласовать	узгадняць
согласительная комиссия	пагаджальная камiсiя
соглашатель	згоднiк
соглашение	згоднасьць, угода
содержание	зьмест, утрыманьне
содержатель	утрымоўца
соединение	складаньне, злучэньне
соединенный	злучаны
сожительница	сумесьнiца, палюбоўнiца
сожительство	сумеснае жыцьцё
сожитие	сумеснае жыцьцё
создание	стварэньне
сознание	сьвядомасьць
сознательность	сьвядомасьць
созыв	збор, склiканьне
созывать	склiкаць
сокращение	скарачэньне
сокрытие	пакрыцьцё, схаваньне
солидарность	солiдарнасьць, згоднасьць
соло-вексель	солё-вэксаль
сомнение	сумненьне
сомнительность	сумненнасьць
соображение	меркаваньне
сообразно	адпаведна
сообща	супольна
сообщение	зносiны, паведамленьне
сообщество	супольства, хаўрус
сообщник	супольнiк, хаўрусьнiк
соответственность	адпаведнасьць
соответствующий	адпаведны
сопоставление	параўнаньне
сопротивление	супрацiўленьне
сословие	стан
состав	склад
составление	улажэньне, складаньне
составлять	укладаць, складаць
состояние	можнасьць, стан
состоятельность	заможнасьць
состязание	спрэчка
состязательный процесс	спрачальны процэс
сотрудник	супрацоўнiк
сотрудничество	супрацоўнiцтва
соучастие	супольнiцтва
соучастник	супольнiк
сохранение	захаваньне, ахова
сохранить	захаваць
сохранная записка	захавальная запiска
сохранность	захавальнасьць
сочинение	твор, укладаньне
социализм	соцыялiзм
социалист	соцыялiсты
социалистический	соцыялiстычны
социальный	соцыяльны
союз	саюз
союзник	саюзьнiк
спасение	ратаваньне
специалист	спэцыялiсты
специализация	спэцыялiзацыя
специальность	спэцыяльнасьць
спецификация	спэцыфiкацыя
список	сьпiс
спор	спрэчка
спорность	спрэчнасьць
способ	спосаб
способность	здольнасьць
способствовать	дапамагаць
справка	спраўка
спрос	попыт, запатрабаваньне
сравнение	параўнаньне
средства	сродкi
средство	спосаб, сродак
срок	тэрмiн, срок
срочность	тэрмiновасьць
срочный	тэрмiновы
ссора	сварка
ссуда	пазычка
ссудный	дапаможнапазычковы
ссылка (наказание)	высылка, сасланьне
ссылка на что-нибудь	сасланьне, адноска
ссыльный	сасланы
ставка	стаўка
стаж	стаж
станция	станцыя
староста	стараста
старший	старэйшы, старшы
старшинство	старшынства
статут	статут
статья	артыкул
стачка	стачка
степень	ступень
степень родства	ступень сваяцтва
стечение	зьбег
стипендия	стыпэндыя
стихия	навала, стыхiя
стоимость	вартасьць, кошт
столица	сталiца
столкновение	сутычка
сторож	стораж, вартаўнiк
страдание	пакута, мука
стража	варта
стражник	вартаўнiк, стражнiк
страна	краiна, старана
страхование	страхаваньне, забесьпячэньне
страховать	страхаваць, забесьпячаць
страховой	страховы
стремление	iмкненьне
строгость	суровасьць
строение	будова, будынак
строитель	будаўнiк
строительство	будаўнiцтва
строить	будаваць
строй	лад
структура	будова
студент	студэнт
субъект	суб'ект
субсидия	дапамога
суд	суд
судебное решение	судовае рашэньне
судебный	судовы
судимость	суднасьць
судить	судзiць
судоговорение	судагаварэньне
судопроизводство	судаводзтва
судоустройство	судоўнiцтва
судья	судзьдзя
суеверие	забабоны
суждение	суджэньне
сумасшедший	вар'ят
суммировать	падрахоўваць
суррогат	падмен
сутки	суткi
суточный	сутачны
сутяжество	цяганiна па судох
существо	iстота
существование	iснаваньне
сущность дела	iстота, аснова справы
счет	рахунак, кошт
счета открывать и закрывать	пачынаць i канчаць рахункi
счетовод	рахоўнiк, рахункавод
счетоводство	рахоўнiцтва, рахункаводзтва
схема	схэма
сырье	сырызна
сюрприз	неспадзеўка, сюрпрыз
табель	табаль
таблица	таблiца
тайный	патайны
такса	такса
талон	квiток, талён
таможенная пошлина	таможная пошлiна, мыт
таможня	таможня, мытнiца
тариф	тарыф
театр	тэатр
текст	тэкст
текущий счет	бягучы рахунак
телеграф	тэлеграф
телесное повреждение	цялеснае калецтва
телефон	тэлефон
тетрадь	сшытак
типография	друкарня
тираж	тыраж
титул	тытул
тленные вещи	тленныя рэчы
товар	тавар
товарищ	таварыш
товарищеский суд	таварыскi суд
товарищество	таварыства
толкование	тлумачэньне
толпа	натоўп
торг	торг
торговец	гандляр
торговля	гандаль, таргоўля
торжественный	урачысты
торжество	урачыстасьць
точка	пункт
точно	дакладна
точность	дакладнасьць
трактат	трактат
трактир	шынок
транспорт	транспорт, перанос
требование	патрабаваньне, вымаганьне
требовательность	вымагальнасьць
тревога	трывога
трезвость	цьвярозасьць
третейский	пасрэднiцкi
третейский суд	пасрэднiцкi суд
третье лицо	трэцяя асоба
труд	праца
трудовая артель	працоўная арцель
трудовой	працоўны
трудоспособность	працаздольнасьць
труп	труп
туземец	тубылец
тщательность	пiльнасьць, стараннасьць, дакладнасьць
тюрьма	астрог, турма
тяжба	цяжба
тяжесть доказательства	цяжкасьць доваду
тяжущийся	цяжбенiк
убеждение	пераконаньне
убежище	прытулак
убийство	забойства
убийца	забойца
убыль	упад
убыток	страта, шкода
уважать	шанаваць
уважение	пашана
уважительная причина	уважная прычына
уведомление	паведамленьне
увеличение исковых требований	павялiчэньне iскавых вымаганьняў
уверение	запэўненьне
уверенность	пэўнасьць
увеселение	забава
увечье	калецтва
увещание	угаворваньне
увод	увод
увольнение	звальненьне
увольнительный билет	звальняльны бiлет
увязка	увязка
угодие	угодзьдзе
уголовный	крымiнальны
уголовщина	крымiнал
угроза	пагроза
удаление	выдаленьне
удар	удар
удача	удача
удержание	утрыманьне
удешевление	патаненьне
удобный	выгодны
удобство	выгода
удовлетворение	задавальненьне
удостоверение	пасьведчаньне
удостоверить	пасьведчыць
уезд	павет
узаконение (закон)	закон
узаконение (детей)	узаконеньне
узник	вязень
указ	загад
указатель	паказальнiк
указать	паказаць
уклонение	ухiленьне
укорительное выражение	дакорлiвы выраз
укрепление	умацаваньне
укрыватель	захоўнiк
укрывательство	пакрываньне
укрытие	пакрыцьцё
улика	улiка
уличать	улiчаць
уловка	выкрут
уложение	улажэньне
умалишенный	вар'ят
уменьшить	зьменшыць
умерший	умерлы
умозаключение	вывад
умоисступление	разьюшанасьць
умолчание	змаўчаньне
умственный	разумовы
умысел	намысел
умышленный	наўмысны
унижение	зьнявага
уничтожать	зьнiшчаць
уничтожение	зьнiшчэньне
упадок	заняпад
уплата	выплата
уполномоченный	упаўнаважаны
упоминание	напамiнаньне
упорство	упартасьць
упорядочение	упарадкаваньне
употребление	ужываньне
управа	управа
управление	кiраўнiцтва
управлять	кiраваць
управляющий	кiраўнiк
упразднить	скасаваць
упрекать	упiкаць
упрочение	угрунтаваньне
упрямство	упартасьць
упущение	занядбаньне
уравнение	зраўнаньне
уравнительный	зраўнальны
уровень	ровень
урод	вырадак, урод
урожай	ураджай
урок	заданьне
урочище	урочышча
урядник	ураднiк
усадьба	сядзiба, сялiба
усердие	стараннасьць, пiльнасьць
усиление	узмацненьне
усиление	патуга
условие	умова
условный	умоўны
усложнение	ускладненьне
усмирение	усьмiрэньне
усмотрение	погляд
усовершенствование	удасканаленьне
успех	пасьпех
успешный	пасьпешны
успокоение	пакой
устав	статут
установить	устанавiць
установление	устанаўленьне, установа, iнстытуцыя
устранение	адхiленьне
устрашение	застрашваньне
устройство	парадак, упарадкаваньне
уступка	уступка
усушка	усушка
усыновитель	усынавiцель
утайка	утайка
утверждать	зацьвярджаць
утечка	выцек
уточнение	удакладненьне
утрата	страта
ухудшать	пагаршаць
участие	удзел
участник	удзельнiк
участок	участак
участь	доля
учащийся	вучань
учебное заведение	школа
учебный год	школьны год
учебный сбор	вучэбны збор
учение	вучэньне
ученичество	вучнёўства
учет	падлiк
учетно-ссудный процент	падлiчальна-пазычковы процант
учредитель	устаноўца
учредительный	устаноўчы
учреждать	устанаўляць
учреждение	установа, устанаўленьне
ущерб	шкода
уяснение	уразумленьне
фабрика	фабрыка
фабрикант	фабрыкант
фабрикат	фабрыкат, выраб
факт	факт
фактический	фактычны
фактор	фактар, чыньнiк
фактура	фактура
фальсификация	фальшаваньне
фальш	фальш
фамилия	прозьвiшча
федерация	фэдэрацыя
фельдшер	фэльчар
фидеикомисс	фiдэiкомiс
физическое лицо	фiзычная асоба
финансы	фiнансы
фирма	фiрма
фиск	скарб, фiск
флаг	сьцяг
флот	флёт
фольварок	фольварак
фонд	запас, фонд
форма	форма
формализм	формалiзм
формальность	формальнасьць
формировать	формаваць
формула	формула
фрахт	фрахт
фрукты	плады
фундамент	падстава, грунт
фураж	корм
характер	характар
харчевня	харчоўня
хвастовство	выхваленьне
хитрость	хiтрасьць
хищение	расьцяг
хлопоты	клапоты
ходатайство	хадайнiцтва
ходок	хадок
хождение в суд	хадзянiна ў суд
хозяин	гаспадар
хозяйственность	гаспадарлiвасьць
хозяйственный	гаспадарскi
хозяйственный расчет	гаспадарскi рашчот
хозяйство	гаспадарка
холостяк	халасты
хранение	схова
хранилище	спрат
хранитель	ахоўнiк
художество	мастацтва
хулиганство	хулiганства
хутор	хутар
царство	царства
цель	мэта, цэль
цена	цана
ценз	цэнз
цензор	цэнзар
цензура	цэнзура
ценность	цэннасьць
ценные бумаги	цэнныя паперы
центр	цэнтр
цепи	ланцугi
церемониал	царамонiял
церемония	царамонiя
церковь	царква
цех	цэх
цикл	цыкль
циркуляр	цыркуляр, абежнiк
час	гадзiна
частичная уплата	частковая выплата
частное имущество	прыватная маемасьць
часть	часьць
чек	чэк, квiт
чеканка	выбiўка
чернила	атрамант, чарнiла
черновой	чарняк
черта	рыса
чертежник	рысавальнiк
честь	гонар, чэсьць
четверть	чвэртка
чин	ранга
чиновник	чыноўнiк
чинш	чынш
число	лiк, чысло
чистота	чыстата
член	член
членовредительство	калецтва
чрезвычайный	надзвычайны
чресполосный	цераспалосны
чтение	чытаньне
чувство	пачуцьцё
шайка	банда
шеф	шэф
шинкарство	шынкарства, карчмарства
шифр	шыфр
школа	школа
шнуровая книга	шнуровая кнiга
шпион	шпiён
шпионство	шпiёнства
шрифт	шрыфт
штаб	штаб
штамп	штамп
штат	штат
штемпель	штэмпаль
штраф	штраф
шуллер	шулер
шум	гам, гоман
эквивалент	эквiвалент, роўнакошт
экзамен	экзамен
экзекутор	экзэкутар
экзекуция	экзэкуцыя
экземпляр	экзэмпляр, паасобнiк
эконом	эконом
экономический	экономiчны
экономия	ашчаднасьць, экономiя
экспедиция	экспэдыцыя
эксперт	экспэрт, дасьледчык
экспертиза	экспэртыза, дасьледваньне
эксплуатация	эксплёатацыя, карыстаньне
экспроприация	экспропрыяцыя
экстракт	выцяжка, экстракт
экстренный	экстраны
эмиграция	высяленьне
эпидемия	пошасьць, эпiдэмiя
этап	этап
этика	этыка
этикет	этыкет
юбилей	юбілей
юридический	праўны
юридическое лицо	юрыдычная асоба
юрисконсульт	праварадца, юрысконсульт
юриспруденция	правазнаўства
юрист	праўнiк, юрысты
юстиция	юстыцыя
ябеда	злонамоўе
явка	яўка
явление	зьявiшча
явная небрежность	яўная няўважлiвасьць
явочный	явачны
яд	атрута, яд
язык	мова
ярлык	ярлык
ярмарка	кiрмаш
ясли	ясьлi
ящик	скрынка
