##Title: Слоўнік сельска-гаспадарчае тэрмінолёгіі (праект) (БНТ)
##HTMLDescription_BEGIN
<div>
	<p class="dictdesc-st">Створана на падставе:</p>
	<p><b>Слоўнік сельска-гаспадарчае тэрмінолёгіі (праект)</b>. Менск: Інбелкульт, 1928.</p>
</div>
<div>
	<p class="spoiler">Ад Інстытуту Навуковае Мовы</p>
	<p>Пры апрацоўцы навуковай сельска-гаспадарчай тэрмінолёгіі прыходзіцца лічыцца з шмат якімі асаблівасьцямі і труднасьцямі. Ува ўсіх мовах у гэтай галіне яшчэ не закончылася тэрмінолёгічная творчасьць і часта аўтары ў сваіх працах падаюць новыя тэрміны, або ўзятыя з народных дыялектаў, або сумысьля прыдуманыя для больш дакладнага азначэньня тых ці іншых паняцьцяў. Ёсьць ужо даволі многа сельска-гаспадарчай літаратуры і на беларускай мове, як популярнай, так і навуковай; укладчыкі гэтае літаратуры мусілі самастойна кожны для сябе ўстанаўляць тэрмінолёгію. Асабліва-ж трэба лічыцца з тымі моўнымі багацьцямі, якія ў гэтай галіне мае народная мова. У беларускага селяніна ў штодзённым ужываньні ёсьць шмат сельска-гаспадарчых тэрмінаў, якія складаюць аснову і найбольш рознастайную частку яго слоўніка.  Багацьце гэтага слоўнага матар’ялу яшчэ павялічваецца, дзякуючы мясцовым адменам, якіх тут асабліва многа і якія часта вельмі далёка адыходзяць адна ад аднае.  </p>
	<p>Усе гэтыя ўмовы спрыялі-б устанаўленьню беларускай навуковай сельска-гаспадарчай тэрмінолёгіі, каб увесь памянёны слоўны матар‘ял быў сабраны і вывучаны. Гэтага, на жаль, яшчэ няма і ня так хутка можа быць. Тым часам бягучая праца аграномаў, настаўнікаў сельска-гаспадарчых школ і іншых працаўнікоў сельскай гаспадаркі, якія ў сваёй рабоце павінны перайсьці на беларускую мову, патрабуе безадкладнага выданьня слоўніка сельска-гаспадарчай тэрмінолёгіі, хаця-б і няпоўнай і не канчаткова ўстаноўленай. 3 гэтай прычыны былая Сельска-Гаспадарчая Сэкцыя Інстытуту Беларускае Культуры ўтварыла асобную тэрмінолёгічную камісію ў складзе аграномаў Я. Грабоўскага, Я. Кісьлякова, М. Лайкова, П. Рагавога і А. Смоліча, якая апрацавала матар‘ялы да слоўніка сельска-гаспадарчай тэрмінолёгіі, перагледжаныя і адобраныя да друку Галоўнай Тэрмінолёгічнай Камісіяй Інстытуту.</p>
	<p>Крыху пазьней пры Навуковым Таварыстве для вывучэньня Беларусі ў Горках, якое зьяўляецца ўстановаю Інстытуту Беларускае Культуры, утварылася некалькі тэрмінолёгічных камісій, якія зьбіраюць і апрацоўваюць матар'ялы па асобных галінах сельска-гаспадарчых навук адпаведна да патрэб выкладаньня гэтых навук у вышэйшай школе.</p>
	<p>Выдаючы тым часам памянёныя матар‘ялы да слоўніка, Інстытут Навуковае Мовы просіць усіх зацікаўленых у існаваньні бездаганнай сельска-гаспадарчай тэрмінолёгіі прысылаць свае ўвагі, дадаткі і папраўкі.</p>
	<p> </p>
	<p>26.ІV.28 г.</p>
	<p>Інстытут Навуковае Мовы.</p>
</div>
##HTMLDescription_END
##ArticleLang: ru/be

абсолютный вес семян	шру´бавая
аграрный	агра´рны 
агрикультурные мероприятия	агрыкульту´рныя мерапрые´мствы 
агроном	аграно´м 
агрономическая лаборатория	аграномі´чная лябораторыя 
агрономический	аграномі´чны 
агрономия	аграно´мія 
акация белая	ака´цыя бе´лая 
альбумин	белкаві´на, альбумі´на 
амбар	клець, сьві´ран 
аппробатор	апраба´тар 
арбуз	каву´н 
аренда	арэ´нда, пасэ´сія 
аренда молочного стада	пакт 
арендатор	аранда´тар, пасэ´сар 
арендатор молочного стада	па´ктар 
арендатор при делении снопами	сно´пшчык 
арендование	арандава´ньне 
арендовать	арандава´ць 
бабка (для клепанья косы)	ба´бка 
бабка или путо (у лошади на ноге)	ба´бка, цы´рка 
бабка снопов	мэ´тлік, ба´бка 
бадья	чоп 
базар	торг, ры´нак 
баклажан	баклажа´н 
бактериальное удобрение	бактэрыя´льнае ўгнае´ньне 
балка (в постройке)	ба´лька, бэ´лька 
балка (заросший овраг)	лог, роў 
барабан (в молотилке)	бараба´н 
барак	бара´к 
барашек	бара´нчык 
барда	бра´га 
барщина	па´ншчына
батрак	па´рабак 
батрацкий посев	ато´рыца 
батрачка	на´ймічка, парабча´нка 
безазотистые экстрактивные вещества	безазо´тныя экстракты´ўныя матэ´рыі 
безводный овраг	сухі´ роў 
бездождие	бяздо´жджыца 
бездорожье	бездаро´жжа, бе´здараж 
безземелье	безьзяме´льле 
безземельный	безьзяме´льны 
белая ржавчина	бе´лая іржа´ 
белковина	белкаві´на 
белок	бяло´к 
белок семени	бяло´к се´мя 
белоус (Nardus)	сіве´ц 
белый клевер	бе´лая канюшы´на 
бельмо	бяльмо´ 
бесплодная земля	бяспло´дная зямля´ 
бесплодные бастарды	няпло´дныя баста´рды 
бесплодный	няпло´дны 
бесполое размножение	бяспло´цьцевае размнажэ´ньне 
бивни (у свиньи)	клыкі´
било (цепа)	біч, бічу´к 
бичевка	шпага´т
бланжевый (масть лошади)	палавы´ 
блеск	бляск 
бобы	струкі´
болезнь	хваро´ба 
болотный сенокос	сенажа´ць бало´тная 
болото	бало´та 
болото моховое	імша´рыстае бало´та 
болото поросшее ольхой	алё´с, ку´дра 
болото топкое	ба´гна 
болтень, болт (рыбачья принадлежность)	бо´ўтка, боўт 
болтень (яйцо)	баўту´н 
болтушка (корм для скота)	калату´ха, бо´ўтанка, баўту´ха 
бор	бор 
боров	парсю´к 
боровок	парсючо´к 
боровой песок	баравы´ пясо´к 
борозда	баразна´ 
борозда водосточная	рышто´к 
бороздка	баразё´нка 
борона дисковая	барана´ ра´ндаль, тале´ркавая 
борона Лакке	барана´ Ля´кке 
борона легкая	барана´ лё´гкая 
борона луговая	барана´ сенажа´тная 
борона норвежская	барана´ нарвэ´ская 
борона простая	барана´ про´стая 
борона пружинная	cпружыно´ўка, драпа´ч, драпа´к 
борона сложная	барана´ склада´ная 
борона тяжелая	барана´ цяжка´я 
борона членистая	барана´ суста´ўная 
боронование	баранава´ньне; скарадзьба´
боронование озими	баранава´ньне ру´ні 
боронование в первые следы (чаще в длину)	лама´ньне во´рыва або´ ральлі´
ботаническая зрелость	ботані´чная сьпе´ласьць 
ботва	наць, наці´ньне 
ботва картофельная	бульбо´ўнік, картапля´нік 
ботва свекловичная	бацьві´ньне 
бочка	бо´чка 
бревно	бервяно´
бричка	бры´чка, вазо´к 
бросовые земли	кідо´мыя зе´млі 
брюква	бру´чка 
брюхо поджарое, отвислое	чэ´рава хударля´вае, бру´ха паджа´рыстае 
буланая лошадь	була´ны конь 
бурав	сьве´рдзел, сьві´дар
буравчик	cьвярдзё´лак 
бурое сено	бу´рае се´на 
бурт, бунт	капе´ц 
бык	буга´й, бык 
быстрота прорастания	шы´бкасьць прараста´ньня 
бэконная фабрика	бэ´конная фа´брыка 
бэконный откорм	бэ´конны вы´карм 
вал (земляной)	вал, на´сып 
вал (в машине)	вал 
валёк (для двух лошадей)	стальва´га 
валёк (для пристяжки лошади)	во´рчык 
валовой доход	агуло´вы дахо´д, агуло´вы прыбы´так 
валух	ва´лух 
валяльные изделия	ва´леныя вы´рабы 
валяльщик	валю´шнік 
варка сыров	гато´ўля сы´ру 
вегетативный	вэгетацы´йны 
вегетационный опыт	вэгетацы´йны до´сьлед 
вегетационный период	вэгетацы´йны пэры´ёд 
венчик	вяно´чак 
вереск	ве´раск 
верхний волос	ве´рхні во´лас 
верховая езда 	язда´ вярхо´м 
вес	вага´ 
весенняя вспашка	веснаво´е ара´ньне, -а´я во´рка 
весы десятичные	ва´гі 
весы коромысловые	ша´лі 
ветвление	галінава´ньне 
ветвь	галі´на 
ветеринар	вэтэрына´р 
ветеринария	вэтэрына´рыя 
веха	ты´чка, ві´тка 
веялка ручная	ве´ялка ручна´я 
веялка-сортировка	а´рфа 
веянье машинное	арфава´ньне 
веять на машине	арфава´ць 
взмет	ара´ньне пе´ршае 
вика	ві´ка 
виковая смесь	ві´кавая ме´шанка 
вилок	кача´н 
вилы	ві´лкі 
вилы навозные деревянные	сахо´р, ві´лы 
винокуренный завод	бро´вар сьпіры´тусны 
вкус молока	смак малака´ 
влага	ві´льгаць 
влажность	вільго´тнасьць 
внутренности	вантро´бы 
внутриселенное землеустройство	унутрасе´льнае зямляўпарадкава´ньне 
внутрихозяйственные условия	унутрагаспада´рчыя ўмо´вы 
водопад	вадаспа´д 
водопроницаемость	вадапрапушча´льнасьць 
водоскат	вадасьцё´к
водосточные борозды	водасьце´чныя баро´зны 
водоудерживательная способность	вадаўтрыма´льная здо´льнасьць 
водянистое молоко	вадзяні´стае малако´
водянистый	вадзяні´сты 
возделываемый слой	вырабны´ пласт 
возделывание земли	вырабле´ньне зямлі´ 
возделывание растений	культу´ра расьлі´н 
возраст	век, узро´ст 
волокно	валакно´
волокуша	валаку´ша 
волос	во´лас 
воронка (посуда)	ле´йка 
вороной	вараны´ 
ворох	ку´ча 
ворсильная шишка	во´рсавая шы´шка 
в развал (пахота)	у ро´скідку 
вредитель	шко´днік 
вредные примеси	шко´дныя до´мешкі 
время посева	час сяўбы´ 
вспахать	узара´ць 
вспахивание	узо´рваньне 
вспахивать	узо´рваць 
вспашка	ара´ньне 
вспашка в развал	ара´ньне ў ро´скідку 
вспашка в свал	ара´ньне ў скла´д 
вспашка глубокая	ара´ньне глыбо´кае 
вспашка мелкая	ара´ньне ме´лкае 
вспашка на „зябь"	ара´ньне на´ зіму, зябле´ньне 
вспашка предпосевная	ме´шань 
вспашка средняя	ара´ньне сярэ´дняе 
всходить	усхо´дзіць 
всходы	усхо´ды 
всходы озимых	усхо´ды азі´міны 
всходы ровные	усхо´ды ро´ўныя 
всхожесть	усхо´днасьць, абхо´днасьць 
второстепенный продукт	другара´дны праду´кт 
выбивание ветром	выбіва´ньне ве´трам 
выбитая телегой яма на дороге	калдо´біна, калдо´ба 
выбраковка	бракава´ньне 
выводка конская	вы´вадка ко´няй 
выгон	вы´ган 
выгребная яма	гнаё´вая я´ма 
выделение (из семьи)	вы´дзел 
выделение молока	выдзяле´ньне малака´ 
выдергивание	вырыва´ньне, выску´бваньне 
выжигание	выпа´льваньне 
выжигание дерна (кудряшей)	выпа´льваньне дзё´рну 
выжимки	аджы´мкі 
выжимки (перетер)	жма´кі, маку´ха 
вызревание (хлебов)	высьпява´ньне 
выкапывать	выко´пваць 
выкармливание, откорм	вы´карм 
вымерзание посевов	вымярза´ньне засе´ваў 
вымокание посевов	вымака´ньне засе´ваў 
вымолот	вы´малат 
вымораживание сорных трав	вымаро´жваньне пустазе´льля 
вымочка	вы´мачка 
вымывание крахмала	вымыва´ньне крухма´лу 
вымя	вы´мя 
выносливость	трыва´ласьць 
выпалывание	выпо´лваньне 
выпаривание	выпа´рваньне 
выпахивание	выво´рваньне 
выпойка	выпо´йваньне 
выпревание посевов	выправа´ньне засе´ваў 
выпрягать	выпрага´ць 
выработка	вы´рабка 
выравнивание	выраўне´ньне 
вырастать	выраста´ць 
выращивание	гадо´ўля 
выращивание молодняка	гадава´ньне маладняка´ 
выращивать	гадава´ць 
вырубка (место после вырубленного леса)	па´сека 
высадки	насе´ньнікі, вы´садкі 
высевать	высява´ць 
выселок	вы´селак 
высиживать	высе´джваць 
высушивание	высу´шваньне 
высыхание	высыха´ньне 
вытягивать	выця´гваць 
вытяжка	вы´цяжка 
выщелачивание	выпало´скваньне 
вязанка луку	пляцё´нка, вяно´к цыбу´лі 
вязкость	вя´зкасьць 
газон	газо´н 
газообмен почвы	газапаме´н гле´бы 
галопом	гало´пам, наўска´ч, галё´пам 
гать	грэ´бля, гаць 
гвозди подковные	гуфналі´ 
генеологический	генэалёгі´чны, родаво´дны 
генерация	генэра´цыя 
гессенская муха (гессенский комарик)	гэ´сэнская му´ха 
гипсование	гіпсава´ньне 
глина	глі´на 
глинозем	гліназе´м 
глотание	глыта´ньне 
глубина	глыбіня´
глыба	глы´за, гру´да 
глыбодроб	рубча´сты ва´лец 
гнедой	гняды´ 
гниение (при достатке влаги)	гніе´ньне, гніцьцё´
гниение (при недостатке влаги)	парахне´ньне 
гниль (влажная)	гнільлё´
гниль (сухая)	парахня´ 
гниль картофельная	бульбяна´я гніль 
гноение	гнае´ньне 
голландская порода	галяндэ´рская паро´да 
головка свеклы	гало´ўка бурака´, пя´ціўка 
головня	галаўня´, са´жа 
гололедица	галалё´д 
горбыль (доска)	апо´лак 
горох	гаро´х 
грабельщик	грабе´ц 
грабли	гра´блі 
град	град 
градобитие	градабі´цьце 
граница (хозяйственная)	мяжа´ 
граничащий	суме´жны 
гребень	грэ´бень 
гребешок	грабяне´ц, грабе´нчык 
гребневая пахота	ара´ньне у гра´нкі, гране´ньне 
греча, гречиха	грэ´чка 
гриб	грыб 
гриб древесный	губа´ 
грибница	грыбні´ца 
грива	гры´ва 
грубый корм	грубы´ корм 
груда (камней)	кру´шня 
грунт	грунт 
груша дикая	дзі´кая гру´ша 
груша культурная	садо´вая гру´ша 
гряда	града´, ляха´ 
грядиль (в плуге)	ды´шаль 
гуано	гуа´на 
гулевой (скот)	выпасо´вы 
гумно (постройка)	гумно´ 
гумус	гу´мус, перагно´й 
гусеница	ву´сень 
дамба	да´мба 
дача корма	по´рцыя ко´рму, дава´нка ко´рму 
двоение	мяша´ньне, друе´ньне 
двузернянка	двухзярнё´ўка 
двуколка	двухко´лка 
делянка	дзяля´нка 
деревенский	вяско´вы, дзераве´нскі 
деревня	вё´ска, дзярэ´ўня 
деревцо	дрэ´ўца 
деревья плодовые	пладо´выя дрэ´вы 
деревянная лопатка для точки косы	мянту´шка 
дернина	дзё´ран, дзярно´, дзірва´н 
дерносним	перадплу´жнік 
дерть	кры´шанае зе´рня, дзерць 
десятина	дзесяці´на 
динамика урожаев	дына´міка ўраджа´яў 
динамометр	дынамамэ´тр, сіламе´р 
дифференциация	дыфэрэнцыя´цыя 
дичок	дзі´чка 
дневной удой	дзё´нны ўдой 
днище	дні´шча 
доение	дае´ньне 
дозревание (хлебов)	дасьпява´ньне 
дозревать	дасьпява´ць 
дозрелый	дасьпе´лы 
домашние животные	сво´йская жывё´ла
донце (луковицы)	пя´тка 
дорога проселочная	прасё´лак 
дорога почтовая	шлях, гасьці´нец
дорога грунтовая	грунтава´я даро´га 
древесина	драўні´на 
древесная листва	лісьцё´ дрэў 
древесный уголь	дрывяны´, дрэ´ўны ву´галь 
древко косы	касьсё´, касі´льна 
древоразведение	дрэвагадо´ўля 
дренаж	дрэна´ж 
дренирование	дрэнава´ньне 
дрены	дрэ´ны 
дрены осушительные	асуша´льныя дрэ´ны 
дрены собирательные	зьбіра´льныя дрэ´ны
дресва	жарства´ 
дробина	саладзі´ны 
дробленое зерно	кры´шанае зе´рня 
дробь охотничья	шрот 
дуга	дуга´ 
дыня	ды´ня 
единицы питательной ценности	адзі´нкі пажы´ўнае ва´ртасьці 
жабры	жэ´бры, зя´бры 
жатва	жніво´ 
жатвенная машина	жнівя´рка 
жвачка	жу´йка, жава´йка 
жевание	жва´ньне, жава´ньне 
желвак (на затылке у лошади)	жаўла´к 
желтая или восковая зрелость	жо´ўтая або´ васкава´я сьпе´ласьць 
желудок	кіньдзю´к, стра´ўнік 
жердь (для увязывания воза)	рубе´ль 
жердь (огор. и сад.)	жэ´рдка 
жеребение	жарабе´ньне 
жеребенок	жарабя´ 
жеребец	жарабе´ц 
жеребиться	жарабі´цца 
жеребость	жаро´бнасьць 
жернова (ручные)	жо´рны 
живой вес	жыва´я вага´ 
животновод	жывёлагадо´вец 
животноводство	жывёлагадо´ўля 
животное	жывё´ла 
животное домашнее	сво´йская жывё´ла 
животные вредные	шко´дныя жывё´лы
жир	тлу´стасьць, тлушч 
жир с брюшины и кишек	здор, лой 
жирномолочность	тлустамало´чнасьць 
жировые шарики	тлу´шчавыя га´лкі 
жмыхи	маку´ха 
жнейка	жнівя´рка 
жнивье	жні´вішча 
жнивье овсяное	аўся´нішча 
жнивье ржаное	аржо´ньне, іржы´шча 
жнивье ячменное	жні´вішча я´чнае 
жница	жняя´ 
жолуди(жёлуди)	жалуды´ 
журавль (колодезный)	жураве´ль, асьве´р 
жучек(жучок) картофельный	бульбяны´ жучо´к 
заарендовать	заарандава´ць 
заболачивание	забало´чваньне 
забор из жердей	плот 
забор каменный	мурава´ная агаро´жа 
забор щитный	парка´н 
заводская конюшня	заво´дзкая ста´йня 
загнивание	загніва´ньне 
загон (в поле)	заго´н 
загон (для скота)	за´гарадзь 
загародка	за´гарадка 
заготовительная организация	загато´ўчая організа´цыя 
заделка навоза	заво´рваньне гно´ю 
заделка (семян)	запа´хваньне 
задушение сорных трав	задушэ´ньне пустазе´льля 
заказный луг	забаро´нная по´жня, забаро´нная сенажа´ць 
закваска хлебная	заква´ска хле´бная 
закон минимума	зако´н мі´німуму 
закон падающей производительности почвы	зако´н спада´льнае вытво´рчасьці гле´бы 
закром	засе´к 
закром хлебный	засе´к 
залежное хозяйство	абло´жная гаспада´рка 
залежь	абло´га, дзірва´н 
заливной луг	заліўны´ луг, по´плаў 
залужение	запуска´ньне пад сенажа´ць 
заморыш	замо´рак 
занятой пар	заня´ты папа´р 
запаренный корм	па´ранка 
запас труда	запа´с пра´цы 
запах	пах 
запахивать	заво´рваць 
запашка	запа´шка 
заплесневеть (о печеном хлебе)	зацьвісьці´ 
запруда	гаць 
запрягать, запречь	запрага´ць, запрэ´гчы 
запускать корову	запуска´ць каро´ву 
заражение	заражэ´ньне 
зародыш	заро´дак 
зародышный мешок	заро´дкавы мяшок 
заросль	за´расьнік 
засаживать	заса´джваць 
засевать	засява´ць 
заслонять	засланя´ць, за´сьціць 
засоренное поле	засьме´чанае по´ле 
засоренность семян	засьме´чанасьць насе´ньня 
заступ	рыдлё´ўка, жалязьня´к 
засуха	сухме´нь, суш 
затенение	зацяне´ньне, за´сьценьне 
затопление (наводнение)	затапле´ньне 
затрата труда	затра´та пра´цы 
зауздать (лошадь)	закялза´ць (каня´) 
захват	захва´т 
зацветать, зацвести	зацьвіта´ць, зацьві´сьці´, закрасава´ць 
зацепка (предмет)	за´чапка 
защита растений	ахо´ва расьлі´н 
защитные насаждения	ахо´ўныя расьлі´ны 
зеленое удобрение	зялё´нае ўгнае´ньне 
зеленый пар	зялё´ны папа´р 
зелень	зеляні´на 
зелень (краска)	зялё´нка (фа´рба) 
земельная рента	зяме´льная рэ´нта 
земельный	зяме´льны 
землевладелец	зямляўла´сьнік 
землевладение	зямляўлада´ньне 
земледелец	зямляро´б, ро´льнік 
земледелие	зямляро´бства, ро´льні´цтва 
земледельческий	зямляро´бскі, ро´льніцкі 
земледельческие машины	зямляро´бныя, ро´льніцкія машы´ны 
землеизмерительный	геадэзы´чны, зямляме´рчы 
землекоп	граба´р 
землемер	камо´рнік 
землемерие	камо´рніцтва 
землемерный	камо´рніцкі 
землеобеспеченность	зямлязабясьпе´чанасьць 
землепашец	ро´льнік 
землепользование	зямлякарыста´ньне 
землеустройство	зямляўпара´дкаваньне 
землечерпательный	зямлячарпа´льны 
землистый	земляны´ 
землистый цвет	земляны´ ко´лер 
земля	зямля´ 
земляная насыпь	земляны´ на´сып 
земляника	суні´цы 
земля общественная	грама´дзкая зямля´ 
земля пахотная	во´рная зямля´
зерно	зе´рня 
зерно второго сорта	зе´рня-друга´к 
зерновое хозяйство	зярнё´вая гаспада´рка 
зерновые культуры	збо´жжавыя культу´ры 
зерновые хлеба	збо´жжа 
зерноочистительный пункт	збожжаачышча´льны пункт 
зернышко	зярня´тка 
злак	збажы´на 
злаки хлебные	збо´жжа 
змейка (машина)	зьмяё´ўка 
зоб (у птицы)	во´льле, вальлё´
зола	по´пел 
зольное вещество	по´пельная матэ´рыя 
зона	пас, зо´на 
зоогигиена	зоагігіе´на 
зрелость	сьпе´ласьць 
зрелый	сьпе´лы 
зреть	сьпець 
зуб в бороне, зубья	зуб, зубы´ 
зубы постоянные	зубы´ пастая´нныя 
зуд	сьверб, чос 
ива (дерево)	вярба´ 
ива (кустарник)	лаза´ 
ивняк	лазьня´к 
избыток	лі´шак 
избыточное увлажнение	збы´тняя вільго´тнасьць 
избыточно-увлажненные почвы, иловки	зана´дта вільго´тныя гле´бы, маклякі´
избыточный труд	збы´тняя пра´ца 
известкование	вапнава´ньне 
известковое молоко	вапе´ннае малако´ 
известь	ва´пна 
извитая шерсть	сукры´стая, пакру´чаная во´ўна 
изгородь из лежачих жердей	плот 
изгородь из стоячих переплетенных тонких кольев	частако´л, тыно´к 
изгородь проволочная	драцяна´я агаро´жа 
изгородь сплетенная из хвороста	пляце´нь 
изгородь (фигурная из строганого материала)	штаке´ты 
изделие	вы´раб 
издержки	затра´ты, тра´ты, выда´ткі 
измельчать (сделаться малым)	здрабне´ць 
измельчить	здрабні´ць 
изменчивость (организмов)	зьме´нлівасьць 
израстать	параста´ць 
изреживаться (о всходах)	радзе´ць 
ил	мул, глей 
илистый	му´лісты, гляі´сты, гле´йкі 
имение	двор, маё´нтак 
инвентарь	інвэнта´р 
индейка, индюк	інды´чка, інды´к 
инкубатор	інкуба´тар 
инсектисиды	інсэктысы´ды 
интенсивность	інтэнсы´ўнасьць 
интенсификация	інтэнсыфіка´цыя 
инфильтрация или просачивание	інфільтра´цыя або´ прасо´чваньне 
искусственное гуано	шту´чнае гуа´на 
искусственные удобрения	шту´чныя ўгнае´ньні 
испарение	выпарэ´ньне 
испытание	выпрабава´ньне 
истощение почвы	спусташэ´ньне гле´бы, высіле´ньне гле´бы 
кабан дикий	дзік, каба´н дзі´кі 
кабан (кастрирован.)	япру´к, парсю´к 
каинит	каіні´т 
кайма	шляк, кайма´ 
калий	ка´лі 
канава	кана´ва, рышто´к 
канавка	кана´ўка, рышто´к 
капиталоинтенсивность	капіталаінтэнсы´ўнасьць 
картофель	бу´льба, карто´пля 
картофелекопатель	бульбакапа´лка 
картофелесажалка	бульбасаджа´лка 
картофельная ботва	бульбо´ўнік, картапля´нік 
картофелеобрабатывающий завод	бульбя´рня 
каток	ва´лец, като´к 
кирка	маты´ка 
кирпич	цэ´гла 
кислотность почвы	кісло´тнасьць гле´бы 
кладовая	камо´ра, кладо´ўка 
клевер	канюшы´на 
клевер белый	канюшы´на бе´лая 
клевер красный	канюшы´на чырво´ная 
клеверная терка	канюшы´нная це´рніца 
клеверище	канюшы´нішча 
клевероутомление	канюшыназмо´ранасьць 
клещи	абцугі´
клин (участок земли)	пале´так, зьмяна´
клубень	бу´льбіна 
клубеньковые бактерии	корнябаро´даўкавыя бактэ´рыі 
клубника	труска´ўкі, суні´цы агаро´дныя 
клуня	пу´ня
клык	клык, іко´л
клюв	дзю´ба 
клюква	жураві´ны
книжка (орган тела)	кні´жка, кні´га 
кнут	пу´га 
кнутовище	пугаўё´
ковать	кава´ць, куць 
ковка (лошади)	кава´ньне 
кожух	кажу´х 
козлы	казлы´, сталю´га 
колесная мазь	калама´зь 
колесо	ко´ла 
колея	каляі´на 
коллектор (главный канал при осушении)	коле´ктар 
коллекционный питомник	колекцы´йны гадава´льнік, шко´лка 
колодец	кало´дзеж, сту´дня 
колос	ко´лас 
колоситься	каласі´цца, выплыва´ць 
колышек (межевой знак)	па´лік 
комбинированная сеялка	комбінава´ная сявя´рка, сяўні´к 
комель	каме´ль 
комковатость	грудкава´тасьць 
комок	гру´дка 
комолый (безрогий)	лаба´ты (бязро´гі) 
компост	компо´ст 
коневодство	гадо´ўля ко´няй 
конек крыши	ваўчо´к 
конные грабли	ко´нныя гра´блі 
конный привод	мане´ж 
коновал	канава´л 
конопля	кано´плі 
конопляный	канапля´ны 
контроль-ассистент	кантро´ль-асыстэ´нт 
контрольное товарищество	кантро´льная супо´лка 
концентрированный корм	концэнтрава´ны корм 
конюх	каню´х 
конюшня	ста´йня 
копна	капа´ 
копыто	капы´т 
корень	ко´рань, карэ´нь 
корешок	карэ´нчык, каранё´к 
корка	скары´нка 
корм	корм 
корм растительный	корм расьлі´нны 
кормление	кармле´ньне 
кормовая дача	дава´нка 
кормовая единица	кармо´вая адзі´нка 
кормовая смесь из соломы и сена	тру´шанка, трася´нка 
кормовой баланс	кармо´вы баля´нс 
кормовая площадь	кармо´вая пло´шча 
кормушка	я´сьлі, жо´лаб 
корневая система	каранё´вая сыстэ´ма 
корневище	сьцябло´-ко´рань 
корнеплод	корняпло´д 
корнерезка	корнярэ´зка 
корова молочная (не яловая)	каро´ва до´йная 
корова молочная (обильная)	каро´ва ўдо´йлівая 
коровник	хлеў, або´ра 
короткорогая (порода)	куцаро´гая 
корпус плуга	стан плу´га 
корчевать	карчава´ць 
корыто (для корма скота)	кары´та 
коса (для кошенья)	каса´ 
косвенное удобрение	пасрэднае ўгнае´ньне 
косилка	касі´лка, каса´рка 
кострика	кастры´ца; мя´леньне 
костяк (скелет)	касьця´к 
костяная зола	касьцяны´ по´пел 
костяная мука	касьцяна´я мука´ 
косьба	касьба´ 
котловина	катлаві´на 
кочан	кача´н 
кочка	ку´піна 
кочкорез	куп’ярэ´з 
краткосрочный кредит	кароткатэрміно´вы крэды´т 
крахмал	крухма´л 
крахмальный	крухма´льны 
крестец	крыж 
крестец (из снопов)	крыж, кры´жык 
крестьянин	селяні´н 
крестьянский	сяля´нскі 
крестьянство	сяля´нства 
кровля, крыша	дах, страха´ 
кролик	трус 
крона (дерева)	каро´на 
крот	крот 
круп	круп, зад 
крупа	кру´пы 
крупное хозяйство	вялі´кая гаспада´рка 
крупный рогатый скот	бы´дла 
крыжовник	а´граст 
кудель	кудзе´ля 
кузнец	кава´ль 
кузница	ку´зьня 
куколь	куко´ль 
культиватор	культыва´тар 
кумыс	кумы´с 
купанье	купа´ньне 
курятник (помещение)	кату´х 
кустарник	хмызьня´к 
кустарник ягодный	я´гаднік 
кустарные промыслы	ха´тнія про´мыслы 
куститься	кусьці´цца, грані´цца 
лабаз	лаба´з 
лабазник	лаба´зьнік 
лактационный период	ляктацы´йны пэры´ёд 
легкое зерно	лё´гкае, нява´жкае зе´рня 
ледник	лядо´ўня 
лежалые семена	зале´глае, заляжа´лае насе´ньне 
лейка	паліва´чка 
лемех	ляме´ш, наро´г 
лен	лён 
лен-долгунец	лён-даўгуне´ц 
лента землемерная	сту´жка камо´рніцкая 
ленточный посев	сту´жачны засе´ў 
лесистый	лясі´сты 
лёс (Löss)	лёэс (націск хутчэй за ўсё на ё, але ў папяровым пазначаны невыразна)
летучий песок	ляту´чы пясо´к, паўзу´н 
лещина, орешник	ляшчы´на, ляшчэ´ўнік 
ливень	лі´вень, уле´ва 
лизиметр	лізымэ´тр 
линять	ліня´ць 
лисий	лісі´ны 
лисица	ліс, ліса´ 
лисохвост	лісахво´ст 
листва	лісьцё´
личинка	ля´рва 
ложбина	лагчы´на 
лоза	лаза´ 
локомобиль	лёкамобі´ль 
ломка трехполья	лама´ньне трохпалё´ўкі 
лопата	рыдлё´ўка, лапа´та 
лопата с приподнятыми краями	шу´фель 
лошадь	конь 
лошадь со скрытой железой	нутрэ´ц 
луг болотный	луг бало´тны 
луг заливной	луг заліўны´, по´плаў 
луг лесной	луг лясны´ 
луг сенокосный	сенажа´ць, по´жня 
луг хороший сухой	муро´жная сенажа´ць, муро´г 
луговодство	паплаўні´цтва, лугава´я гаспада´рка 
луговой	лугавы´ 
лужайка	лужо´к 
лук	цыбу´ля 
лунка	я´мка 
лущение	лушчэ´ньне 
лущильник	лушчы´льнік 
льнище	ільня´нішча, ільні´шча 
льноводство	ільня´рства 
льнообделочные пункты	ільнаро´бныя пункты 
льняная трещетка(трещотка)	ільняна´я трашчо´тка 
льняной	альняны´, ільняны´ 
люпин	лу´бін 
лядо	ля´да 
мазанка	ляпя´нка, тынкава´нка 
майский жук	хрушч 
мак	мак 
малина	малі´на 
малинник	малі´ньнік 
малоземелье	малазяме´льле 
маломощные хозяйства	маламо´жныя гаспада´ркі 
маркер	ма´ркер, зна´чнік 
масло бить	біць ма´сла; гнаць але´й 
маслобойка	бо´йка 
маслобойня	маслабо´йня 
маслодельный завод	масьля´рня 
масло коровье	ма´сла 
масло растительное	але´й 
масло сливочное	ма´сла сьметанко´вае 
масло сметанное, чухонское	ма´сла сьмята´ннае 
масть	масьць 
материнская порода	мацяры´нская паро´да 
материнский клубень (картофеля)	мацяры´нская бу´льбіна 
маточные рожки (спорынья)	ражкі´, спор 
маховик	махаві´к 
машина для очистки зерна	машы´на для ачы´сткі зе´рнят 
машина корчевальная	карчава´льная машы´на, карчава´лка 
машины сельскохозяйственные	машы´ны сельскагаспада´рчыя 
медведка	сяка´ч, туро´к 
медный купорос	сі´ні ка´мень 
межа	мяжа´ 
междурядие	міжра´дзьдзе 
межевание	межава´ньне 
межник	узьме´жак 
мелиорация	мэліёра´цыя 
мелкая заделка	плы´ткае запа´хваньне 
мелкая вспашка	плы´ткае ара´ньне 
мелкое хозяйство	дро´бная гаспада´рка 
мелкозернистая почва	крупкава´тая гле´ба 
мельник	ме´льнік, млына´р 
мельница	млын, млін 
мельница ветряная	вятра´к 
мельница водяная	вадзяны´ млын, млін 
мельница паравая	паравы´ млын, млін 
мергелевание почвы	маргелява´ньне гле´бы 
мергель	ма´ргель 
мерин	конь 
мериносовая овца, меринос	мэрыно´с, шпа´нка 
мертвый покров	мё´ртвы насьці´л 
метизация	мэтыза´цыя 
мех (пушнина)	шку´рка 
мех (в кузнице)	мех 
можжевельник	яло´вец, ядло´вец 
мокрая почва	сіпа´к, мо´края гле´ба 
молодняк	маладня´к 
молозиво	мало´дзіва 
молоко кислое (простокваша)	сыраква´ша, кі´слае малако´ 
молоко кипяченое	па´ранае малако´ 
молоко скисшее, полузакисшее	малако´ пракі´слае, бры´зглае 
молоко снятое или тощее	малако´ зьня´тае, зьбіра´нае 
молотилка	малата´рня 
молоток для отбивки кос	кляве´ц 
молотый	мо´латы, ме´лены 
молотьба	малацьба´ 
молочная зрелость	мало´чная сьпе´ласьць 
молочница	малача´рка, мало´чніца 
молочное дело	малача´рства 
молочное хозяйство	малача´рская гаспада´рка 
молочные артели	малача´рскія арце´лі 
молочные колодцы	мало´чныя я´мкі 
молочные продукты	малача´рскія праду´кты 
молочные отбросы	малача´рскія адпа´дкі, во´дкіды 
молочный сахар	мало´чны цу´кер 
молочный скот	мало´чная скаці´на 
мотыжение междурядий	матыкава´ньне міжра´дзьдзяў 
мотыльковые растения	стручко´выя расьлі´ны 
морг (мера поверхности)	морг 
морковь кормовая	мо´рква кармо´вая 
мох	мох 
моховое болото	амша´ра 
моча	мача´ 
мочки	то´нкія каранькі´, махра´чыкі 
мука для сдабривания грубых кормов	во´бмешка, во´бсыпка 
мязга (картофель)	мязга´ 
мякиш	мя´кіш 
мясо-шерстное овцеводство	мя´сна-ваўня´нае аўча´рства 
мятлик	мятлі´ца 
набухнуть	набрыня´ць 
навес	паве´ць, паве´тка, прыстрэ´шак 
наводнение	пато´па, паво´дка 
навоз	гной 
навоз перепревший	гной перапрэ´лы 
навоз свежий	гной сьве´жы 
навоз теплый, или горячий	гной цё´плы, або гарачы 
навоз холодный	гной хало´дны 
навозная жижа	гно´йная жы´жка 
навозное удобрение	угнае´ньне 
навозохранилище	гно´ішча, гнаё´ўня 
нагуливаться	ад’яда´цца, адпа´свацца 
нагульный	напа´сны, нагульны´ 
надел (участок земли)	надзе´л 
наемный рабочий	па´рабак, парабча´нка; на´йміт, на´ймічка, на´ймітка 
наиливание	наму´льваньне 
наковальня	кава´дла 
на корне	на пні´ 
налог	пада´так 
на племя	на плямя´ 
наседка	квакту´ха 
насест	куро´садня 
насиживание	насе´джваньне 
наследственность	насьле´днасьць, спа´дчыннасьць 
насыпная культура	насыпна´я культу´ра 
натурально-потребительское хозяйство	натура´льна - спажыве´цкая гаспада´рка 
натура семян	нату´ра насе´ньня 
на убой	на зарэ´з, на ўбо´й 
недозрелость	недасьпе´ласьць 
недозрелый	недасьпе´лы 
недоуздок	абро´ць, во´бруць 
незерновые культуры	нязбо´жжавыя культу´ры 
незрелость	нясьпе´ласьць 
необрабатываемая в течении ряда лет и незасеваемая земля	я´лавіна 
неприхотливость (к корму)	неперабо´рлівасьць 
непроросший	непраро´слы 
непроростающие(непрорастающие) семена	непраро´сьлівае насе´ньне 
нетель	падцё´лак 
нетрудовое хозяйство	непрацо´ўная гаспада´рка 
неурожай	неўраджа´й 
неурожайность	неўрадлі´васьць, неўраджа´йнасьць 
нехозяйственность	негаспада´рнасьць 
нива	ні´ва 
нивеллировка	нівэліро´ўка 
нитраты	нітра´ты 
нитрификация	нітрыфіка´цыя 
новь (залежь)	навіна´ 
нож у плуга	раза´к, нож 
норвежская селитра	нарвэ´ская сале´тра 
норма потребления	но´рма спажыцьця´ 
об'емистый(объёмистый) корм	грубы´ корм 
об’емный(объёмный) вес семян	аб’ё´мная вага´ насе´ньня 
обложение	абклада´ньне, абкла´дка 
обмолот	абмало´т 
обод	во´бад 
оборот	зваро´т 
обработка земли	вы´раб зямлі´ 
обработка (молока)	апрацо´ўка 
обрезка	абрэ´зка 
обруч	абру´ч 
обсеменить	абсе´яць 
обух	абу´х 
общественная агрономия	грама´дзкая аграно´мія 
овёс	авё´с 
овёс шатиловский	авё´с шаці´лаўскі 
овечий	аве´чы 
овин	ё´ўня, асе´ць 
овод	авадзе´нь, авадзё´н 
овощи	гаро´дніна 
овраг	роў, раўча´к 
овсянище	аўся´нішча 
овца	аве´чка 
овцеводство	аўча´рства 
овчар	аўча´р 
овчина	аўчы´на 
оглобля	агло´бля 
огневая система	агнява´я сыстэ´ма 
огораживание	агаро´джваньне 
огород	гаро´д, агаро´д 
огородник	гаро´днік, агаро´днік 
огородничество	гаро´дніцтва, агаро´дніцтва 
огородные семена	гаро´днае, агаро´днае насе´ньне 
ограда	агаро´жа 
огрех	агрэ´х, узрэ´х, цалю´к 
огурец	гуро´к, агуро´к 
однотипность	аднатыпо´васьць 
одобренный производитель	ухва´лены племяньні´к 
одонья	адо´нкі 
ожирение	атлушчэ´ньне 
озадки	паза´дкі 
озимая пшеница	азі´мка-пшані´ца 
озимая рожь	жы´та 
озимые посевы	азі´мыя засе´вы 
озимые хлеба´	азі´мае збо´жжа 
озимь	азі´міна 
оковка	аку´цьце 
околот	акало´т 
окорок	шы´нка, кумпя´к 
окрестность	вако´ліца 
окулировка	вачкава´ньне 
окучивание	абсыпа´ньне, абво´рваньне 
окучник	абсы´пнік, ляшні´к 
омшанник	амша´ньнік, імшэ´ньнік 
опаливать свинью	смалі´ць сьвіньню´ 
спаривать свинью	апа´рваць сьвіньню´ 
оплата корма	апла´та ко´рму 
опрыскивание	апы´рскваньне 
опрыскиватель	пы´рскаўка 
оптимальные размеры хозяйства	оптыма´льная велічыня´ гаспада´ркі 
опустошение	спусташэ´ньне 
опыление	апылкава´ньне 
опыт	до´сьлед, пра´ктыка 
опытная станция	дасьле´дчая ста´нцыя 
опытное поле	дасьле´дчае по´ле 
опыты вегетационные	до´сьледы вэгетацы´йныя 
опыты полевые	до´сьледы палявы´я 
опыты с удобрением	до´сьледы з угнае´ньнем 
оранжерея	цяплі´ца, цяпля´рня 
орошение	абвадне´ньне 
организационно-производственные формы	організацы´йна-вытво´рчыя фо´рмы 
организационный строй	організацы´йны лад 
орудие (сел.-хоз.)	прыла´да 
освежать кровь	адсьвяжа´ць кроў, паднаўля´ць кроў 
освежение крови	адсьвяжэ´ньне крыві´, паднаўле´ньне крыві´
оседание почвы	асяда´ньне гле´бы, апада´ньне гле´бы 
оселок	асяло´к 
особь	адзі´нка, індыві´дуум 
осока	асака´ 
осот	асо´т 
ости (у ячменя)	асьцюкі´, вусы´ 
остов у телеги	панара´д (калё´сы без драбі´н) 
острога	во´сьці 
осушение болот	асу´шка бало´т 
осыпание	асыпа´ньне 
осыпание хлебов	асыпа´ньне збо´жжа 
осыпь	асы´пка 
ось	вось 
отава	ата´ва 
отбивать косу	кляпа´ць касу´ 
отбор	адбо´р, вы´бар 
отбросы	адпа´дкі, во´дкіды 
отвал	адкладня´, палі´ца 
отвал винтовой	адкладня´ шру´бавая (магчыма і палі´ца шру´бавая – у папяровым невыразна)
отвал в сохе	палі´ца, перакла´дка 
отвал культурный	адкладня´ культу´рная 
отвал цилиндрический	адкладня´ цыліндро´вая 
отвальные орудия	прыла´ды з адкладнё´й 
отвеивать (на ветре)	пала´ць, апала´ць 
отгребать	адграба´ць 
отгрести	адграбсьці´, адгарну´ць 
отдельное растение	асо´бная расьлі´на, ка´лі´ва 
отел	цяле´ньне, ацё´л 
откармливание	адко´рмліваньне, выко´рмліваньне 
откорм	вы´карм, адко´рм 
открытые каналы	адкры´тыя кана´лы 
отмежевание	адмежава´ньне 
отравление	атру´чваньне, атручэ´ньне 
отрасль	галі´на 
отродье (скота)	ко´дла, кале´на 
отросток	адро´стак, па´сынак, па´растак 
отруб	адру´б 
отруби	асе´ўкі 
отсаживать (от матки)	адлуча´ць, адніма´ць 
отстаивание	састо´йваньне 
отцвести (о хлебах)	адкрасава´ць 
отцветание	адцьвіта´ньне (садо´ў); адкрасава´ньне (збо´жжа) 
охвостье	ахво´сьце, аці´ра, во´трыны, во´бмеці 
очистка зерна	ачы´стка зе´рня 
ощипывание	абшчы´пваньне 
падеж (скота)	падзе´ж, памо´рак скаці´ны 
падение стебля	абва´льваньне сьцябла´ 
паз	паз 
пакля	па´кульле 
покос	касьба´ 
пар	папа´р 
пар занятой	папа´р заня´ты 
пар зеленый	папа´р зялё´ны 
пар поздний	папа´р по´зьні 
пар ранний, весенний	папа´р ра´ньні, вясе´ньні 
пар черный	папа´р чо´рны 
паразиты	паразы´ты 
паренина	па´ранка 
парник	парні´к, раса´днік 
парное молоко	сырадо´й 
паровая обработка	вы´раб папа´ру 
паровое поле	папа´р 
пароконный	парако´нны 
пасека	пчо´льнік 
пастбище	па´ша 
пастбищное кормление	выпасо´вае кармле´ньне 
пастбищный период	выпасо´вы пэры´ёд 
пастеризация	пастэрыза´цыя 
пастух	пасту´х 
пастьба (скота)	пасьба´ 
пахание (вспашка)	во´рка, ара´ньне 
пахарь	ара´ты, арэ´ц 
пахать	ара´ць 
пахота	во´рыва, па´хаць 
пахотный слой	во´рны слой 
пахтанье (сколотина)	масьлё´нка 
пашня	ральля´, па´хаць, во´рная зямля´ 
пегий	пярэ´сты 
пелюшка	пялю´шка 
пень	пень 
пенька	пянька´ 
пепел	по´пел 
первичная обработка волокна	первястко´вая апрацо´ўка валакна´ 
первотельная (корова)	першаце´ліца 
первый венец в дерев. постройке	падру´б 
переваримость	стра´ўнасьць 
переваривание	траўле´ньне 
переваримый корм	стра´ўны корм 
перевясло	перавя´сла, пярэ´вясла 
перегной	перагно´й 
перегонка	пераго´нка 
передок (в телеге)	перадо´к (цяле´жкі) 
перековка	перако´ўка 
перелесок	перале´сак 
перемешивание почвы	пераме´шваньне гле´бы 
перенаселение аграрное	пералюдне´ньне агра´рнае 
перепахать	пераара´ць, адара´ць 
перепашка	пераво´рка 
переплетание (корней)	пераплята´ньне карэ´ньняў 
пересадка деревьев	пераса´джваньне дрэў 
пересаживать, -дить	пераса´джваць, перасадзі´ць 
перестаивание хлеба	перасто´йваньне збо´жжа 
период случки	пэры´ёд пры´пуску 
период цветения (хлебов)	пэры´ёд красава´ньня 
пестрополье	пярэстапалё´ўка 
песчаник	пескаві´к 
пивная дробина	саладзі´ны 
пикировка	пікіро´ўка 
пилка (работа)	піло´ўка 
питательное вещество	пажы´ўная матэ´рыя 
питательное достоинство	пажы´ўная ва´ртасьць 
питательный режим	пажы´ўны рэжы´м 
питомник	гадава´льнік, шко´лка  
пища	пажы´ва, е´жа 
планировка	раўнава´ньне, плянто´ўка 
планировка	плянава´ньне 
плантация	плянта´цыя 
пласт (земли)	пласт 
пласт земли из-под плуга (нераскрошившийся)	скі´ба 
плашмя, плоско	пла´зам 
племенной бык	племянны´ буга´й 
племенные книги	заво´дзкія кні´гі 
племя	плямя´, заво´д 
плесень	пле´сьня, цьвіль (на хле´бе), бро´сьня (на ква´шаных бурако´х) 
плетень	пляце´нь 
плешь, плешина	плех, ла´піна 
плод	плод 
плодовито	пло´дна, пладаві´та 
плодовитость	пло´днасьць, пладлі´васьць 
плодовитый	пло´дны 
плодовый	пладо´вы 
плодоношение	плодано´снасьць 
плодородие	ураджа´йнасьць 
плодородность	плодаро´днасьць 
плодородный	урадлі´вы, плодаро´дны 
плодосмен	плодазьме´н 
плодосменное хозяйство	плодазыме´нная гаспада´рка 
плотина	гаць, грэ´бля, за´стаўка 
повальные болезни	по´шасныя хваро´бы 
повилика	павіту´ха 
повреждение семян	ушкаджэ´ньне насе´ньня 
поглотительная способность	паглына´льная здо´льнасьць 
поголовье конское	пагало´ўе ко´нскае 
погреб (хозяйственный для хранения овощей)	склеп, по´граб, вары´ўня 
подвал	склеп, сутарэ´ня 
поддерживающий корм	падтрыма´льны корм 
подзолистая почва	падзол, падзо´лістая гле´ба 
подкладень (яйцо)	по´клад 
подкова	падко´ва 
подкорм	пры´карм 
подкормка во время отдыха	папа´с 
подкрепление кормом	падмацава´ньне ко´рмам 
подпахотный слой	жыве´ц 
подпочва	падгле´б’е, грунт 
подпочва глинистая	падгле´б’е глі´ністае 
подпочва супесчаная	падгле´б’е супяшча´нае 
подойник	даё´нка, дайні´ца 
подсевание	падсява´ньне, по´дсеў 
подсевное растение	падсе´ўная расьлі´на 
подсолнечник	сланэ´чнік 
подстилка	по´дсьціл 
пожнивная культура растений	пажні´ўная культу´ра расьлі´н 
пожнивная репа	пажні´ўная рэ´па 
пожнивные остатки	пажні´ўныя рэ´шткі, іржы´шча 
пожнивье	аржо´ньне, іржы´шча 
пойло	по´йла 
показательное поле	паказа´льнае по´ле 
показательный огород	паказа´льны агаро´д 
покос (луг)	сенажа´ць 
покрыться коркой	закарэ´ць 
полба	по´лба 
поле задернелое	по´ле задзірване´лае 
поле после картофеля	картапля´нішча, бульбя´нішча 
полевая доска	палазо´к 
полеводство	ро´льніцтва, палява´я гаспада´рка 
полевое травосеяние	палявы´ травазасе´ў, -о´е травасе´яньне 
полевой клин	пале´так, зьмяна´ 
полевые участки	пале´ткі
полегание хлебов	выляга´ньне збо´жжа 
поливка	паліва´ньне, палі´ўка 
полка, полотье	по´ліва 
полная зрелость	по´ўная сьпе´ласьць 
полова	мякі´на 
половые органы	пло´цьцевыя о´рганы 
полоса	шнур, паласа´ 
полупар	поўпапа´р 
пользовательный скот	продукцы´йнае бы´дла 
помесь	мяша´нец 
помет птичий	птушы´ны памё´т 
помещик	паме´шчык 
помидор	памідо´р 
понос	ля´ксы 
попона	гу´нька, го´нька 
пористость	сіткава´тасьць 
породистость	заво´дзкасьць, уро´днасьць 
породистый	завадзкі´, уро´дны 
пороки	ва´ды, зага´ны 
поросёнок	парася´ 
поросль	па´расьнік 
поросль корневая	ато´жылкі 
посадка	саджа´ньне 
посев	засе´ў, сяўба´ 
посев гнездовой	засе´ў гнездавы´ 
посев машинный	засе´ў машы´нны 
посев по пласту	засе´ў па аднаво´р’і 
посев под покровное растение	по´дсеў 
посев разбросной	засе´ў рассыпны´, раскідны´ 
посев рядовой	засе´ў радко´вы, рада´мі 
посевная площадь	засе´ўная пло´шча 
посевной материал	насе´ньне, насе´нны матар’я´л 
посевный	засе´ўны 
поселок	пасё´лак 
поспевание	высьпява´ньне 
постройка	будо´ўля, буды´нак, буды´ніна 
постромка	пастро´нак 
поташ	пата´ш 
потолок	столь 
потребительское хозяйство	спажыве´цкая гаспада´рка 
початки кукурузы	кійкі´, кіё´ўкі 
почва	гле´ба 
почва бурая	гле´ба бу´рая, буразе´м 
почва вересковая	гле´ба вераско´вая 
почва дерново-подзолистая	гле´ба дзё´рна-падзо´льная 
почва известковая	гле´ба ва´пністая 
почва лёссовая	гле´ба лё´эсавая 
почвы мелкоземистые	дробназе´містыя гле´бы 
почва перегнойная	гле´ба перагно´йная 
почва песчаная	гле´ба пяшча´ная 
почва рыхлая	гле´ба пу´хкая 
почва связная	гле´ба зьвя´зная 
почва торфяная	гле´ба тарфяна´я 
почва тяжелая	гле´ба цяжка´я 
почва черноземная	чарназе´м 
почвоведение	глебазна´ўства 
почвоуглубитель	глебапаглы´бнік 
почвоутомление	глебазмо´ранасьць 
почка	пупы´шка, пучо´к 
прокатный пункт	панаё´мны пункт, машыно´вы пункт 
прение	прэ´ньне, прэль 
премирование производителей	прэміява´ньне племяньніко´ў 
прибыль	прыбы´так, зыск 
прививание	прышчэ´пліваньне 
прививать, -вить	прышчэ´пліваць, прышчапі´ць 
прививок	прышчэ´п 
привянуть	прывя´ць, тро´хі завя´ць 
приготовление масла	прыгатава´ньне ма´сла 
прикатывание	вальцава´ньне 
прилитие крови	даліва´ньне крыві´ 
приманка	прына´да 
применение	дастасава´ньне 
примесь	до´мешка 
приобретение	набыцьцё´, набыва´ньне 
приплод	прыпло´д 
приправа корма	запра´ва ко´рму 
припустить (к соскам)	падсадзі´ць 
приусадебная культура	прысялі´бная культу´ра 
прищипывание	прышчы´пваньне 
проветрить	праве´трыць 
проволочный червь	драцяні´к 
продукты животные	праду´кты жывё´льныя 
продукты земледелия	праду´кты зямляро´бскія, ро´льніцкія 
продукты растительные	праду´кты расьлі´нныя 
производитель	племяньні´к 
производительность	вытво´рчасьць 
производство	вы´твар 
произрастание	выраста´ньне 
прокисание	пракіса´ньне 
промежуточная культура	праме´жная культу´ра 
промывание масла	прамыва´ньне ма´сла 
пропахивать (картофель)	абганя´ць 
пропашные культуры	абсыпны´я культу´ры 
пропитание	прако´рм 
прорастание хлеба	прараста´ньне збо´жжа 
проращивание	праро´шчваньне 
прореживание	прарэ´джваньне 
прорывка	прарыва´ньне 
просека	прасе´ка 
просо	про´са 
простокваша	сыраква´ша 
просушка	прасу´шка 
протравливание семян	пратру´чваньне насе´ньня 
процеживание	працэ´джваньне 
пруд	са´жалка; стаў
пружинная борона	спружыно´ўка, драпа´ч, драпа´к 
прядильные растения	прадзі´льныя расьлі´ны 
пряжа	пра´дзіва, пра´жа 
прялка	прасьні´ца 
птенцы	птушаня´ты 
птица	пту´шка; пта´ства 
птицевод	птушка´р 
птицеводство	пту´шніцтва 
птичий	птушы´ны 
птичник	пту´шнік, пта´шнік 
пугало	пу´жала 
пудрет	пудрэ´т 
пустоцвет	пустацьве´т 
пустошь	пу´стка 
пустырь	пу´сташ, пусты´р 
путо	пу´та 
пух или подшерсток	пух 
пчела	пчала´ 
пчеловодство	пчаля´рства 
пчеловод	пчаля´р 
пчельник	пчэ´льня, пчо´льнік 
пшеница	пшані´ца 
пшеница яровая	яру´шка, я´рка 
пшено	пшано´ 
пыльца (у растения)	краса´, пыло´к 
пырей	пы´рнік 
рабочая лошадь	рабо´чы конь 
разбивка на гряды	ляшэ´ньне 
разброс	ро´скід, раскі´дка 
разведение	разво´д, разьвядзе´ньне 
разведение в себе	разво´д у сабе´ 
разветвления главного ствола	разгалі´неньне гало´ўнага ствала´ 
разделка земли из-под леса	вы´раб ля´да 
разделка туши	разбо´рка ту´шы 
раз’емная(разъёмная) борозда	разо´ра 
размежевание	разьмежава´ньне 
размельчение почвы	драбле´ньне гле´бы 
размножение животных	распло´д жывё´лы 
размол	памо´л, млі´ва 
разновидность	адме´на 
разнородность	рознаро´днасьць 
разнотипичность	рознатыпо´васьць 
разнуздывать	раске´лзваць 
разработка	разрабо´тка 
разравнивать	разро´ўніваць 
разрез	разрэ´з, парэ´з 
разрыхлять	распухля´ць 
рассада	раса´да 
рассадник	раса´днік 
расход	расхо´д, выда´так 
райграсс итальянский	жы´цік італья´нскі, ра´йграс італья´нскі 
райграсс английский	жы´цік анге´льскі, ра´йграс анге´льскі 
район	раё´н 
распахивание	узо´рваньне 
распашка	узво´рка 
распыление	распыле´ньне 
рассаживать	расса´джваць 
рассевание	расьсе´ўка, расьсява´ньне 
растение	расьлі´на 
растение кормовое	кармава´я расьлі´на 
растение культурное	культу´рная расьлі´на 
растениеводство	расьлінаво´дзтва 
растения паровые	расьлі´ны папа´рныя 
растения пропашные	расьлі´ны абсыпны´я 
растения яровые	ярына´, яр 
растительная зола	расьлі´нны по´пел 
растительный	расьлі´нны 
растить	расьці´ць, гадава´ць 
расход труда	расхо´д пра´цы 
расцветать, -сти	зацьвіта´ць, зацьві´сьці´, закрасава´ць 
расчистка (из-под леса)	ля´да 
рациональный	рацыяна´льны 
реакция среды	рэа´кцыя асярэ´дзіны 
редька	рэ´дзька 
резка (соломенная)	се´чка 
репа	рэ´па 
репейник	дзядкі´ 
репродукция семян	рэпроду´кцыя насе´ньня 
речной песок	жвір 
решетина	ла´та 
ржавчина	іржа´ 
ржавчина гороха	іржа´ гаро´хавая 
ржавчина злаковая	іржа´ збо´жжавая 
ржавчина овсяная	іржа´ аўся´ная 
ржавчина пятнистая	іржа´ пля´містая 
ржавчина свеклы	іржа´ бура´чная 
ржаной	жы´тні, аржаны´ 
ржище	аржо´ньне, іржы´шча 
рига	гумно´ 
рожь	жы´та 
рожь яровая	я´рыца 
роса	раса´
рост	рост 
рост (процесс)	узраста´ньне 
росток	расток, па´растак 
росток картофеля	храсто´к 
рубашка скота	саро´чка скаці´ны 
ручка при древке косы	ручка, лучо´к 
ручка у цепа	цапі´льна 
рыбоводство	гадо´ўля ры´бы 
рыболовство	рыба´цтва 
рыжая масть	ры´жая масьць 
рыночная кон’юнктура(конъюнктура)	ры´начная кон’юнкту´ра 
рыночное положение	ры´начнае палажэ´ньне 
рыночный продукт	ры´начны праду´кт 
рысак	рыса´к, бягу´н 
рысистый	рысі´сты 
рыхлый песок	пу´хкі пясо´к 
рядовая сеялка	радко´вы сяўні´к 
сад	сад 
садовник	садо´ўнік 
садовод	садаво´д 
садоводство	садо´ўніцтва 
саженцы	фля´нсы, са´джанцы 
сало (рогат, скот.)	лой 
сало (свиное)	са´ла 
сало (свиное) внутреннее	здор 
сальный откорм	са´льны вы´карм 
самоопыление	самаапылкава´ньне 
самосев	самасе´й, самасе´ў 
сапка, тяпка	капані´чка 
сарай (для сена)	пу´ня 
сарай (для скота)	хлеў 
сахарная свекла (свекловица)	цукро´выя буракі´ 
сбор	збор 
сбруя	ву´праж 
сбыт	збыт 
свекла	буракі´ 
свекла кормовая	буракі´ кармавы´я 
свекла сахарная	буракі´ цукро´выя 
свернулась (кровь)	запякла´ся (кроў) 
свернулось (молоко)	сьсе´лася, зьбе´глася (малако´) 
свернулся (лист)	скруці´ўся (ліст) 
свиноводство	сьвіна´рства, гадо´ўля сьвіне´й 
свинья йоркширская	сьвіньня´ ё´ркшырская 
свинья племенная	сьвіньня´ племянна´я 
свинья супоросная	сьвіньня´ паро´сная 
сгущенное молоко	згу´шчанае малако´
сдаивание	здо´йваньне 
себестоимость	сабеко´шт 
севооборот	севазваро´т 
седло	сядло´ 
селекционная станция	сэлекцы´йная ста´нцыя 
селекция	сэле´кцыя 
сельско-хозяйственная годность семян	се´льска-гаспада´рчая го´днасьць насе´ньня 
сельско-хозяйственные орудия	се´льска-гаспада´рчыя прыла´ды 
сельско-хозяйственная таксация	се´льска-гаспада´рчая такса´цыя 
семена	насе´ньне 
семена непроростающие(непрорастающие)	непраро´сьлівае насе´ньне 
семенная станция	насе´нная ста´нцыя 
семенное хозяйство	насе´нная гаспада´рка 
семенной белок	насе´нны бяло´к 
семенной рассадник	насе´нны раса´днік 
семеноводство	разво´д насе´ньня, насе´ньніцтва 
семенная культура	насе´нная культу´ра 
семенники (растения)	насе´ньнікі, насе´нкі, вы´садкі 
сено затухлое	се´на ту´хлае 
сеновал	адры´на, пу´ня 
сеноворошилка	сенаваро´чалка 
сенокос (площадь)	сенажа´ць, по´жня 
сенокос (сенокошение)	касаві´ца, касьба´ 
сенокосный луг	сенажа´ць, по´жня 
сенопашня	сенаральля´ 
сепаратор	сэпара´тар 
сераделла	сэрадэ´ля, птушано´жка, птушане´ц 
сердцевина	сарцаві´на 
серп	серп 
сеялка (машина)	сявя´рка, сяўні´к 
сеялка комбинированная	сявя´рка комбінава´ная 
сеялка разбросная	сявя´рка рассыпна´я, раскідна´я 
сеялка рядовая	сявя´рка радко´вая 
сеяние	сяўба´ 
сеянцы	се´янцы 
сидерация	сыдэра´цыя 
силос	сіло´с 
сильный корм	мо´цны корм 
система земледелия	сыстэ´ма зямляро´бства 
система полеводства	сыстэ´ма ро´льніцтва 
система хозяйства	сыстэ´ма гаспада´ркі 
скаковая лошадь	высьціго´вы конь; скаку´н 
скат северный	пака´т паўно´чны 
скат южный	пака´т паўднё´вы 
скашивание	ско´шваньне 
скирда (хлеба)	скі´рта, торп 
скоропашка	скорапа´шка, скораво´рка 
скороспелость	скорасьпе´ласьць 
скорость проростания	ско´расьць прараста´ньня 
скот	скаці´на 
скот мелкий	скаці´на дро´бная 
скот племенной	скаці´на племянна´я 
скотный двор	або´ра, до´ржнік, за´гарад 
скотовод	жывёлаво´д 
скотоводство	ската´рства 
скребница	скрабло´
скрещивание	скрыжава´ньне 
скупщик	ску´пшчык 
сладкое молоко	сало´дкае малако´ 
сливки	вяршо´к, сьмята´нка 
сливкоотделитель	сэпара´тар 
слизень полевой	смоўж 
слоистость	слаі´стасьць, пластава´тасьць 
слоистый	слаі´сты, пластава´ты 
слой годичный	слой гадавы´ 
слой пахотный	во´рны слой 
случка	пры´пуск 
случной пункт	прыпускны´ пункт 
смесь	ме´шанка, су´месь 
смесь вико-овсяная	ме´шанка аўса´ з ві´каю 
смесь овса с ячменем	ме´шанка аўса´ з ячме´нем 
смесь соломы и сена	тру´шанка, трася´нка 
сметана	сьмята´на 
смешанный посев	мяша´ны засе´ў 
смола	смала´ 
смолистый	смо´льны 
смородина	смаро´дзіна 
смородина (красная)	парэ´чкі 
смык (род бороны)	смык 
снабжение	даста´ва 
сноп	сноп 
снятое молоко	зьня´тае, зьбіра´нае малако´ 
содержание скота	утрыма´ньне скаці´ны, жывё´лы 
созревание (свекловицы)	высьпява´ньне 
созревать, созреть	высьпява´ць, вы´сьпець 
созревший	дасьпе´лы 
созреть	дасьпе´ць 
солка сыров	сале´ньне сыро´ў 
солодовые ростки	саладзі´ны 
солома	сало´ма 
соломенный	саламя´ны 
соломина	сало´міна 
соломорезка	сячка´рня 
солонцы	саланцы´ 
сорная куча	сьме´тнішча 
сорное место	сьме´тнік 
сорные травы	пустазе´льле, сарні´на 
сорт	сорт, гату´нак 
сорта местные	сарты´, гату´нкі мясцо´выя 
сорта хлебов	сарты´, гату´нкі збо´жжа 
сортировать	сартава´ць 
сортировка	сарто´ўка, а´рфа 
сортировка зерна	сартава´ньне зярня´т 
сортоиспытание	сортавыпрабава´ньне 
сосняк	хво´йнік, сасо´ньнік 
сосок	цы´цка´ 
соха	саха´ 
сохранение	захава´ньне 
сошники (у сохи)	наро´гі, лемяхі´ 
спарилась (полов, акт)	папалява´ла, пабе´гала 
спасывать	спа´сваць
спелость, спелый	сьпе´ласьць, сьпе´лы 
спица	сьпі´ца 
спорынья	ражкі´ 
способность проростания(прорастания)	здо´льнасьць прараста´ньня 
срез (место среза)	зрэз 
срезание кочек	зраза´ньне куп’я´ 
сруб	зруб 
стадо	ста´да 
стандартный сорт	стандарто´вы гату´нак 
створожилось (молоко)	стваражы´лася 
стебель	сьцябло´, цыбу´р 
стеблевание	сьцеблява´ньне 
стеблевые узлы	сьцябло´выя кале´нцы 
стельность (коровы)	це´льнасьць 
степень оподзоленности	ступе´нь ападзо´ленасьці 
степень спелости семян	ступе´нь сьпе´ласьці насе´ньня 
стержень	стры´жань, астрыжо´нак 
стерилизация	стэрыліза´цыя 
стимулированный	стымулява´ны 
стог	стог 
стог с передвижной крышей на 4-х столбах	брок, стажа´рня 
стойло	сто´йла 
стойловое кормление	сто´йлавае кармле´ньне 
стойловый период	сто´йлавы пэры´ёд 
сток	сток, адлі´ў 
стравливание	стра´ўліваньне 
страхование (посевов)	страхава´ньне 
стрижка	стры´жка 
строение (действие)	будо´ўля, будава´ньне 
строение (постройка)	буды´нак 
строение почвы	будо´ва гле´бы 
структура почвы	структу´ра гле´бы 
стручок	стручо´к, лу´скаўка 
суглинок	суглі´нак 
сук	сук 
суперфосфат	супэрфосфа´т 
супесь, супесок	су´песак 
сурепица, сурепка	сьвірэ´піца, сьвірэ´пка 
сусеки	засе´кі 
суховей	сухаве´й 
сухостой	сухасто´й 
счетоводные записи	рахунко´выя за´пісы 
сушильня (ветряная)	азяро´д, пярэ´плат 
сушка	су´шка 
сушка клевера в хохолках	су´шка канюшы´ны ў чубо´х 
сыворотка	сыро´ватка 
сыросека	сырасе´ка 
твердые извержения	экскрэмэ´нты, кал 
творог	тво´раг 
телега	калё´сы, драбі´ны 
теленок	цяля´ 
телка	цё´лка, цялу´шка 
телосложение	склад це´ла 
тень	цень 
тепловая мочка льна	цеплаво´е мачэ´ньне ільну´ 
теребление (уничтожение поросли)	расьцяро´бка, выцяро´бка 
техническая переработка	тэхні´чная пераапрацо´ўка 
течка	це´чка, юр 
тимофеевка	цімафе´йка 
титьки (у свиньи)	цы´цкі 
ткацкий станок	кро´сны 
тля (на иве)	імшы´ца, тля 
товарность	тава´рнасьць 
товарные излишки	тава´рныя лі´шкі 
ток (в гумне)	ток 
толкач (у маслобойки)	таўка´ч 
толо´ка	талака´ 
томасшлак	тамашо´ўка, тамашля´к 
тонкое льняное полотно	ку´жаль 
тонкошерстная овца	тонкару´нная аве´чка 
топор	тапо´р, сяке´ра 
топчак	тапча´к 
топь, зыбкое место	ба´гнішча, ба´гна, дрыгва´ 
торговые сорта	тава´рныя гату´нкі 
торфование	тарфава´ньне 
торфяная подстилка	тарфяны´ по´дсьціл 
торфяники	тарфянікі´ 
торфяной порошок	тарфяны´ парашо´к 
траваполье	травапо´льле 
травосеяние	травасе´яньне, травазасе´ў 
травяной корм	травяны´ корм 
трактор	тра´ктар 
транспортабельный	транспорта´бельны 
треножить	трыно´жыць 
трехполье	трохпалё´ўка 
трещины на дереве (морозобоины)	раско´ліны на дрэ´ве (ад маро´зу) 
триер	тры´ер 
троекратная вспашка	трае´ньне 
трудоемкий	працаё´місты 
трудоемкость	працаё´містасьць 
труха	пацяру´ха, патру´ха 
тулуп	кажу´х 
туша	ту´ша 
тычина	ты´чка 
тяжеловозная лошадь	ламавы´ конь, цяжкаво´з 
убой	убо´й 
убойный вес	убо´йная вага´ 
уборка	убо´рка, прыбо´рка 
уборочные машины	убо´рачныя машы´ны 
убыточная отрасль	стра´тная галіна 
угловое травосеяние	кутко´вы травазасе´ў 
угодья	ужытко´ўнасьці, уго´дзьдзі 
удельный вес семян	адно´сная вага´ насе´ньня 
удилы	цу´глі 
удобоусвояемый азот	лёгкаспажы´ўны азо´т 
удобрение	удабрэ´ньне, угнае´ньне 
удобрение азотное	удабрэ´ньне азо´тнае (магчыма і угнае´ньне азо´тнае – у папяровым невыразна)
удобрение зеленое	удабрэ´ньне зялё´нае (магчыма і угнае´ньне зялё´нае – у папяровым невыразна)
удобрения искусственные	удабрэ´ньні шту´чныя 
удобрение косвенное	угнае´ньне пасярэ´дняе 
удобрение неполное	угнае´ньне няпо´ўнае 
удобрение полное	угнае´ньне по´ўнае
удой	удо´й 
удойный период	до´йны пэры´ёд 
узда, уздечка	вуздэ´чка 
укатывание	вальцава´ньне 
укос	уко´с 
укосный клевер	касьбяна´я канюшы´на 
укрепление летучих песков	замацава´ньне ляту´чых пяско´ў
укроп	кроп, укро´п 
улей колодочный	ву´лей-кало´дка 
улей рамочный	ву´лей ра´мавы 
улучшенный производитель	пале´пшаны племяньні´к 
улучшенный скот	пале´пшаная скаці´на 
умолот	умало´т 
умолотность	умало´тнасьць 
унаваживание	угно´йваньне 
унаваживать	угно´йваць 
унавоженный участок	угно´ены вуча´стак 
уплотнение почвы	зьляга´ньне, сьціска´ньне гле´бы 
уплотнение севооборотов	пашчытне´ньне севазваро´таў 
упряжка	запрэ´жка 
уровень интенсивности	ро´вень інтэнсы´ўнасьці
урожай	ураджа´й 
урожайность,урожайный	ураджа´йнасьць, ураджа´йны 
усадьба	сядзі´ба, сялі´ба 
устойчивость (положения)	сто´йкасьць 
устойчивость (сопротивление влиянию)	трыва´ласьць 
утка	ка´чка, ву´тка 
утоптаная земля	уто´птаная зямля´ 
утренники	пры´маразкі 
уход (за растениями)	дагля´д, до´гляд 
участок	вуча´стак 
участок земельный	вуча´стак зямлі´ 
ушат	цэ´бар 
фасоль	фасо´ля 
фауна	фа´ўна 
физиологическая спелость семян	фізыёлёгі´чная сьпе´ласьць насе´ньня 
фильтровать (молоко)	фі´льтрава´ць 
фитопатология	фітапаталё´гія 
флора	флё´ра 
фосфор	фо´сфар 
фосфоритная мука	фосфары´тная мука´ 
фосфорная кислота	фо´сфарная кіслата´ 
фруктовый	фрукто´вы 
фунгисиды	фунгісы´ды 
хвойные деревья	ігля´стыя дрэ´вы 
хворост	хво´раст 
хвощ	хвошч 
хвоя	іглі´ца, шы´льнік 
хлеб (зерно)	збо´жжа 
хлеб (испеченный)	хлеб 
хлебопашество	хлебаро´бства, ро´льніцтва 
хлебопашец	хлебаро´б, ро´льнік 
хлебородный	хлебаро´дны 
хлебофуражный баланс	збожжафура´жны баля´нс 
хмель	хмель 
хозяйственная зрелость	гаспада´рчая сьпе´ласьць 
хозяйство безнавозное	гаспада´рка бязгно´йная 
хозяйство пригородное	гаспада´рка падгаро´дная 
хозяйство чересполосное	гаспада´рка цераспало´сная 
холодильник	халадзі´льнік 
холощение	лягча´ньне, паклада´ньне 
хомут	хаму´т 
хромота	кульга´васьць 
хрущ (майский жук)	хрушч
хряк	кнур, кно´раз 
хрящеватая почва	жвірава´тая гле´ба 
цвет (окраска)	ко´лер 
цветение (садов)	цьвіце´ньне 
цветение (хлебов)	красава´ньне 
цветок	кве´тка, кра´ска 
цветочная пыльца	краса´, пыло´к 
цедилка	цадзі´лка 
целина	цаліна´ 
цельное молоко	цэ´льнае малако´, нязьбіра´нае малако´ 
ценообразование	цэнаўтварэ´ньне 
центрофуга	цэнтрафу´га 
цилиндрическая сортировка	цыліндро´вая сарто´ўка 
частицы почвы	часьці´нкі, ча´стачкі гле´бы 
частное земледелие	спэцыя´льнае зямляро´бства 
частная зоотехния	спэцыя´льная зоатэ´хнія 
черва	чарва´ 
чередование растений	чаргава´ньне расьлі´н
чересполосица	цераспало´сіца 
черенок	зразо´к 
черепица	чарапі´ца, дахо´ўка 
чернозем	чарназе´м 
четырехполье	чатырохпалё´ўка 
чехлик корневой	каптурок каранё´вы 
чечевица	сачэ´ўка, сачаві´ца 
чилийская селитра	чылі´йская сале´тра 
чистосортный	чыстагату´нкавы 
чистота семян	чыстата´ насе´ньня 
чистый посев	чы´сты засе´ў 
шайба	шайба 
шайка	ра´жка 
шатры	шатры´, бу´дкі 
шелуха	луска´, лупі´ны 
шерсть (овечья)	во´ўна 
шерсть (свиная)	шчаці´на, шчэць 
шестьдесят снопов	капа´ (адзі´нка лічэ´ньня) 
шина	шы´на 
шорник	ры´мар 
шпалеры	шпале´ры 
шпергель	шпэ´ргель 
штандорт	штандо´рт 
штык	штых 
щавель	шча´ўе 
щелочь	луг 
щетина	шчаці´на 
щуплые семена	шчу´плае насе´ньне 
экономия (имение)	двор, маё´нтак, экано´мія 
экстенсивность	экстэнсы´ўнасьць 
экстерьер	экстэр’е´р, склад це´ла 
энергия прорастания	энэ´ргія прараста´ньня 
эспарцет	эспарцэ´т 
ягнёнок	ягня´ 
ягниться	акаці´цца
яловица (нетельная корова)	я´лаўка, я´лавіца 
яровая пшеница	яру´шка, я´рка 
яровая рожь	я´рыца 
яровые растения	яравы´я расьлі´ны 
ясли	я´сьлі 
ящур	я´шчур 
