##Title: Тэрмінолёгія грамадазнаўства (БНТ)
##HTMLDescription_BEGIN
<div>
	<p class="dictdesc-st">Створана на падставе:</p>
	<p><b>Тэрмінолёгія грамадазнаўства</b>. Менск: Інбелкульт, 1926.</p>
</div>
<div>
	<p class="spoiler">Прадмова</p>
	<p>Гэты выпуск «Беларускае Навуковае Тэрмінолёгіі» прызначаны абслугоўваць грамадазнаўчыя дысцыпліны ў беларускай сярэдняй, а часткай – і вышэйшай школе.</p>
	<p>Зьмешчаныя тут тэрміны апрацоўваліся на працягу  1922−1923 акадэмічнага году ў Гуманітарнай Сэкцыі Інстытуту Беларускае Культуры, а пасьля, у канцы 1925 году, іх прагледзела і зацьвердзіла Правапісна-Тэрмінолёгічная Камісія.</p>
	<p>Бліжэйшы ўдзел у апрацаваньні гэтага выпуску тэрмінолёгіі прымалі: член-супрацоўнік Інстытуту Беларускае Культуры Ўладыслаў Чаржынскі (укладчык проекту), правадзейны член Канстантын Міцкевіч (Якуб Колас) і член-супрацоўнік Мікола Байкоў.</p>
</div>
##HTMLDescription_END
##ArticleLang: ru/be

абориген	тубылец
абсолютизм	абсолютызм, неагранiчанасьць
абсолютизм политический	полiтычны абсолютызм, неагранiчанасьць
абсолютизм просвещенный	асьвечаны абсолютызм
абсолютная монархия	абсолютная, неагранiчаная монархiя
абсолютное перенаселение	абсолютнае пералюдненьне
автократ	самаўладца
автократизм	самаўладнасьць
автократия	самаўладзьдзе
автономический	аўтономiчны
автономия	аўтономiя, самаўрад
автономия культурная	культурная аўтономiя, самаўрад
автономия культурно-персональная	культурна-пэрсональная аўтономiя, самаўрад
автономия территориальная	краёвая аўтономiя, самаўрад
автономная область	аўтономная, самаўрадная краiна
автономная республика	самаўрадная аўтономная рэспублiка
автономный	аўтономны
авторитарная родовая община	аўторытарная радавая грамада
автотомия	аўтотомiя
автохтоны	першабыльцы
агитатор	агiтатар
агитация	агiтацыя
аграрии	абшарнiкi
аграрный вопрос	зямельнае пытаньне
агрессивная политика	зачэпная полiтыка
агрикультура	ральнiцтва
ад	пекла
административная власть	упраўная ўлада
административный	упраўны
административный договор	умова, дагавор, угода адмiнiстрацыйная, упраўная
администратор	упраўнiк
администрация	управа
активное гражданство	дзейнае грамадзянства
активное избирательное право	дзейна-выбарнае права
акциз	акцыз
акционерное товарищество (общество)	акцыйнае таварыства (суполка)
алтарь	аўтар
амулет	амулет
анархизм	анархізм
анархист	анархiсты
анархический	анархiчны, бязурадны
анархия (безвластие)	бязурадзьдзе, бязуладзьдзе, анархiя
анархия (беспорядок)	бязладзьдзе
анимизм	анiмiзм, удухаўленьне
аннексия	анэксiя
антагонизм	супрацiўнiцтва
антимилитаризм	антымiлiтарызм, супрацьваяўлiвасьць
античная культура	антычная культура
античная республика	антычная рэспублiка
античное государство	антычная дзяржава
античность	антычнасьць
античный мир	антычны сьвет
антропоморфизм	учалавечваньне, антропоморфiзм
аполитичность	аполiтычнасьць
аренда	арэнда
арендатор	арандатар
аристократ	арыстократ, магнат, пан
аристократическая республика	арыстократычная рэспублiка
аристократический	арыстократычны, можнаўладны
аристократия	арыстократыя, можнаўладзтва, панства
армия	армiя
армия территориальная	краёвая армiя
артель	сябрыня
археограф	архэограф
археография	архэографiя
археолог	архэолёг
археология	архэолёгiя
аскетизм	аскетызм
ассимиляция	прыпадабленьне, асыміляцыя
ассоциация	злучнасьць
атеизм	бязбожжа, атэiзм
атеист	атэiсты, бязбожнiк
аэроплан	самалёт
базар	кiрмаш, рынак
баллотировка	лёсы
банк	банк
банк государственный	дзяржаўны банк
банк депозитный	дэпозытны банк
банк ипотечный	iпотэчны банк
банк коммерческий	комэрцыйны банк
банк кредитный	пазычковы, крэдытовы банк
банк меновой	менавы банк
банк промышленный	прамысловы банк
банк торговый	гандлёвы банк
банк частный	прыватны банк
банк эмиссионный	эмiсыйны банк
банковский капитал	банкаўскi капiтал
банкротство	банкруцтва
барон	барон
баронство	баронства
баррикада	барыкада
барщина	паншчына
бастовать	баставаць
батрак	батрак
безбожие	бязбожжа
безбожник	бязбожнiк
безбрачие	бязжонства, няшлюбнасьць
безвластие	бязуладзьдзе
безгосударственность	безьдзяржаўнасьць
безграмотность	няпiсьменнасьць
беззаконие	беззаконьне
беззаконность	незаконнасьць
безземелие	безьзямельле
безземельное население	безьзямельнае насяленьне
безлюдие	бязьлюдзьдзе
безначалие	бязуладзьдзе
безопасность	бясьпечнасьць
безопасность внешняя	знадворная бясьпечнасьць
безопасность внутренняя	унутраная бясьпечнасьць
безопасность имущественная	маемасная бясьпечнасьць
безопасность личная	асабовая бясьпечнасьць
безопасность общественная	грамадзкая бясьпечнасьць
безоружный	бяззбройны
безответственность	безадказнасьць
безработица	безрабоцьце
безработное население	безработнае насяленьне
бесклассовое общество	бясклясавае грамадзтва
бесплеменный	беспляменны
беспорядок	беспарадак
беспошлинный	бязмытны
бессмертие	несьмяротнасьць
бессословное общество	бясстанавае грамадзтва
бессрочность власти	бестэрміновасьць улады
биржа	бiржа, гелда
биржа труда	бiржа працы
битва	бiтва
благо	дабро
благо классовое	клясавае дабро
благо личное	асабовае дабро
благо общее	паспалiтае дабро
благодарственная жертва	падзячная ахвяра
благодетельное божество	дабрадзейнае боства
благотворительное божество	дабрачыннае боства
блокада	замык, блёкада
богатырский	гэроiчны, багатырскi
богатырство	багатырства, гэроiзм
богатырь	багатыр, волат, асiлак, гэрой
боготворить	абагаўляць
божество	боства
божество благодетельное	дабрадзейнае боства
божество разрушительное	злачыннае боства
бой	бой
бойкот	бойкот
бойкотировать	бойкотаваць
больничная касса	больнiчная каса
большевизм	бальшавiзм
борьба	барацьба, змаганьне
борьба классовая	клясавая барацьба, змаганьне
борьба социальная	соцыяльная барацьба, змаганьне
борьба экономическая	эканомiчная барацьба, змаганьне
боярин	баярын
боярское сословие	баярскi стан
боярство	баярства
брак	шлюб
брак гражданский	грамадзянскi шлюб
брак первобытный	першабытны шлюб
браманизм	браманiзм
братский	брацкi
братство	брацтва
бронзовый век	бронзавы век
буддизм	буддызм
бумажные деньги	папяровыя грошы
бунт	бунт
бунтовщик	бунтаўшчык
буржуазия	буржуазія
буржуазия городская	гарадзкая буржуазія
буржуазия капиталистическая	капiталiстычная буржуазiя
буржуазия крупная	буйная буржуазія
буржуазия мелкая	дробная буржуазiя
буржуазия средняя	сярэдняя буржуазiя
буржуазная республика	буржуазная рэспублiка
буржуазное государство	буржуазная дзяржава
буржуазный класс	буржуазная кляса
буржуй	буржуй
быт	быт
быт родовой	радавы быт
быт семейный	сямейны быт
быт экономический	экономiчны быт
бюджет	бюджэт
бюргерство	мяшчанства
бюрократизм	бюрократызм
бюрократическая монархия	бюрократычная монархія
бюрократическое государство	бюрократычная дзяржава
бюрократия	бюрократыя
вандализм	вандалізм
варвар	барбар
варварство	барбарства
вассал	васал
вассальная зависимость	васальная залежнасьць
вассальное государство	васальная дзяржава
ввоз	прывоз
век	век
век бронзовый	бронзавы век
век железный	жалезны век
век каменный	каменны век
век неолитический	новакаменны век
век палеолитический	старакаменны век
великодержавие	вялiкадзяржаўе
великодержавный	вялiкадзяржаўны
великокняжеский	вялiкакняжы
вера	вера
верование	вераваньне
вероисповедание	веравызнаньне
веротерпимость	веразносьлiвасьць
веротерпимый	веразносьлiвы
верхняя палата	вышэйшая палата
верховная власть	найвышэйшая ўлада
верховный жрец	найвышэйшы жрэц
Veto	Veto
Veto монарха	Veto монарха
Veto народа	Veto народу
Veto президента	Veto прэзыдэнта
вече	веча
владелец	уласьнiк
владение	уладаньне
властелин	уладар
власть	улада
власть административная	адмiнiстрацыйная ўлада
власть верховная	найвышэйшая ўлада
власть вождя	улада правадыра
власть государственная	дзяржаўная ўлада
власть жрецов	улада жрацоў
власть законадательная	законадаўчая ўлада
власть иностранная	чужаземная ўлада
власть исполнительная	выканаўчая ўлада
власть местная	мясцовая ўлада
власть монарха	улада монарха
власть надгосударственная	наддзяржаўная ўлада
власть народа	улада народу
власть неограниченная	неабмежаваная ўлада
власть правительственная	урадавая ўлада
власть светская	сьвецкая ўлада
власть советская	савецкая ўлада
власть суверенная	сувэрэнная ўлада
власть учредительная	устаноўчая ўлада
власть церкви	царкоўная ўлада
внешний рынок	загранiчны рынак
внешняя безопасность	знадворная бясьпека
внешняя политика	загранiчная полiтыка
внешняя торговля	загранiчны гандаль
внутренний рынок	унутраны рынак
внутренняя политика	унутраная полiтыка
внутренняя торговля	унутраны гандаль
водный путь	водны шлях
воевода	ваявода
военная служба	вайсковая служба
военная экспедиция	ваенная выправа
военно-государственный капитализм	ваенна-дзяржаўны капiталiзм
военное положение	ваеннае палажэньне
военное сословие	вайсковы стан
военный класс	вайсковая кляса
военный коммунизм	ваенны комунiзм
военный режим	ваеншчына
воздухоплавание	лётнiцтва
воздушный путь	паветраны шлях
воззвание	адозва
возрожденец	адраджэнец
возрождение	адраджэньне
война	вайна
война гражданская	грамадзянская вайна
война колониальная	колёнiяльная вайна
война междуусобная	дамовая вайна
война морская	морская вайна
война наступательная	зачэпная вайна
война оборонительная	абаронная вайна
война партизанская	партызанцкая вайна
воинская повинность	вайсковая павiннасьць
воинственный	ваяўнiчы
войско	войска
войско наемное	наймовае войска
войско территориальное	краёвае войска
волнение	забурэньне, неспакой
волость	воласьць
вольнонаемный	вольнанайманы
вольноотпущенник	вольнаадпушчаны, вызвалены
вольность	вольнасьць
воля	воля
воля государства	воля дзяржавы
воля законодателя	воля законадаўцы
воля народа	воля народу, народная воля
воля представителя	воля прадстаўнiка
вооружать	узбройваць
вооружение	узбраеньне
вооруженный	узброены
вопрос аграрный	зямельнае пытаньне
вопрос женский	жаночае пытаньне
вопрос национальный	нацыянальнае пытаньне
вопрос рабочий	рабочае пытаньне
восставший	паўстанец
восстание	паўстаньне
восстановление	аднаўленьне
враг	вораг
всадников сословие	стан коньнiкаў
Всебелорусский съезд советов	Усебеларускi зьезд саветаў
Всебелорусский Центральный Исполнительный Комитет	Усебеларускi Цэнтральны Выканаўчы Камiтэт
Вселенский собор	Сусьветны сабор
всемирный	сусьветны
всемогущество суверенной власти	усемагутнасьць сувэрэннай улады
всенародный	усенародны, паспалiты
всеобщая история	сусьветная гiсторыя
всеобщая стачка	агульная забастоўка
всеобщее избирательное право	агульнае выбарнае права
всесоюзный	усесаюзны
выборный	выбарны
выборы	выбары
вывоз	вываз
выкуп	выкуп
выступление	выступленьне
вытеснение	выцясьненьне
гавань	прыстань, порт
гарантия	забясьпека
гарнизон	залога
гегемония	гегемонiя, верхаводзтва
генеральные штаты	генэральныя штаты
герб	гэрб
герой	гэрой
герцог	гэрцог
герцогство	гэрцогства
гетеризм	гэтэрызм
гетман	гэтман
гетманство	гэтманства
гильдия	гiльдыя
гинекратия	жонаўладзьдзе
гнет	уцiск
гонение	ганеньне
город	горад, места
городская буржуазия	гарадзкая, меская буржуазiя
городская культура	гарадзкая культура, меская культура
горожанин	гараджанiн
господство	панаваньне
господствующее сословие	пануючы стан
господствующие классы	пануючыя клясы
государственная власть	дзяржаўная ўлада
государственная должность	дзяржаўная пасада
государственная религия	дзяржаўная рэлiгiя
государственное устройство	дзяржаўны лад
государственность	дзяржаўнасьць
государственный банк	дзяржаўны банк
государственный капитализм	дзяржаўны капiталiзм
государственный язык	дзяржаўная мова
государство	дзяржава
государство античное	антычная дзяржава
государство буржуазное	буржуазная дзяржава
государство бюрократическое	бюрократычная дзяржава
государство вассальное	васальная дзяржава
государство конституционное	констытуцыйная дзяржава
государство конфедерированное	конфэдэраваная дзяржава
государство несуверенное	несувэрэнная дзяржава
государство покровительствуемое	падапечная дзяржава
государство полицейское	полiцэйская дзяржава
государство пролетарское	пролетарская дзяржава
государство советское	савецкая дзяржава
государство социалистическое	соцыялiстычная дзяржава
государство средневековое	сярэднявяковая дзяржава
государство суверенное	сувэрэнная дзяржава
государство унированное	унiраваная дзяржава
государство унитарное	унiтарная дзяржава
государство федеративное	фэдэрацыйная дзяржава
государство феодальное	фэўдальная дзяржава
готический	готычны
гражданин	грамадзянiн
гражданка	грамадзянка
гражданская война	грамадзянская вайна
гражданская свобода	грамадзянская вольнасьць, грамадзянская свабода
гражданский брак	грамадзянскi шлюб
гражданство	грамадзянства
гражданство активное	дзейнае грамадзянства
гражданство пассивное	нядзейнае грамадзянства
грамота дарственная	даравальная грамата
грамота охранная	ахоўная грамата
грамотность	пiсьменнасьць
граница	гранiца
граф	граф
графский	графскi
графство	графства
гробница	магiльня
групповой интерес	групавы iнтарэс
губерния	губэрня
гуманизм	гуманiзм
гуманист	гуманiсты
данник	даньнiк
дань	дань, данiна, чынш
дарственная грамота	даравальная грамата
дарственный	даравальны
движение	рух
движение национальное	нацыянальны рух
движение освободительное	вызваленскi рух
движение политическое	полiтычны рух
движение профессиональное	профэсiянальны рух
движение рабочее	рабочы рух
движение религиозное	рэлiгiйны рух
движение социальное	грамадзкi рух
двоевластие	двоеўладзьдзе
двор	двор
дворянин	дваранiн, шляхцiц
дворянская культура	дваранская, шляхецкая культура
дворянское сословие	дваранскi, шляхецкi стан
дворянство	дваранства, шляхецтва, шляхта
двухпалатный парламент	двухпалатны парлямэнт
девольвация	дэвольвацыя
дезертир	дэзэртыр
дезертирство	дэзэртырства
дезорганизация	бязладзьдзе
декаданс	дэкаданс, заняпад
декларация	дэклярацыя
деклассированный	дэклясаваны
деклассировать	абясклясiць, дэклясаваць
декрет	дэкрэт
делегат	дэлегат
делегация	дэлегацыя
демагог	дэмагог
демагогия	дэмагогiя
демаркационный	пагранiчны, дэмаркацыйны
демобилизация	дэмобiлiзацыя
демократ	дэмократ
демократическая конституция	дэмократычная констытуцыя
демократическая республика	дэмократычная рэспублiка, народная рэспублiка
демократия	дэмократыя
демократия непосредственная	беспасярэдняя дэмократыя
демократия представительная	прадстаўнiцкая дэмократыя
демонстрация	дэмонстрацыя
демос	дэмос, народ
денационализация	дэнацыяналiзацыя
денежное хозяйство	грашовая гаспадарка
денежный обмен	грашовая мена
деньги бумажные	бумажныя грошы
деньги кредитные	крэдытовыя грошы
деньги металлические	мэталiчныя грошы
деревня	вёска
деревянное орудие	дзераўляная прылада
деспот	дэспот
деспотизм	дэспотызм
деспотическая монархия	дэспотычная монархiя
деспотия	дэспотыя
десятина	дзесяцiна
децентрализация	дэцэнтралiзацыя
децентралист	дэцэнтралiсты
деятель	дзеяч
дикарь	дзiкар, дзiкун
диктатор	дыктатар
диктатура	дыктатура
династия	дынастыя
дипломат	дыплёмат
дипломатия	дыплёматыя
директория	дырэкторыя
дифференциация общества	падзел грамадзтва
добывающая промышленность	здабыўчая прамысловасьць
добыча	здабыча
договор	умова, угода, дагавор
договор административный	адмiнiстрацыйная, упраўная ўмова, угода, дагавор
договор общественный	грамадзкая ўмова, угода, дагавор
договор политический	полiтычная ўмова, угода, дагавор
доисторический период	дагiстарычны пэрыод
докапиталистические формы промышленности	дакапiталiстычныя формы прамысловасьцi
должность государственная	дзяржаўная пасада
должность общественная	грамадзкая пасада
домашнее производство	дамовая продукцыя, вытворчасьць
домашняя промышленность	дамовая прамысловасьць
дорога железная	чыгунка
дорога шоссейная	шаса
древний	старажытны
древность	старажытнасьць
древняя история	старажытная гiсторыя
дружина	дружына
дуалистическая монархия	дваiстая монархiя
духовенство	духавенства
духовная культура	духоўная культура
духовное сословие	духоўны стан
единение	яднаньне
единобожие	аднабожжа
единобожный	аднабожны
единобрачие	аднажонства
единоверие	аднавер'е
единоверный	аднаверны
единовластие	аднаўладзьдзе
единогласный	аднагалосны
единоплеменник	аднапляменьнiк
единоплеменный	аднапляменны
единство	еднасьць
единство государства	еднасьць дзяржавы
единство общества	еднасьць грамадзтва
единство суверенной власти	еднасьць сувэрэннай улады
ересь	гарэзiя, гэрась
еретик	гарэтык
железная дорога	чыгунка
железный век	жалезны век
женский вопрос	жаночае пытаньне
жертва	ахвяра
жертва благодарственная	падзячная ахвяра
жертвенник	ахвярны аўтар
жертвенное животное	ахвярная жывёла
жертвоприношение	ахвяраваньне, ахвяра
живопись	малярства
животное жертвенное	ахвярная жывёла
жизнь загробная	пазамагiльнае жыцьцё
житель	жыхар
жребий	лёс
жреческое сословие	жрэцкi стан
жречество	жрэцтва
жрец	жрэц
жрец верховный	найвышэйшы жрэц
жрица	жрыца
забастовка	забастоўка
зависимость	залежнасьць
зависимость вассальная	васальная залежнасьць
зависимость ленная	ленная залежнасьць
зависимый	залежны
завод (фабрика)	фабрыка
завоевание	заваяваньне
завоеватель	заваявальнік
заговор	змова
заговорщик	змоўнiк
заграничная торговля	загранiчны гандаль
загробная жизнь	пазамагiльнае жыцьцё
загробный мир	пазамагiльны сьвет
заем	пазыка
заем бессрочный	бестэрмiновая пазыка
заем облигационный	облiгацыйная пазыка
законодатель	законадаўца
законодательная власть	законадаўчая ўлада
законодательное собрание	законадаўчы сойм
законодательство	законадаўства
законодательство фабричное	фабрычнае законадаўства
заработная плата	заработная плата
заработок	заработак
захват	захват
защита	абарона
защитник	абаронца
земельная община	зямельная грамада
земельная рента	зямельная рэнта
землевладелец	зямляўласьнiк
землевладение общинное	грамадаўскае зямляўладаньне
землевладение частное	прыватнае зямляўладаньне
землевладельческий класс	зямляўласьнiцкая кляса
землевладелец	рольнiк
земледелие	ральніцтва
земледелие первобытное	першабытнае ральніцтва
земледелие плуговое	плугавое ральніцтва
земледелие ручное	ручное ральніцтва
землевладельческий период	ральнiцкi пэрыод
земледельческое орудие	ральнiцкая прылада
знание	веда
знать	магнацтва
иго	ярмо, няволя
идеография	iдэографiя
идол	балван
идолопоклонник	балвахвал
идолопоклонство	балвахвальства
иероглиф	героглiф
избиратель	выбiральнiк
избирательная монархия	выбарная монархiя
избирательное право	выбарнае права
избирательное право активное	дзейна-выбарнае права
избирательное право всеобщее	агульнае выбарнае права
избирательное право пассивное	нядзейна-выбарнае права
избирательный ценз	выбарны цэнз
избранник	выбраньнiк
изгнание	выгнаньне
изгнанник	выгнаньнiк
изделие фабричное	фабрычны выраб
изобретатель	вынаходца
изобретение	вынаходка
изувер	фанатык
изуверство	фанатызм
иконоборец	вобразаборца
иконоборство	вобразаборства
иконопоклонение	вобразахвальства
иконопоклонник	вобразахвал
иммигрант	усяленец
иммиграция	усяленьне
иммунитет	непарушнасьць, незачэпнасьць
император	iмпэратар
империализм	iмпэрыялiзм
империалист	iмпэрыялiсты
империалистический	iмпэрыялiстычны
империя	iмпэрыя
импорт	увоз, прывоз
имущественная безопасность	маёмасная бясьпека
имущественный ценз	маёмасны цэнз
имущество	маёмасьць
имущий класс	заможная кляса
индивидуальное хозяйство	паасобная гаспадарка
индустриализация	упрамысловеньне
индустриальный	прамысловы
индустрия	прамысловасьць
инкорпорация	улучэньне
иноверец	чужаверац
иноверный	чужаверны
иногородний	iншагародны, iншамескi
иноземец	чужаземец
иноземный	чужаземны
инок	манах
иноплеменник	чужаплемец
иноплеменный	чужапляменны
иностранец	чужаземец
иностранная власть	чужаземная ўлада
иностранный	чужаземны
иночество	манаства
интеллигенция	iнтэлiгенцыя
интенсивное хозяйство	iнтэнсыўная гаспадарка
интенсификация	iнтэнсыфiкацыя
интервенция	iнтэрвэнцыя, умяшальнасьць
интерес	iнтарэс
интерес групповой	групавы iнтарэс
интерес классовый	клясавы iнтарэс
интерес личный	асабовы iнтарэс
интерес общий	супольны iнтарэс
интернационал	iнтэрнацыянал
Интернационал Коммунистический	Комуністычны Iнтэрнацыянал
интернациональная культура	мiжнародная культура
искусство	мастацтва
ислам	iслам
исповедание	вызнаньне
исполнительная власть	выканаўчая ўлада
исполнительный труд	выканаўчая праца
историограф	гісторыяпiсец
историография	гiсторыяпiс
исторический	гістарычны
история	гiсторыя
история всеобщая	сусьветная гiсторыя
история древняя	старажытная гiсторыя
история новая	новая гiсторыя
история средневековая	гісторыя сярэднiх вякоў
казенный	скарбовы, дзяржаўны
казна	скарб
казначейство	скарбовая камора
казнить	пакараць сьмерцю
казнохранилище	скарбнiца
казнь	кара сьмерцю
календарь	каляндар
каменно-угольная промышленность	каменна-вуглёвая прамысловасьць
каменное орудие	каменная прылада
каменный век	каменны век
канцлер	канцлер
капитал	капiтал
капитал акционерный	акцыйны капiтал
капитал банковый	банкаўскi капiтал
капитал движимый	рухомы капiтал
капитал запасный	запасны капiтал
капитал крупный	вялiкi капiтал
капитал мелкий	дробны капiтал
капитал облигационный	облiгацыйны капiтал
капитал оборотный	зваротны капiтал
капитал основной	iста, асноўны капiтал
капитал переменный	зьменны капiтал
капитал постоянный	сталы капiтал
капитал производительный	продукцыйны капiтал
капитал производственный	вытворчы капiтал
капитал промышленный	прамысловы капiтал
капитал ростовщический	лiхвярскi капiтал
капитал торгово-промышленный	гандлёва-прамысловы капiтал
капитал торговый	гандлёвы капiтал
капитал финансовый	фiнансавы капiтал
капитализм военно-государственный	ваенна-дзяржаўны капiталiзм
капитализм государственный	дзяржаўны капiталiзм
капитализм промышленный	прамысловы капiталiзм
капитализм торговый	гандлёвы капiталiзм
капиталистическая буржуазия	капiталiстычная буржуазiя
капиталистическое накопление	капiталiстычнае назьбiраньне
капиталистическое общество	капiталiстычнае грамадзтва
капиталистическое производство	капiталiстычная продукцыя
капиталистическое хозяйство	капiталiстычная гаспадарка
капитуляция	капiтуляцыя
касса больничная	больнiчная каса
касса взаимопомощи	каса ўзаемнае дапамогi
касса страховая	каса страхавая
каста	каста
кастовый строй	каставы ўклад
католичество	каталiцтва
клан	клан
класс	кляса
класс буржуазный	буржуазная кляса
класс военный	вайсковая кляса
класс господствующий	пануючая кляса
класс землевладельческий	зямляўласьнiцкая кляса
класс имущий	заможная кляса
класс неимущий	незаможная кляса
класс правящий	кiраўнiчая кляса
класс пролетарский	пролетарская кляса
класс промежуточный	прамежная, пасярэдняя кляса
класс промышленный	прамысловая кляса
класс торгово-промышленный	гандлёва-прамысловая кляса
класс эксплуатируемый	вызысканая кляса
класс эксплуатирующий	вызыскальная кляса
классицизм	клясыцызм
классический	клясычны
классовая борьба	клясавая барацьба, змаганьне
классовое благо	клясавае дабро
классовые привиллегии (привилегии)	клясавыя прывiлеi
классовые противоречия	клясавыя супярэчнасьцi
классовый интерес	клясавы iнтарэс
клерикал	клерыкал, царкоўнiк, касьцёльнiк
клерикализм	клерыкалiзм, царкоўнiцтва, касьцёльнiцтва
клинопись	клiнапiс
клуб	клюб
книгопечатание	друкарства
княжеский	княжы
княжество	княства
князь	князь
коалиция	коалiцыя
кодекс	кодэкс, збор законаў
колдовство	чараўнiцтва
колдун	чараўнiк
колесница	калясьнiца
коллектив	суполка
коллективизм трудовой	працоўны колектывiзм, супольнасьць
коллективная работа	гуртавая, супольная, колектыўная праца
коллективная собственность	супольная ўласнасьць
колонат	колёнат
колониальная война	колёнiяльная вайна
колониальная политика	колёнiяльная полiтыка
колониальная промышленность	колёнiяльная прамысловасьць
колониальное производство	колёнiяльная продукцыя
колонизация	колёнiзацыя, асаднiцтва
колонист	колёнiсты, асаднiк
колония	колёнiя, асада
комиссар	камiсар
комиссариат	камiсарыят
коммуна	комуна
коммунизм	комунiзм
коммунизм военный	ваенны комунiзм
коммунизм первобытный	першабытны комунiзм
коммунизм христианский	хрысьцiянскi комунізм
коммунист	комунiсты
коммунистическая партия	комунiстычная партыя
Коммунистический интернационал	Комунiстычны інтэрнацыянал
коммунистический строй	комунiстычны ўклад
коммунистическое производство	комунiстычная продукцыя, вытворчасьць
конвент	конвэнт
конвенция	конвэнцыя
конгресс	конгрэс
конкордат	конкордат
конкуренция рыночная	рыначная конкурэнцыя
консерватизм	консэрватызм
консерватор	консэрватар
консорциум	консорцыум
конспиративный	змоўны
конспиратор	змоўнiк
конспирация	змова
конституанта	констытуанта
конституционная монархия	констытуцыйная монархiя
конституционное государство	констытуцыйная дзяржава
конституционное правление	констытуцыйны ўклад
конституция	констытуцыя
конституция государственная	дзяржаўная констытуцыя
конституция местная (областная)	краёвая констытуцыя
конституция октроированная	дарованая констытуцыя
конституция федеральная	фэдэральная констытуцыя
консул	консул
консульство	консульства
континентальная война	сухаземная вайна
континентальная политика	сухаземная полiтыка
континентальная система	контынэнтальная сыстэма
контрабанда	контрабанда
контрабандист	контрабандысты
контрибуция	контрыбуцыя
контр-революция	контр-рэволюцыя
конфедерация	конфэдэрацыя
конфедерированное государство	конфэдэраваная дзяржава
конфискация	конфiскацыя, заскарбаваньне
конфискованный	конфiскованы, заскарбованы
конфисковать	конфiскаваць, заскарбаваць
конфликт	конфлiкт, стычка, спрэчка
концентрация капитала	концэнтрацыя капiталу
концентрация производства	концэнтрацыя продукцыi
концерн	концэрн
концессия	концэсiя
кооператив	коопэратыва
кооперация	коопэрацыя, суполка
кооперация потребительская	спажывецкая коопэрацыя, суполка
копательная палка	капальная палка, капачка
кораблеплавание	карабляплаваньне
королевство	каралеўства
король	кароль
косвенные налоги	пабочныя падаткi
космополит	космополiт, сусьветнiк
космополитизм	космополiтызм, сусьветнiцтва
костяное орудие	касьцяная прылада
кочевник	качоўнiк, вандроўнiк
кочевое хозяйство	качоўная гаспадарка
кочевой период	качоўны пэрыод
кредитный банк	банк пазычковы
крепостник	прыгоньнiк
крепостное право	прыгоннае права
крепостное сословие	прыгонны стан
крепостное хозяйство	прыгонная гаспадарка
крепостной	прыгонны
крепостной труд	прыгонная праца
крепость	крэпасьць
крестовые походы	крыжовыя паходы
крестоносец	крыжак
крестьянин	селянiн
крестьянское сословие	сялянскi стан
крестьянское хозяйство	сялянская гаспадарка
крестьянство	сялянства
кризис промышленный	прамысловы крызiс
кровная связь	кроўная сувязь
крупная буржуазия	буйная буржуазiя
крупно-капиталистическое производство	буйна-капiталiстычная продукцыя, вытворчасьць
крупный капитал	вялiкi капiтал
культ мертвых	культ мёртвых
культура	культура
культура античная	антычная культура
культура городская	гарадзкая культура
культура дворянская	шляхецкая культура
культура духовная	духоўная культура
культура интернациональная	мiжнародная культура
культура материальная	матэрыяльная культура
культура национальная	нацыянальная культура
культура общечеловеческая	агульналюдзкая культура
культура первобытная	першабытная культура
культура придворная	прыдворная культура
культура пролетарская	пролетарская культура
культурная автономия	культурная аўтономiя
культурно-персональная автономия	культурна-пэрсональная аўтономiя
купец	купец
купеческое сословие	купецкi стан
купечество	купецтва
кустарная промышленность	саматужная прамысловасьць
кустарное производство	саматужная продукцыя
кустарь	саматужнiк
лавка	крама
лагерь	стан
лаократия	народаўладзьдзе
ленная зависимость	ленная залежнасьць
ленник	леньнiк
лесное хозяйство	лясная гаспадарка
летописец	летапiсец
летопись	летапiс
летосчисление	летазьлiчэньне
либерал	лiбэрал
либерализм	лiбэралiзм
лига	лiга
личная безопасность	асабовая бясьпека
личная свобода	вольнасьць асобы
личное благо	асабовае дабро
личный интерес	асабовы інтарэс
лодка	лодка
люмпэн-пролетариат	люмпэн-пролетарыят
лютеранство	лютаранства
маг	маг, чорнакнiжнiк
магия	магiя, чорнакнiжжа
магометанство	магомэтанства
мажоритарное представительство	прадстаўнiцтва большасьці
манифест	манiфэст
мануфактура	мануфактура, крамнiна
марксизм	марксызм
массонская ложа	масонская лёжа
массонство	масонства
мастеровой	рамесьнік
мастерская	майстэрня
материализм	матэрыялiзм
материалист	матэрыялiсты
материальная культура	матэрыяльная культура
матриархат	матрыархат
машинное производство	машинная продукция, вытворчасьць
медиатизация	мэдыатызацыя
международная связь	мiжнародная сувязь
междуусобная война	дамовая вайна
мелкая буржуазия	дробная буржуазiя
мелкий капитал	дробны капiтал
мелкое крестьянское землевладение	дробнае сялянскае зямляўладаньне
мелкое производство	дробная продукцыя, вытворчасьць
меморандум	напамiнаньне, мэморандум
меновая ценность	менавая цэннасьць
меновое общество	менавое грамадзтва, таварыства
меновой банк	менавы банк
меркантилизм	мэркантылiзм, гандлярства
меркантильная система	мэркантыльная, гандлярская сыстэма
местная власть	мясцовая ўлада
местная (областная) конституция	краёвая констытуцыя
местное самоуправление	мясцовы самаўрад
местное управление	мясцовая ўправа
металлургическая промышленность	мэталюргiчная прамысловасьць
метрополия	мэтрополiя
механическая сила	мэханiчная сiла
мещанин	мешчанiн
мещанство	мяшчанства
милитаризм	мiлiтарызм
милитаристическая политика	мiлiтарыстычная полiтыка
милиция	мiлiцыя
минимум заработной платы	мiнiмум заработнай платы
министерство	мiнiстэрства
министр	мiнiстар
мир	сьвет
мир античный	антычны сьвет
мир загробный	пазамагiльны сьвет
мир средневековый	сярэднявяковы сьвет
мир (согласие)	мiр, згода, спакой
мирный	мiрны, спакойны
мировоззрение	сьветагляд
митинг	мітынг
миф	мiт
мифолог	мiтолёг
мифология	мiтолёгiя
многобожие	многабожжа
многобожник	многабожнiк
многобрачие	многажонства
мобилизация	мобілізацыя
монарх	монарх
монархия абсолютная	абсолютная, неагранiчаная монархiя
монархия бюрократическая	бюрократычная монархiя
монархия деспотическая	дэспотычная монархiя
монархия дуалистическая	дваiстая монархiя
монархия избирательная	выбарная монархiя
монархия конституционная	констытуцыйная монархiя
монархия наследственная	насьледная монархія
монархия ограниченная	констытуцыйная монархiя
монархия парламентарная	парлямэнтарная монархiя
монархия самодержавная	самадзяржаўная монархiя
монастырь	манастыр, кляштар
монах	манах
моногамия	аднажонства
монополизация	монополiзацыя
монополия	монополія
мореплавание	мораплаваньне
мореплаватель	мораплаўнiк
морская война	морская вайна
морская торговля	морскi гандаль, таргоўля
морской путь	морскi шлях
мотыга	матыка
мотыжная культура	матычная культура
муниципалитет	мунiцыпалiтэт
мусульманство	мусульманства
мятеж	мяцеж
мятежник	мяцежнiк
набег	наезд, набег
надгосударственная власть	наддзяржаўная ўлада
надел	надзел
наемник	наймiт
наемное войско	нанятае войска
наемные рабочие	наёмныя рабочыя
наемный труд	наёмная праца
накопление капиталистическое	капiталiстычнае накапленьне
накопление первоначальное	першапачатковае накапленьне
налог	падатак
налог косвенный	пабочны падатак
налог подоходный	прыбытковы падатак
налог поимущественный	маёмасны падатак
налог прогрессивно-подоходный	паступова-прыбытковы падатак
налог прямой	просты падатак
наместник	намесьнiк
наместничество	намесьнiцтва
народ	народ
народное голосование	народнае галасаваньне
народное представительство	народнае прадстаўнiцтва
народность	народнасьць, нацыянальнасьць
Народный Комиссариат Внешней Торговли (Наркомвнешторг)	Народны Камiсарыят Загранiчнага Гандлю, Таргоўлi
Народный Комиссариат Внутренней Торговли (Наркомвнуторг)	Народны Камiсарыят Унутранага Гандлю, Таргоўлi
Народный Комиссариат Внутренних Дел (Наркомвнутдел)	Народны Камісарыят Унутраных Спраў
Народный Комиссариат Здравоохранения (Наркомздрав)	Народны Камiсарыят Аховы Здароўя
Народный Комиссариат Земледелия (Наркомзем)	Народны Камiсарыят Рольнiцтва
Народный Комиссариат по Военным и Морским Делам (Наркомвоенмор)	Народны Камiсарыят Вайсковых i Морскiх Спраў
Народный Комиссариат по Иностранным Делам (Наркоминдел)	Народны Камiсарыят Загранiчных Спраў
Народный Комиссариат по Национальным Делам (Наркомнац)	Народны Камiсарыят Нацыянальных Спраў
Народный Комиссариат Почты и Телеграфов (Наркомпочтель)	Народны Камiсарыят Пошты i Тэлеграфу
Народный Комиссариат Просвещения (Наркомпрос)	Народны Камiсарыят Асьветы
Народный Комиссариат Путей Сообщения	Народны Камiсарыят Дарожных Зносiн
Народный Комиссариат Рабоче-Крестьянской Инспекции	Народны Камiсарыят Рабоча-Сялянскай Iнспэкцыi
Народный Комиссариат Социального Обеспечения	Народны Камiсарыят Соцыяльнага Забесьпячэньня
Народный Комиссариат Труда (Наркомтруд)	Народны Камiсарыят Працы
Народный Комиссариат Финансов	Народны Камiсарыят Фiнансаў
Народный Комиссариат Юстиции	Народны Камiсарыят Юстыцыi
народный суверенитет	народны сувэрэнiтэт
народовластие	народаўладзьдзе
народонаселение	насяленьне
народоправие	народапраўства
население	насяленьне, люднасьць
население безземельное	безьзямельнае насяленьне, люднасьць
население безработное	безработнае насяленьне, люднасьць
наследник	насьледнiк
наследование	насьледваньне
наследственная власть монарха	насьледная ўлада монарха
наследственная монархия	насьледная монархiя
наследственность	спадчына, насьледзьдзе
наступательная война	зачэпная вайна
натуральная подать	натуральны падатак
натурально-меновое хозяйство	натуральна-менавая гаспадарка
натуральное хозяйство	натуральная гаспадарка
натуральный фетишизм	натуральны фэтышызм
научная экспедиция	навуковая экспэдыцыя, выправа
научный социализм	навуковы соцыялiзм
национализация	нацыяналiзацыя
национализм	нацыяналiзм
национальная культура	нацыянальная культура
национальное движение	нацыянальны рух
национальное собрание	нацыянальны збор
национальность	нацыянальнасьць, народнасьць
национальный	нацыянальны
национальный вопрос	нацыянальнае пытаньне
нация	нацыя
нашествие	навала
невольник	нявольнiк
невольничество	нявольнiцтва
неволя	няволя
независимость	незалежнасьць
независимый	незалежны
неимущий класс	незаможная кляса
нейтралитет	бесстароннасьць, нэйтралiтэт
необходимое рабочее время	канечны рабочы час
неограниченная власть	неагранiчаная, неабмежаваная ўлада
неограниченная монархия	неагранiчаная монархiя, неабмежаваная монархiя
неограниченность	неагранiчанасьць, неабмежаванасьць
неолитический век	новакаменны век
непобедимость	непераможнасьць
непобедимый	непераможны
непогрешимость (папская)	неамыльнасьць
непосредственная демократия	беспасярэдняя дэмократыя
непосредственная республика	беспасярэдняя рэспублiка
непосредственный обмен	беспасярэдняя мена
неприкосновенность	недатыкальнасьць
неравенство социальное	грамадзкая няроўнасьць
нераздельность	непадзельнасьць
несуверенное государство	нясувэрэнная дзяржава
нетерпимость	нязносьлiвасьць
нижняя палата (парламента)	нiжэйшая палата
низвержение	зьвяржэньне
новая история	новая гiсторыя
новая экономическая политика	новая экономiчная полiтыка
объединение	аб'яднаньне
объединитель	аб'яднальнiк
объединительный	аб'яднальны
обезземеление	абезьзямеленьне
обезоруженный	раззброены
обитаемый	залюднены
обитатель	тубылец, насельнiк
областная автономия	краёвая аўтономiя
областной	краёвы
область	краiна
область автономная	аўтономная краiна
обмен	мена, памена
обмен денежный	грашовая мена, памена
обмен непосредственный	беспасярэдняя мена, памена
обмен товарный	таварная мена, памена
обожествление власти	абагаўленьне ўлады
оборона	абарона
оборонительная война	абаронная вайна
оборотный капитал	зваротны капiтал
обрабатывающая промышленность	апрацоўчая прамысловасьць
образ жизни	спосаб жыцьця
образование	асьвета
образованность	адукованасьць
образовательный ценз	адукацыйны цэнз, асьветны цэнз
оброк	чынш
обряд	абрад
обскурант	обскурант
обскурантизм	обскурантызм
общая собственность	супольная ўласнасьць
общее благо	агульнае дабро
общенародный	усенародны
общественная безопасность	грамадзкая бясьпека
общественная должность	грамадзкая пасада
общественная связь	грамадзкая сувязь
общественно-политический строй	грамадзка-полiтычны лад
общественное мнение	грамадзкая думка
общественное пастбище	грамадзкая паша
общественное поле	грамадзкае поле
общественное производство	грамадзкая продукцыя, вытворчасьць
общественное разделение труда	грамадзкi падзел працы
общественность	грамадзкасьць
общественные игры	грамадзкiя гульнi
общественные работы	грамадзкiя работы
общественный	грамадзкi
общественный договор	грамадзкая ўмова, дагавор, угода
общество	грамадзтва, таварыства, супольства
общество бесклассовое	бясклясавае грамадзтва
общество бессословное	бясстанавае прамадзтва
общество капиталистическое	капiталiстычнае грамадзтва
общество меновое	менавое грамадзтва, таварыства
общество первобытно-коммунистическое	першабытна-комунiстычнае грамадзтва
общество первобытное	першабытнае грамадзтва
общество рабовладельческое	рабаўласьнiцкае грамадзтва
общество социалистическое	соцыялiстычнае грамадзтва
общество феодальное	фэўдальнае грамадзтва
обществоведение	грамадазнаўства
общечеловеческая культура	агульналюдзкая культура
общий интерес	супольны iнтарэс
община	грамада
община земельная	зямельная грамада
община патриархальная	патрыархальная грамада
община религиозная	рэлiгiйная грамада
община семейная	сямейная грамада
общинное землевладение	грамадаўскае зямляўладаньне
общинное хозяйство	грамадаўская гаспадарка
обычай	звычай
объявление войны	аб'яўленьне вайны
огнебойное орудие	гармата
огнепоклонение	агняхвальства
огнепоклонник	агняхвал
огнестрельное оружие	пальная зброя
ограниченная монархия	агранiчаная монархiя
одиночная работа	адзiночная работа
одичавшее племя	зьдзiчэлае племя
однопалатный парламент	аднапалатны парлямэнт
океанические пути	акiянiчныя шляхi
оккупация	окупацыя
октроированная конституция	дараваная констытуцыя
олигарх	олiгарх
олигархия	олiгархiя
олицетворение	увасабленьне
оппозиционер	опозыцыянэр
оппозиционный	опозыцыйны
оппозиция	опозыцыя
оппортунизм	опортунiзм, згоднiцтва
оппортунист	опортунiсты, згоднiк
оптовая торговля	гуртавы гандаль, таргоўля
оракул	аракул
организаторский труд	органiзатарская праца
организация	органiзацыя
организация рабовладельческая	рабаўласьнiцкая органiзацыя
орда	арда
орден (орган)	ордэн
орудие деревянное	дзераўляная прылада
орудие земледельческое	ральнiцкая прылада
орудие каменное	каменная прылада
орудие костяное	касьцяная прылада
орудие огнебойное	гармата
орудие производства	прылада продукцыi, вытворчасьцi
орудие труда	прылада працы
оружие	зброя
оружие огнестрельное	пальнае аружжа
осада	аблога
осадное положение	абложны стан
осажденный	абложаны
освободитель	вызвалiцель
освободительница	вызвалiцелька
освободительное движение	вызваленчы рух
освобождать	вызваляць
освобождение	вызваленьне
освобожденный	вызвалены
основание (города)	залажэньне, закладзiны
основатель	закладальнiк
основной капитал	iста, асноўны капiтал
ответственность	адказнасьць
ответственность политическая	полiтычная адказнасьць
ответственность юридическая	праўная адказнасьць
отечественная война	вайна за айчыну
отечество	айчына, бацькаўшчына
откуп	адкуп, арэнда
откупная система	адкупная сыстэма
откупщик	адкупнiк, арандатар
относительное перенаселение	адноснае пералюдненьне
отношения производственные	вытворчыя адносiны
отпущенник	вызваленец
отпущенница	вызваленка
отречение	вырачэньне, адрачэньне
отступление	адступленьне
отступник	адшчапенец, адступнiк
отступничество	адшчапенства, адступнiцтва
отторжение	адарваньне
отхожий промысел	адходны промысел
отчуждение территории	адабраньне тэрыторыi
отшельник	пустэльнiк
отшельничество	пустэльнiцтва
охлократия	охлёкратыя
охота	паляўнiцтва
охотничий период	паляўнiчы пэрыод
охотничий промысел	паляўнiчы промысел
охотничье хозяйство	паляўнiчая гаспадарка
охрана	абарона, ахова
охранитель	абаронца, ахоўнiк
охранная грамота	ахоўная грамата
палата верхняя	верхняя палата
палата депутатов	палата паслоў, дэпутатаў
палата лордов	палата лёрдаў, сэнатараў
палата нижняя	нiжняя палата
палеолитический век	старакаменны век
панисламизм	панiсламiзм
панславизм	панславiзм
парий	пары
парламент	парлямэнт
парламент двухпалатный	двухпалатны парлямэнт
парламент однопалатный	аднапалатны парлямэнт
парламентаризм	парлямэнтарызм
парламентарная монархия	парлямэнтарная монархiя
парламентарная республика	парлямэнтарная рэспублiка
паровая техника	паравая тэхнiка
паровой двигатель	паравы рухоўнiк
пароход	параход
партизан	партызан
партизанская война	партызанская вайна
партия	партыя
партия коммунистическая	комунiстычная партыя
парусное судно	парусная суднiна
пассивное гражданство	нядзейнае грамадзянства
пассивное избирательное право	нядзейна-выбарнае права
патриархальная община	патрыархальная грамада
патриархально-родовой период	патрыархальна-радавы пэрыод
патриархат	патрыархат
патриот	патрыота
патриотизм	патрыотызм
патриотический	патрыотычны
патриций	патрыцы
пауперизм	галота, паўпэрызм
пацифизм	мiрлiвасьць, пацыфiзм
пацифист	мiрлiвец, пацыфiсты
пацифистский	мiрлiвы, пацыфiскi
первенство	пяршынства
первобытная культура	першабытная культура
первобытно-коммунистическое общество	першабытна-комунiстычнае грамадзтва
первобытно-охотничье производство	першабытна-паляўнiчая продукцыя
первобытное земледелие	першабытнае ральнiцтва
первобытное общество	першабытнае грамадзтва
первобытное присвояющее хозяйство	першабытная прысваяльная гаспадарка
первобытный брак	першабытны шлюб
первобытный родовой коммунизм	першабытны радавы комунiзм
первоначальное накопление	першапачатковае накапленьне
переворот	пераварот
переворот политический	полiтычны пераварот
переворот социальный	соцыяльны пераварот
переменный капитал	зьменны капiтал
перемирие	замiрэньне
перенаселение	пералюдненьне, перанасяленьне
перенаселение абсолютное	абсолютнае пералюдненьне, перанасяленьне
перенаселение относительное	адноснае пералюдненьне, перанасяленьне
перепись	перапiс
перепроизводство	перапродукцыя, перавытворчасьць
переселенец	перасяленец
переселение	перасяленьне
период	пэрыод, кругабег
период доисторический	дагiстарычны пэрыод, кругабег
период земледельческий	ральнiчы пэрыод, кругабег
период кочевой	вандроўны пэрыод, кругабег
период охотничий	паляўнiчы пэрыод, кругабег
период патриархально-родовой	патрыархальна-радавы пэрыод, кругабег
период скотоводческий	жывёлаводны пэрыод, кругабег
периодическая печать	пэрыодычны друк
персональная уния	пэрсональная, асабовая вунiя
печать	друк
печать периодическая	пэрыодычны друк
плантационное хозяйство	плянтацыйная гаспадарка
пластические искусства	плястычныя мастацтвы
плата заработная	заработная плата
плебисцит	плебiсцыт
племя	племя
племя одичавшее	зьдзiчэлае племя
плен	палон
пленник	палонны
плуговое земледелие	плугавое ральнiцтва
плутократия	плютократыя
побег	уцёкi
победа	перамога
победитель	пераможнiк
победительный	перамагальны
победный	пераможны
пебежденный	пераможаны
повелитель	уладар
повинность	павiннасьць
повинность воинская	вайсковая павiннасьць
повозка	воз
повременная оплата труда	пачасовая аплата працы
поголовная подать	падушны падатак
пограничный	пагранiчны
подать	падатак
подать натуральная	натуральны падатак
подать поземельная	зямельны падатак
подвластный	падуладны
подданный	падданы
подданство	падданства
поденная работа	падзённая работа
подземное царство	падземны сьвет
подмастерье	чаляднiк
подоходный налог	падатак на прыбытак
подсобный промысел	падсобны промысел
поединок	паядынак
поезд	поезд
пожизненность власти монарха	дажывотнасьць улады монарха
пожизненный	дажывотны
позиция	позыцыя
поимущественный налог	маёмасны падатак
поклонение	пахваленьне
поклоняться	пахваляць
поколение	пакаленьне
покорение	пакарэньне
покоритель	пакарыцель
покровитель	апякун
покровительствование	апекаваньне
покровительствуемое государство	падапечная дзяржава
покупка	купля
покушение	замах
полиандрия	многамуства
полигамия	многажонства
политика	полiтыка
политика агрессивная	зачэпная полiтыка
политика внешняя	загранiчная полiтыка
политика внутренняя	унутраная полiтыка
политика иностранная	замежная, загранiчная полiтыка
политика колониальная	колёнiяльная полiтыка
политика континентальная	сухаземная, контынэнтальная полiтыка
политика протекционная	апякунчая полiтыка
политическая ответственность	полiтычная адказнасьць
политическая революция	полiтычная рэволюцыя
политическая экономия	полiтычная экономiя
политический абсолютизм	полiтычны абсолютызм
политический договор	полiтычная ўмова, дагавор, угода
политический переворот	полiтычны пераварот
политический союз	полiтычны саюз
политический суверенитет	полiтычны сувэрэнiтэт
политический террор	полiтычнае застрашэньне, тэрор
политическое движение	полiтычны рух
политическое устройство	полiтычны ўклад
полицейское государство	полiцэйская дзяржава
полиция	полiцыя
полководец	войскавод
полная (развернутая) форма обмена	поўная (разьвiнутая) форма мены
полновластие	поўнаўладзьдзе
полновластный	поўнаўладны
полномочие	поўнамоцтва
полномочный	поўнамоцны
полноправие	поўнапраўе
полноправный	поўнапраўны
положение военное	ваеннае палажэньне, стан
поместье	двор
помещик	абшарнiк
помещичий	абшарнiцкi
поработитель	заняволец
поработить	заняволiць
порабощение	заняволя
порабощенный	заняволены
поражение	паражэньне
поселенец	асаднiк, пасяленец
поселение	асада, пасяленьне
посол	пасол
посольство	пасольства
посредничество	пасрэднiцтва
постоянный капитал	сталы капiтал
потомок	патомак
потомственный	патомны
потомство	патомства
потребительный рынок	спажыўчы рынак
потребительская кооперация	спажывецкая коопэрацыя
поход	паход
походы крестовые	крыжовыя паходы
почитание	пахваленьне
пошлина таможенная	мыта
правитель	кiраўнiчы
правительственная власть	урадавая ўлада
правительство	урад
править	кiраваць
правление	кiраўнiцтва
правление конституционное	констытуцыйны ўклад
правление представительное	прадстаўнiчы ўклад
право избирательное	выбарнае права
право избирательное активное	дзейна-выбарнае права
право избирательное пассивное	нядзейна-выбарнае права
право крепостное	прыгоннае права
право убежища	права прыпынку
правовая связь	праўная сувязь
православие	праваслаўе
правящие классы	кiраўнiчыя клясы
предатель	здраднiк
предательство	здраднiцтва
предводитель	верхавод
предложение (товара)	посул
предок	продак
предопределение	празначэньне
предпринимательская прибыль	прадпрыемчы прыбытак, зыск
предприятие	прадпрыемства
председатель	старшыня
председательство	старшынства
представитель	прадстаўнiк
представительная демократия	прадстаўнiчая дэмократыя
представительная республика	прадстаўнiчая рэспублiка
представительное правление	прадстаўнiчы ўклад
представительное собрание	прадстаўнiчы сход
представительные учреждения	прадстаўнiчыя ўстановы
представительство	прадстаўнiцтва
представительство мажоритарное	мажорытарнае прадстаўнiцтва
представительство народное	народнае прадстаўнiцтва
предшественник	папярэднiк
преемник	наступнiк
преемственность власти	пераймальнасьць улады
преобразование	рэформа
преобразователь	рэформатар
преобразовательница	рэформатарка
преобразовательный	рэформатарскi
преследование	прасьледваньне
престол	пасад, трон
претендент	прэтэндэнт
прибавочная стоимость	дадатковая вартасьць
прибавочная ценность	дадатковая цэннасьць
прибавочное рабочее время	дадатковы рабочы час
прибавочный продукт	дадатковы продукт
прибавочный труд	дадатковая праца
прибежище	прыпынак
прибыль	прыбытак
прибыль предпринимательская	прадпрыемчы прыбытак
прибыль торговая	гандлёвы, тарговы прыбытак
прибыль учредительская	устаноўчы прыбытак
привиллегии (привилегии) классовые	клясавыя прывiлеi
привиллегии (привилегии) сословные	станавыя прывiлеi
привиллегированный (привилегированный)	упрывiлеяваны
привиллегия (привилегия)	прывiлей
пригород	прадмесьце, прыгарад
пригородный	прыгарадны
придворная культура	прыдворная культура
призыв	прызыў
прикрепление крестьян	прымацаваньне сялян
приручение животных	прыручэньне жывёлы
присвояющее хозяйство	прысваяльная гаспадарка
присоединение	далучэньне
притеснение	уцiск
провинция	провiнцыя
прогресс	поступ, прогрэс
прогрессивно-подоходный налог	паступова-прыбытковы падатак
прогрессивный	паступовы, прогрэсыўны
прогрессист	паступовец, прогрэсысты
продукт прибавочный	дадатковы продукт
производитель	продуктар
производительность	продукцыйнасьць
производительность труда	продукцыйнасьць працы
производительные силы	продукцыйныя, вытворчыя сiлы
производительный труд	продукцыйная праца
производственная техника	вытворчая тэхнiка
производственные отношения	вытворчыя адносiны
производство	продукцыя, вытворчасьць
производство домашнее	дамовая продукцыя, вытворчасьць
производство капиталистическое	капiталiстычная продукцыя, вытворчасьць
производство колониальное	колёнiяльная продукцыя, вытворчасьць
производство коммунистическое	комунiстычная продукцыя, вытворчасьць
производство крупно-капиталистическое	буйна-капiталiстычная продукцыя, вытворчасьць
производство кустарное	саматужная продукцыя, вытворчасьць
производство машинное	машынная продукцыя, вытворчасьць
производство мелкое	дробная продукцыя, вытворчасьць
производство общественное	грамадзкая продукцыя, вытворчасьць
производство первобытно-охотничье	першабытна-паляўнiчая продукцыя, вытворчасьць
производство сельско-хозяйственное	сельска-гаспадарчая продукцыя, вытворчасьць
производство социалистическое	соцыялiстычная продукцыя, вытворчасьць
производство средств потребления	продукцыя сродкаў спажываньня
производство средств производства	продукцыя сродкаў вытворчасьцi
производство товарное	таварная продукцыя, вытворчасьць
производящее хозяйство	вытворчая гаспадарка
происхождение	пахаджэньне
прокламация	адозва, проклямацыя
пролетариат	пролетарыят
пролетариат промышленный	прамысловы пролетарыят
пролетарий	пролетары
пролетарская культура	пролетарская культура
пролетарская революция	пролетарская рэволюцыя
пролетарский класс	пролетарская кляса
пролетарское государство	пролетарская дзяржава
промежуточные классы	пасярэднiя клясы
промысел	промысел
промысел отхожий	адыходны промысел
промысел подсобный	падсобны промысел
промысел охотничий	паляўнiчы промысел
промышленник	прамысловец
промышленность	прамысловасьць
промышленность добывающая	здабыўчая прамысловасьць
промышленность домашняя	дамовая прамысловасьць
промышленность колониальная	колёнiяльная прамысловасьць
промышленность кустарная	саматужная прамысловасьць
промышленность металлургическая	мэталюргiчная прамысловасьць
промышленность обрабатывающая	апрацоўчая прамысловасьць
промышленность текстильная	ткацкая прамысловасьць
промышленность фабрично-заводская	фабрычная прамысловасьць
промышленный	прамысловы
промышленный капитал	прамысловы капiтал
промышленный капитализм	прамысловы капiталiзм
промышленный класс	прамысловая кляса
промышленный кризис	прамысловы крызiс
промышленный пролетариат	прамысловы пролетарыят
пропаганда	пропаганда
пропорциональная система выборов	пропорцыянальная сыстэма выбараў
просветитель	асьветнiк
просветительный	асьветны
просвещение	асьвета
просвещенный абсолютизм	асьветны абсолютызм
простая (случайная) форма обмена	простая (выпадковая) форма мены
проституция	простытуцыя
протекторат	апека
протекционизм	апекаваньне, протэкцыянiзм
протекционная политика	апякунчая полiтыка
протестантизм	протэстантызм
противоречия классовые	клясавыя супярэчнасьцi
профессиональное движение	профэсiянальны рух
профессиональный союз	профэсiянальны саюз
профессия	профэсiя
прямые налоги	простыя падаткi
путь водный	водны шлях
путь воздушный	паветраны шлях
путь морской	морскi шлях
путь океанический	акiянiчны шлях
путь торговый	гандлёвы, тарговы шлях
раб	раб, нявольнiк
рабовладельческая организация	рабаўласьнiцкая органiзацыя
рабовладельческое общество	рабаўласьнiцкае грамадзтва
рабовладельческое хозяйство	рабаўласьнiцкая гаспадарка
работа коллективная	гуртавая, колектыўная работа
работа общественная	грамадзкая работа
работа одиночная	адзiночная работа
работа поденная	падзённая работа
рабочая сила	рабочая сiла
рабочее движение	рабочы, работнiцкi рух
рабочие наемные	наёмныя рабочыя
рабочий	рабочы, работнiк
рабочий вопрос	рабочае пытаньне
рабский	нявольнiцкi, рабскi
рабство	нявольнiцтва, рабства
рабыня	нявольнiца, рабыня
равенство	роўнасьць
равноправие	роўнапраўнасьць
радикал	радыкал
радикализм	радыкалiзм
радикальный	радыкальны
развернутая форма обмена	разьвiнутая форма мены
разделение труда	падзел працы
разложение общества	распад грамадзтва
разноплеменный	рознапляменны
разноязычный	рознамоўны
разорение	зруйнаваньне
разоритель	руйнавальнiк
разоружение	раззбраеньне
район	раён
раса	раса
раскол (церкви)	схiзма, раскол
расовые различия	расавыя асаблiвасьцi
распределение	разьмеркаваньне
расселение	расьсяленьне
расслоение общества	падзел грамадзтва
ратификация	ратыфiкацыя
рационализм	рацыяналiзм
реакция	рэакцыя
ревизионизм	перагляд, рэвiзiянiзм
революционный синдикализм	рэволюцыйны сындыкалiзм
революция	рэволюцыя
революция политическая	полiтычная рэволюцыя
революция пролетарская	пролетарская рэволюцыя
революция социальная	соцыяльная рэволюцыя
революция экономическая	экономічная рэволюцыя
регресс	рэгрэс
режим	рэжым
режим военный	ваеншчына
реквизиция	рэквiзыцыя
рекрут	рэкрут
религиозная община	рэлiгiйная грамада
религиозное движение	рэлiгiйны рух
религия	рэлiгiя
религия государственная	дзяржаўная рэлігія
ремесленник	рамесьнiк
ремесло	рамясло
ренегат	вырадак, адшчапенец, рэнэгат
ренессанс	адраджэньне
рента земельная	зямельная рэнта
республика	рэспубліка
республика автономная	аўтономная рэспублiка
республика античная	антычная рэспублiка
республика аристократическая	арыстократычная рэспублiка
республика буржуазная	буржуазная рэспублiка
республика демократическая	дэмократычная, народная рэспублiка
республика непосредственная	беспасярэдняя рэспублiка
республика парламентарная	парлямэнтарная рэспублiка
республика представительная	прадстаўнiчая рэспублiка
республика советская	савецкая рэспублiка
республика теократическая	тэократычная рэспублiка
республиканец	рэспублiканец
реставрация	аднаўленьне, рэстаўрацыя
реформа	рэформа
реформатор	рэформатар
реформация	рэформацыя
род	род
родина	бацькаўшчьна, айчына
родовая община авторитарная	аўторытарная радавая грамада
родовая частная собственность	радавая прыватная ўласнасьць
родовой быт	радавы быт
родовой союз	радавы саюз
родовой строй	радавы ўклад
родоначальник	пачынальнiк роду
розничная торговля	раздробны гандаль
роялист	роялiсты
рубеж	рубеж
ручная техника	ручная тэхнiка
ручное земледелие	ручное ральнiцтва
рынок	рынак
рынок внешний	загранiчны рынак
рынок внутренний	унутраны рынак
рынок потребительный	спажыўчы рынак
рыночная конкуренция	рыначная конкурэнцыя
рыцарское сословие	рыцарскi стан
рыцарство	рыцарства
рыцарь	рыцар
саботаж	саботаж
самовластие	самаўладзьдзе
самодержавие	самадзяржаўе, самаўладзтва
самодержавная монархия	самадзяржаўная, самаўладная монархiя
самодержец	самадзержац, самаўладца
самозванец	самазванец
самозванство	самазванства
самоограничение государства	самаабмежаваньне дзяржавы
самоопределение	самавызначэньне
самоопределение государства	самавызначэньне дзяржавы
самоопределение личности	самавызначэньне асобы
самоопределение народа	самавызначэньне народу
самоопределение нации	самавызначэньне нацыi
самоопределение общества	самавызначэньне грамадзтва
самосохранение	самазахаваньне
самосохранение государства	самазахаваньне дзяржавы
самосохранение личности	самазахаваньне асобы
самосохранение народа	самазахаваньне народу
самостоятельность	самастойнасьць
самостоятельный	самастойны
самоуничтожение государства	самазьнiшчэньне дзяржавы
самоуправление	самаўрад
самоуправление местное	мясцовы самаўрад
сбыт	збыт
свайная постройка	будынак на палях
сверхпродукт	звышпродукт, звышак
светская власть	сьвецкая ўлада
свобода	свабода, вольнасьць
свобода гражданская	грамадзянская свабода, грамадзянская вольнасьць
свобода личности	свабода асобы, вольнасьць асобы
свобода совести	свабода сумленьня, вольнасьць сумленьня
свободные сословия	вольныя, свабодныя станы
свободный	вольны, свабодны
связь кровная	кроўная сувязь
связь международная	мiжнародная сувязь
связь общественная	грамадзкая сувязь
связь правовая	праўная сувязь
связь фактическая	фактычная сувязь
святилище	сьвяцiлішча
священник	сьвяшчэньнiк
священный	сьвяты
сейм	сойм
секта	сэкта
сектантство	сэктанства
сектант	сэктант
секуляризация	сэкулярызацыя
секция	сэкцыя
селение	сялiба
сельско-хозяйственное производство	сельска-гаспадарчая продукцыя
сельско-хозяйственный	сельска-гаспадарчы
сельское хозяйство	сельская гаспадарка
семейная община	сямейная грамада
семейный быт	сямейны быт
семья	сям'я
сепаратизм	адасобленасьць, сэпаратызм
сепаратный	адасоблены, сэпаратыўны
сессия парламента	сэсiя парлямэнту
сессия парламента чрезвычайная	надзвычайная сэсiя парлямэнту
сила военная	ваенная сiла
сила рабочая	рабочая сiла
синдикализм	сындыкалiзм
синдикализм революционный	рэволюцыйны сындыкалiзм
синдикат	сындыкат
система однопалатная	аднапалатны ўклад
система откупная	адкупная сыстэма
скотовод	жывёлавод, скотнiк
скотоводство	жывёлаводзтва, гадоўля жывёлы
скотоводческий период	жывёлаводзкi пэрыод
скотоводческое хозяйство	жывёлаводзкая гаспадарка
служба военная	вайсковая служба
случайная (простая) форма обмена	выпадковая (простая) форма мены
сношение	зносiны
собор Вселенский	Сусьветны сабор
собрание законодательное	законадаўчы сойм
собрание представительное	прадстаўнiчы сойм, сход
собрание учредительное	устаноўчы сойм, сход
собственник	уласьнiк
собственность	уласнасьць
собственность индивидуальная	асабовая ўласнасьць
собственность коллективная	супольная, колектыўная ўласнасьць
собственность общая	агульная ўласнасьць
собственность частная	прыватная ўласнасьць
событие	падзея, праява
совет	рада
советская власть	савецкая ўлада
советская республика	савецкая рэспублiка
советское государство	савецкая дзяржава
совещание	нарада
совещательный	дарадчы
современник	сучасьнiк
современность	сучаснасьць
современный	сучасны
соглашатель	згоднiк
соглашательский	згоднiцкi
соглашательство	згоднiцтва
соглашение	згода
согражданин	суграмадзянiн
сожительство	сужыцьце
созыв	склiканьне
сообщество	згуртаваньне
соотечественник	адназемец
сословие	стан
сословие боярское	баярскi стан
сословие военное	вайсковы стан
сословие всадников	стан коньнiкаў
сословие господствующее	пануючы стан
сословие дворянское	шляхецкi стан
сословие духовное	духоўны стан
сословие жреческое	жрэцкi стан
сословие крепостное	прыгонны стан
сословие крестьянское	сялянскi стан
сословие купеческое	купецкi стан
сословие рыцарское	рыцарскi стан
сословность	станавасьць
сословные привиллегии (привилегии)	станавыя прывiлеi
сословный строй	станавы ўклад
сотрудничество	супрацоўнiцтва
социал-демократия	соцыял-дэмократыя
социализация	соцыялiзацыя
социализированный	соцыялiзованы
социализировать	соцыялiзаваць
социализм	соцыялiзм
социализм научный	навуковы соцыялiзм
социализм пролетарский	пролетарскi соцыялiзм
социализм утопический	утопiчны соцыялiзм
социализм христианский	хрысьцiянскi соцыялiзм
социалист	соцыялiсты
социалистический	соцыялiстычны
социалистический строй	соцыялiстычны ўклад, соцыялiстычны лад
социалистическое государство	соцыялiстычная дзяржава
социалистическое общество	соцыялiстычнае грамадзтва
социалистическое производство	соцыялiстычная продукцыя, вытворчасьць
социалистическое хозяйство	соцыялiстычная гаспадарка
социальная борьба	соцыяльная барацьба, соцыяльнае змаганьне
социальная группа	соцыяльная група
социальная история	соцыяльная гісторыя
социальная революция	соцыяльная рэволюцыя
социальная сила	соцыяльная сiла
социальное движение	грамадзкi, соцыяльны рух
социальное неравенство	грамадзкая, соцыяльная няроўнасьць
социальные науки	грамадзкiя, соцыяльныя навукi
социальные противоречия	соцыяльныя супярэчнасьцi
социология	грамадазнаўства, соцыолёгiя
союз	саюз
союз политический	полiтычны саюз
союз профессиональный	профэсiянальны саюз
союз родовой	радавы саюз
союзник	саюзьнiк
союзный	саюзны
спекуляция	спэкуляцыя
среда	асяродзiшча
средневековая история	гісторыя сярэднiх вякоў
средневековое государство	сярэднявяковая дзяржава
средневековье	сярэднiя вякi
средняя буржуазия	сярэдняя буржуазiя
средства производства	сродкi продукцыi, вытворчасьці
средства сообщения	сродкi зносiн
средства существования	сродкi iснаваньня
стачка	забастоўка
стачка всеобщая	агульная забастоўка
степное хозяйство	стэпная гаспадарка
стоимость меновая	менавая вартасьць
стоимость потребительская	спажывецкая вартасьць, кошт
стоимость прибавочная	дадатковая вартасьць, кошт
стоимость трудовая	працоўная вартасьць, кошт
столетие	сталецьце, век
столица	сталiца
страховая касса	каса страхавая
строй кастовый	каставы лад
строй коммунистический	комунiстычны лад
строй конституционный	констытуцыйны лад
строй общественно-политический	грамадзка-полiтычны лад
строй родовой	радавы лад
строй сословный	станавы лад
строй экономический	экономiчны лад
суверен	сувэрэн
суверенитет	сувэрэнiтэт
суверенитет государства	сувэрэнiтэт дзяржавы
суверенитет монарха	сувэрэнiтэт монарха
суверенитет народа	сувэрэнiтэт народу
суверенитет политический	сувэрэнiтэт полiтычны
суверенитет права	сувэрэнiтэт права
суверенитет экономический	сувэрэнiтэт экономiчны
суверенитет юридический	сувэрэнiтэт юрыдычны, праўны
суверенная власть	сувэрэнная ўлада
суверенное государство	сувэрэнная дзяржава
суверенность	сувэрэннасьць
судно парусное	парусная суднiна
схоластика	схолястыка
сюзеренитет	сюзэрэнiтэт
табу	табу
талисман	зачур, талiзман
таможенная пошлина	мыта
таможня	мытнiца
текстильная промышленность	ткацкая прамысловасьць
телеграф	тэлеграф
телефон	тэлефон
теократическая республика	тэократычная рэспублiка
терпимость	зносьлiвасьць
территориальная автономия	краёвая аўтономiя
территориальная армия	краёвая армiя
территория	абшары, тэрыторыя
террор	застрашэньне, тэрор
террор политический	полiтычнае застрашэньне
терроризованный	застрашаны
терроризовать	застрашаць
террорист	застрашальнiк, тэрорысты
террористический	застрашальны, тэрорыстычны
техника машинная	машынная тэхнiка
техника паровая	паравая тэхнiка
техника производственная	вытворчая тэхнiка
техника ручная	ручная тэхнiка
техника электрическая	электрычная тэхнiка
тиран	тыран
тирания	тыранiя
товар	тавар
товар всеобщий	агульны тавар
товарищество	таварыства
товарищество акционерное	акцыйнае таварыства, суполка
товарное производство	таварная продукцыя
товарное хозяйство	таварная гаспадарка
товарный обмен	таварная мена
товарообмен	таварамен
толеранция политическая	полiтычная зносьлiвасьць, толеранцыя
толеранция религиозная	рэлiгiйная зносьлiвасьць
торг	торг
торговая прибыль	гандлёвы прыбытак
торговая экспедиция	гандлёвая выправа
торговец	гандляр
торговля	гандаль, таргоўля
торговля внешняя	загранiчны гандаль, таргоўля
торговля внутренняя	унутраны гандаль, таргоўля
торговля заграничная	загранiчны гандаль, таргоўля
торговля морская	морскi гандаль, таргоўля
торговля оптовая	гуртавы гандаль, таргоўля
торговля розничная	раздробны гандаль
торговля сухопутная	сухаземны гандаль, таргоўля
торгово-промышленный капитал	гандлёва-прамысловы капiтал
торгово-промышленный класс	гандлёва-прамысловая кляса
торговое хозяйство	гандлёвая гаспадарка
торговый капитал	гандлёвы капiтал
торговый капитализм	гандлёвы капiталiзм
торговый путь	гандлёвы шлях
тотем	тотэм
тотемизм	тотэмiзм
трактат	трактат
транзит	транзiт, перавоз
транспорт	транспорт
трест	трэст
третье сословие	трэцi стан
троглодиты	пячорнiкi
трон	трон
труд	праца
труд исполнительный	выканаўчая праца
труд крепостной	прыгонная праца
труд наемный	наёмная праца
труд общественно-полезный	грамадзка-карысная лраца
труд организаторский	органiзатарская праца
труд прибавочный	дадатковая праца
труд производительный	продукцыйныя праца
трудовая стоимость	працоўная вартасьць, кошт
трудовой коллективизм	працоўная супольнасьць, колектывiзм
туземец	тубылец
туземный	тубыльчы
турнир	турнiр
узурпатор	узурпатар, захопнiк
узурпация	узурпация, захопнiцтва
указ	наказ
унитарное государство	унiтарная дзяржава
уния	вунiя
уния персональная	асабовая вунiя
упадок	заняпад
управление	управа
управление местное	мясцовая ўправа
уравнение в правах	зраўнаваньне ў правох
уравнительный	зраўнальны
условие	умова
усмирение	усьмiрэньне
усобицы	дамовыя войны
устройство государственное	дзяржаўны ўклад
устройство политическое	полiтычны ўклад
утопист	утопiсты
утопический социализм	утопiчны соцыялiзм
утопия	утопiя
утопия научная	навуковая утопiя
утопия социальная	грамадзкая утопiя
учение	тэорыя, навука
учение социальное	тэорыя грамадзянская, навука прамадзянская
учение экономическое	экономiчныя тэорыi, навукi
учредительная власть	устаноўчая ўлада
учредительное собрание	устаноўчы сойм, сход
учредительская прибыль	устаноўчы прыбытак
учреждение	установа
учреждение благотворительное	дабрачынная ўстанова
учреждения представительные	прадстаўнiчыя ўстановы
фабрика	фабрыка
фабрикант	фабрыкант
фабрикат	фабрыкат
фабрично-заводская промышленность	фабрычная прамысловасьць
фабричное законодательство	фабрычнае законадаўства
фабричное изделие	фабрычны выраб
фанатизм	фанатызм
фанатик	фанатык
фашизм	фашызм
федерализм	фэдэралiзм
федералист	фэдэралiсты
федеральная конституция	фэдэральная констытуцыя
федеральный	фэдэральны
федеративное государство	фэдэрацыйная дзяржава
федерация	фэдэрацыя
феодал	фэўдал
феодализм	фэўдалiзм
феодальное государство	фэўдальная дзяржава
феодальное общество	фэўдальнае грамадзтва
фетиш	фэтыш
фетишизм	фэтышызм
фетишизм натуральный	натуральны фэтышызм
философ	фiлёзоф
философия	фiлёзофiя
финансист	фiнансiсты
финансовый капитал	фiнансавы капiтал
финансы	фiнансы
флот	флёта
флот воздушный	паветраная флёта
флот морской	морская флёта
форма государства	форма дзяржавы
форма государственного устройства	форма дзяржаўнага ўкладу
форма обмена полная (развернутая)	поўная (разьвiнутая) форма мены
форма простая (случайная)	простая (выпадковая) форма мены
форма правления	форма праўленьня
формы промышленности докапиталистические	дакапіталiстычныя формы прамысловасьцi
фракция	фракцыя
фратриа	брацтва
хартия вольностей	хартыя вольнасьцяй
хлебные законы	хлебныя законы
хлебопашество	ральнiцтва
хлебопашец	рольнiк
хозяин	гаспадар
хозяйский	гаспадарскi
хозяйственный	гаспадарчы
хозяйство денежное	грашовая гаспадарка
хозяйство индивидуальное	паасобная гаспадарка
хозяйство интенсивное	iнтэнсыўная гаспадарка
хозяйство капиталистическое	капiталiстычная гаспадарка
хозяйство кочевое	качоўная гаспадарка
хозяйство крепостное	прыгонная гаспадарка
хозяйство крестьянское	сялянская гаспадарка
хозяйство лесное	лясная гаспадарка
хозяйство меновое	менавая гаспадарка
хозяйство натурально-меновое (смешанное)	натуральна-менавая гаспадарка
хозяйство натуральное	натуральная гаспадарка
хозяйство общинное	грамадзкая гаспадарка
хозяйство ойкосное	ойкосная, прысваяльная гаспадарка
хозяйство охотничье	паляўнiчая гаспадарка
хозяйство плантационное	плянтацыйная гаспадарка
хозяйство присвояющее	прысваяльная гаспадарка
хозяйство производящее	вытворчая гаспадарка
хозяйство рабовладельческое	рабаўласьнiцкая гаспадарка
хозяйство сельское	сельская гаспадарка
хозяйство скотоводческое	жывёлаводная гаспадарка
хозяйство социалистическое	соцыялiстычная гаспадарка
хозяйство степное	стэпная гаспадарка
хозяйство товарное	таварная гаспадарка
хозяйство торговое	гандлёвая, тарговая гаспадарка
храм	сьвятыня
христианский	хрысьцiянскi
христианский коммунизм	хрысьцiянскi комунiзм
христианский социализм	хрысьцiянскi соцыялiзм
христианство	хрысьцiянства
хроника	хронiка
хронолог	хронолёг
хронологическая таблица	хронолёгiчная таблiца
хронология	хронолёгiя
царство подземное	падземны сьвет
цезаризм	цэзарызм
цена	цана
ценз избирательный	выбарны цэнз
ценз имущественный	маёмасны цэнз
ценз образовательный	адукацыйны, асьветны цэнз
цензура	цэнзура
ценность	цэннасьць
ценность меновая	менавая цэннасьць
ценность прибавочная	дадатковая цэннасьць
центр	асяродак, цэнтр
централизация	цэнтралiзацыя
централизировать	цэнтралiзаваць
централизованный	цэнтралiзованы
центральный	цэнтральны
церковная власть	царкоўная ўлада
церковь	царква, касьцёл
цех	цэх
цивилизация	цывiлiзацыя
цивилизованный	цывiлiзаваны
цивильный	сьвецкi, цывiльны
частная собственность	прыватная ўласнасьць
частное землевладение	прыватнае зямляўладаньне
человеческий	чалавечы
человечество	чалавецтва
чиновник	ураднiк, чыноўнiк
чиновничество	ураднiцтва, чыноўнiцтва
чинш	чынш
чистилище	чысьцец
чужеземец	чужаземец
чужеземный	чужаземны
шаман	шаман
шаманизм	шаманiзм
школа	школа
шовинизм	шовiнiзм
шовинист	шовiнiсты
шоссейная дорога	шаса
штаты	штаты
эвакуация	эвакуацыя
эволюционный	эволюцыйны
эволюция	эволюцыя
эвпатриды	эўпатрыды
эдикт	эдыкт
экономика	экономіка
экономист	экономiсты
экономическая борьба	экономiчная барацьба, змаганьне
экономическая революция	экономiчная рэволюцыя
экономические учения	экономiчныя тэорыi, навукi
экономический быт	экономiчны быт
экономический строй	экономiчны ўклад, лад
экономический суверенитет	сувэрэнiтэт экономiчны
экономия	экономiя
экспатриация	экспатрыяцыя
экспедиция	выправа, экспэдыцыя
экспедиция военная	ваенная выправа, экспэдыцыя
экспедиция научная	навуковая выправа, экспэдыцыя
экспедиция торговая	тарговая экспэдыцыя, гандлёвая выправа
эксплуататор	эксплёататар
эксплуататорский	эксплёататарскi
эксплуатация	вызыск, эксплёатацыя
эксплуатируемые классы	эксплёатаваныя клясы
эксплуатирующие классы	вызыскальныя клясы, эксплёатуючыя клясы
экспорт	вываз
экспроприатор	экспропрыятар
экспроприация	высваеньне, экспропрыяцыя
экспроприированный	высваены, экспропрыяваны
экстенсивная система сельского хозяйства	экстэнсыўная сыстэма сельскае гаспадаркi
экстерриториальность	пазамежнасьць, экстэрыторыяльнасьць
экстерриториальный	пазамежны, экстэрыторыяльны
электорат	электорат
электрическая техника	электрычная тэхнiка
эмансипация	вызваленьне, эманцыпацыя
эмигрант	эмiгрант
эмиграция	эмiграцыя
эмиссионный банк	эмiсыйны банк
эмиссия денег	выпуск грошай
энциклопедист	энцыклёпэдысты
эпоха	эпоха
эра	эра
эстетика	эстэтыка
этика	этыка
этнограф	этнограф
этнография	этнографiя
этнолог	этнолёг
этнология	этнолёгiя
язык государственный	дзяржаўная мова
языческий	паганскi
язычество	паганства
язычник	паганец
ярмарка	кiрмаш
