##Title: Слоўнік глебазнаўчае тэрмінолёгіі (праект) (БНТ)
##HTMLDescription_BEGIN
<div>
	<p class="dictdesc-st">Створана на падставе:</p>
	<p><b>Слоўнік глебазнаўчае тэрмінолёгіі (праект)</b>. Менск: Інбелкульт, 1927.</p>
</div>
<div>
	<p class="spoiler">Ад Галоўнае Тэрмінолёгічнае Камісіі</p>
	<p>Слоўнік глебазнаўчае тэрмінолёгіі выходзіць у сьвет, як і папярэднія тэрмінолёгічныя слоўнікі, з значэньнем <i>проекту</i> які ў далейшым можа зьмяняцца, калі запатрабуе таго навуковы досьлед і пэдагогічная практыка.</p>
	<p>Глебазнаўчая тэрмінолёгія прагледжана і выпраўлена Г. Т. Камісіяю і ўхвалена да друку ў трох мовах − расійскай, беларускай і нямецкай.</p>
	<p>Выпускаючы ў сьвет кожную тэрмінолёгію, Г.-Тэрмінолёгічная Камісія і далей зьбірае тэрмінолёгічны матар‘ял − народны і літаратурны, каб у наступных выданьнях пашыраць і выпраўляць тое, што на падставе новага матар’ялу будзе вымагаць належных выправак і дадаткаў.</p>
	<p>Даць дакладную тэрмінолёгію, якая-б адпавядала ў поўнай меры навуковасьці і здавальняла-б пэдагогічную практыку − справа нялёгкая, і Камісія лічыць, што ўдасканаліць сваю работу яна зможа толькі ў тым выпадку, калі на помач ёй прыдзе актыўная праца ўсіх зацікаўленых асоб і ўстаноў. Вось чаму Камісія зварачаецца да іх з просьбаю дапамагчы ёй у цяжкай справе распрацаваньня беларускае навуковае тэрмінолёгіі.</p>
	<p>Сабраны тэрмінолёгічны матар‘ял Камісія просіць надсылаць у Інбелкульт (Менск, Рэволюцыйная, 21) на імя Галоўнае Тэрмінолёгічнае Камісіі. Корэспондэнцыя на імя Інбелкульту паштовай аплаце не падлягае.</p>
	<p> </p>
	<p>Галоўная Тэрмінолёгічная Камісія.</p>
	<p>Менск, 10 мая 1927 г.</p>
</div>
<div>
	<p class="spoiler">Прадмова</p>
	<p>Укладаньне беларускае глебазнаўчае тэрмінолёгіі пачата мною з 1924 году і працягнулася, гэткім чынам, тры гады. Гэткі доўгі тэрмін тлумачыцца як цяжкасьцю самое працы, так і тым, што пры ўкладаньні тэрмінолёгіі, у яе беларускай частцы, тэрміны набываліся ў розных мясцох Беларусі, што я мог рабіць на працягу досыць абмежаванага часу − улетку 1924, 25 і 26 гадоў.</p>
	<p>Усю працу па складаньні тэрмінолёгіі можна падзяліць на некалькі частак. Перш за ўсё былі выпісаны расійскія тэрміны з лепшых курсаў глебазнаўства апошніх выданьняў і з надрукаваных глебазнаўчых прац пра Беларусі; тэрміны выпісваліся як спэцыяльныя, гэтак і іншыя, якія наогул ужываюцца ў гэтай галіне. Апрача гэтых тэрмінаў, у расійскую частку тэрмінолёгіі былі ўведзены яшчэ „падвойныя” тэрміны (два словы на адно паняцьце), якія зьявіліся дзякуючы таму, што ў замежнай, асабліва нямецкай, літаратуры ўжываецца цэлы рад слоў, якія парасійску немагчыма перавесьці адным словам, і якія, бязумоўна, павінны знаходзіцца ў глебазнаўчым слоўніку. Некаторыя з гэткіх слоў знайшлі сабе выраз у адным беларускім слове, некаторыя ў двох, але большую частку іх я пакінуў, як міжнародныя, але у беларускай транскрыпцыі.</p>
	<p>Гэткім чынам знайшлося больш за тысячу тэрмінаў. Яны былі ўзгоднены з надрукаванай ужо Інбелкультам тэрмінолёгіяй − агульнай геолёгічнай і географічнай. У выніку гэтай працы частка тэрмінаў была выкінута, як ужо надрукаваных, частка-ж была пакінута, бо бяз іх глебазнаўчы слоўнік ня быў-бы поўным. Далей можна было пачаць укладаньне беларускай часткі тэрмінолёгіі. </p>
	<p>Перш за ўсё былі адзначаны тэрміны, якія можна было знайсьці ў народнай мове, паняцьці якіх былі-б знаёмы беларускаму сялянству. Сьпіс гэтых тэрмінаў, трэба сказаць невялікі, запаўняўся на мясцох як у часы глебазнаўчых досьледаў на Беларусі, якія я праводзіў у памянёныя вышэй гады, гэтак-жа і ў часы прыватных паездак па Беларусі. Гэтак былі набыты тэрміны з некаторых частак Магілеўшчыны, Калініншчыны, Меншчыны, Случчыны, Віцебшчыны.</p>
	<p>Далейшая праца была ў адшуканьні найлепшага беларускага выразу для тых слоў, якіх ня было ў жывой народнай мове. Большасьць з гэтых слоў я пакінуў у міжнароднай форме, але ў беларускай транскрыпцыі, тым больш, што і ў расійскай мове яны ўжываюцца як чужаземныя.</p>
	<p>Далей былі ўкладзены украінская і нямецкая часткі тэрмінолёгіі. Тут я карыстаўся як слоўнікамі, гэтак-жа і навейшай украінскай і нямецкай глебазнаўчай літаратурай.</p>
	<p>У заключэньне лічу патрэбным адзначыць, што нямецкую частку тэрмінолёгіі мне ласкава прарэдагаваў магістар агрономіі Г. В. Краўзэ, за што складаю яму сваю шчырую падзяку.</p>
	<p> </p>
	<p>Сьпіс</p>
	<p>літаратуры, выкарыстанае пры складаньні Беларускае Глебазнаўчае Тэрмінолёгіі.</p>
	<p>1.	Глинка К. Д. Почвоведение.</p>
	<p>2.	Вильямс В. Р. Почвоведение.</p>
	<p>3.	Афанасьев Я. Н. Этюды о покровных породах Белоруссии.</p>
	<p>4.	Афанасьев Я. Н. Очерки почв Белоруссии.</p>
	<p>5.	Гедройц К. К. Учение о поглотительной способности почвы.</p>
	<p>6.	Гедройц К. К. − статьи о ненасыщенности почв и ультрамеханическом составе.</p>
	<p>7.	Гедройц К. К. Химический анализ почв.</p>
	<p>8.	Дюкло. Коллонды.</p>
	<p>9.	Часопіс „Почвоведение” за апошнія гады.</p>
	<p>10.	 Беларуская Навуковая Тэрмінолёгія:</p>
	<p>выпуск трэці − географічныя і г. д. гэрміны</p>
	<p>выпуск пяты − геолёгія, мінэралёгія і г. д.</p>
	<p>выпуск восьмы − лясныя тэрміны. </p>
	<p>11.	 Расійска-беларускі слоўнік (Байк. і Гарэцк.).</p>
	<p>12.	 В. Ластоўскі. Расейска-крыўскі слоўнік.</p>
	<p>13.	 П. Tутковський, акад. словник геологічноï терминологіï.</p>
	<p>14.	 Г. Махов. Грунтознавство.</p>
	<p>15.	 Русско-украинские словари (апошніх выпускаў).</p>
	<p>16.	 Павловский. Немецко-русский и русско-немецкий словари.</p>
	<p>17.	 „Internationale Mitteilungen für Bodenkunde” за апошнія гады.</p>
	<p>18.	 Actes de la IV conférence internationale de pédologie. Rome, 1924. (Ha нямецкай i іншых мовах).</p>
	<p>19.	Verhandlungen der II bodenkündlichen. Kommission. 1926, Teil A und В.</p>
	<p> </p>
	<p><i>Кучынскі П.</i></p>
	<p>Асьпірант пры Глебазнаўчай катэдры Белорускай Дзяржаўнай Сельска-Гаспадарчай Акадэміі у Горках.</p>
	<p> </p>
	<p>Горкі. С.-Г. Акадэмія 22 студзеня 1927 г.</p>
</div>
##HTMLDescription_END
##ArticleLang: ru/be/de

абсолютный вес почвы	абсолютная вага глебы	das absolute Gewicht des Bodens 
абсорбция	абсорбцыя, убіраньне агульнае	die Absorbtion 
автоматические весы (Odeu'a)	аўтоматычная вага, самаўзважнік	die automatisch registrierende Balance 
аггрегат	агрэгат, скупнасьць	der Aggregatzustand, ursprüngliche Zustand 
адсорбция	адсорбцыя, убіраньне паверхнае	die Adsorbtion 
азональный	азональны	azonal, nicht in Zonen eingefügt 
азот атмосферных осадков	ападкавы азот 	der Stickstoff der Niederschläge 
азот гуминовой кислоты	азот гумінавай кіслаты	der Stickstoff der Humussäure 
азот гумуса	азот перагнойны	der Humusstickstoff 
аккумуляция	акумуляцыя, награмаджэньне (T. 6)	die Accumulation 
аккумуляционные горизонты	паземы награмаджэньня	die Sammelnschichte  
аллювий 	алюві, наплавы, намыў (T. 6)	das Alluvium, der Alluvialboden 
аллювиальные отложения	наплыўныя, намыўныя адклады	die Alluvialablagerungen 
алюмосиликат 	алюмасылікат 	das Aluminiumsilikat, Alumosilikat 
алюмосиликатный комплекс	алюмасылікатны комплекс	der Alumosilikatkomplex
аммонизация	амонізацыя	die Ammonisation 
анаморфизм  	анаморфізм, скажанаформнасьць	die Umbildung   
анаэробный	беспаве´травы	anaërisch 
ангидрид хромовый	ангідрыд хромавы	das Chromanhydrid, Chromsäure (die) 
анион	аніён	das Anion 
аморфный	бясформны	amorph, formlos 
апокреновая кислота	апокрэнавая кіслата	die Apokrensäure  
аппарат Робинзона (механический aппарат)	піпэтнік, Робінзонаў апарат	der Pipettapparat  
аспиратор 	паветравыцяжнік, асьпіратар	der Aspirator  
аэробный	паветравы	aërisch 
бак Шенэ 	бак, чоп Шэнэ 	der Schön'sche (Back) Reservoir 
белозем 	сyxi пазем 	die wasserlose Schicht 
белоглазка 	белавочка 	der weisse Tupf, Flecken 
безводный горизонт	белазем, белаглебіца	der Weissboden, weisse Boden 
беспорядочное падение	беспара´дачны апад	das unregelmässige Herabfallen 
бледнозем	бледназем	die Bleicherde 
блюдце 	круглая западзіна 	die schüsselartige Vertiefung 
бокал Сикорского 	кубак Сікорскага 	der Becher von Sikorski 
болото травяное 	балота, багна, дрыгва, арша	das Moor, der Sumpf  
болото моховое 	імшара, амшарына 	das Moosmoor, Hochmoor 
бонитировка 	ацэнка 	die Abschätzung (des Bodens) 
бугор моренный	груд морэнавы(у слоўніку магчыма памылка друку - марэнавы)	der Moränenhügel 
бур	земляны сьвідар	der Erdbohrer 
бурозем	буразем	die Braunerde 
буферная смесь	буфарнік	die Puffermischung 
буферное значение 	буфарны азначнік	der Pufferwert  
буферное состояние	буфарнасьць 	der Pufferzustand  
бобовины (железной руды)	бабовіны, рудзяк 	das Bohnenerz, Bohnerz 
валовой анализ	агульны аналіз	die Bauschanalyse 
валун 	камень-валун 	der Feldstein, Klaubstein 
вгибать	угінаць	einbiegen 
вертикальная отдельность	прадоўжная адменнасьць	die vertikale Schichtsonderung 
вечная мерзлота 	вечная мерзлата 	der ewige Frostzustand 
взбалтывать	збоўтваць	umschütteln, umrühren 
взволнованная поверхность	узрушаная паверхня	die aufgerührte (bewegte) Oberfläche 
взвешенный материал	мут, узважаны матар’ял	das Aufgeschlämmte, die Trübe 
взгорье 	узгор’е 	der Anhügel, die Anhöhe 
взмучивание	ускаламучваньне	das Aufschlämmen 
взаимодействие 	узаемадзейнасьць 	der gegenteilige Einfluss 
вивианит	вівіяніт	das Vivianit 
вискозиметр	грузкамер	der Viskosimeter 
включения 	уключэньні, улучэньні	der Einschluss  
влага гигроскопическая	паветраная вільгаць	das hygroskopische Wasser 
влагоемкость	вадаёмнасьць	die Wasserkapacität 
вмывание	нутраўмываньне	das Hineinwaschen 
внедряющийся в глубину	уедлівы 	in die Tiefe gehend, areïdimensional 
вода почвенная	верхаводка	das Bodenwasser 
вода грунтовая 	вада грунтавая, падземная	das Grundwasser  
водоподъемность 	вадапад’ёмнасьць 	die Wasseraufhebungsfähigkeit 
водопроводимость 	вадаправоднасьць	die Wasserleitungsfähigkeit 
водопроницаемость	вадапрапушчальнасьць	die Wasserdurchlässigkeit 
водоупорный слой 	вадастойкі пласт 	die wasserundurchlässige Schicht 
водяная баня	вадзяная грэлка (хэмічны тэрмін)	das Wasserbad  
воздухопроницаемость	паветрапрапушчальнасьць	die Luftdurchlässigkeit 
воздушная баня	паветравая грэлка	das Luftbad 
воздушно-сухой	паветрана-сухі	lufttrocken 
возрастание скорости падения 	узрастаньне скорасьці па´даньня 	das Anwachsen der Fallgeschwindigkeit 
впадение	упад, уток	die Einsenkung 
впадина  	западзіна, падзіна, западзь, ямка	die Einsenkung   
впитывать	убіраць, уцягаць	einsaugen, einziehen 
впуклый	упуклы, угіблы	eingebogen, eingedrückt 
время отстаиванья	час адстойваньня 	die Periode des Abklärens 
воронка делительная	падзельная лейка 	der Teiltrichter  
воронкообразный	лейкаваты 	trichterförmig  
воспринимать	успрымаць	auffassen, aufnehmen 
волосность	валоснасьць	die Kapillarität 
всасывать	усосваць	einsaugen 
вскипать (от соляной кислоты)	ускіпаць 	aufbrausen, aufschäumen 
всколебать 	ускалануць, ззыбнуць	aufrühren, in Bewegung bringen 
вспучиваться 	успучвацца 	sich aufblähen, auftreiben 
втекать	улівацца	hineinfliessen 
выветривание	выве´трываньне	die Verwitterung 
выветривание биологическое	выве´трываньне біолёгічнае	die biologische Verwitterung  
выветравание механическое	выве´трываньне мэханічнае	die mechanische Verwitterung  
выветривание органическое	выве´трываньне органічнае	die organische Verwitterung 
выветривание химическое	выве´трываньне хэмічнае	die chemische Verwitterung 
выдувание 	выдзіманьне, вывяваньне	das Ausblasen, Auswehen 
выемка (образца) 	вынімка 	die Ausgrabung, das Ausnehmen
выкачать	вы´пампаваць	auspumpen 
вымерзание	вымярзаньне	das Ausfrieren, Durchfrieren
выпаривать 	выпа´рваць 	verdampfen, verdünsten, auskochen 
выпуклый	пука´ты	ausgebogen, erhaben 
высокоствольный лес	гонкі лес 	der Hochwald  
высота абсолютная	вышыня абсолютная	die absolute Höhe  
высота водораздельная	узвышша вадападзельнае	die Wasserscheide  
высота относительная	вышыня адносная 	die relative Höhe  
высушивать	высушваць	austrocknen 
вытекание 	выцяканьне 	das Ausfliessen, der Ausfluss 
вытеснять (хим.)	выціскаць	verdrängen 
вытяжка	вы´цяжка	der Auszug 
вытяжка водная	вы´цяжка во´дная	der Wasserauszug 
вытяжка лимоннокислая	вы´цяжка цытрынна-кіслая	der Zitronensäureauszug 
вытяжка солянокислая	вы´цяжка салянакіслая	der Salzsäureauszug  
вытяжка фтористоводородная	вы´цяжка флюёравадародная 	der Fluorwasserstoffauszug  
выхлопковывание	вызгусткоўваньне	die Ausflockung 
выщелачивание	лугаваньне	die Auslaugung 
выцветы солей 	выцьветы соляў 	die Ausblühungen v. Salzen 
вязкость 	грузкасьць 	die Klebrigkeit, Zähigkeit 
вскипятить	згатаваць	aufkochen 
галечник	галачнік; галька	das Gerölle 
гель 	гель; згустак студнявы	die Gele  
герметически	гэрмэтычна	hermetisch, luftdicht 
гидрогель 	гідрагель; згустак водны	die Hydrogele  
гидрозоль 	гідразоль, расьцечнік водны	die Hydrosol  
гидрат 	гідрат, воднік 	das Hydrat, Wasserstoffverbindung 
гигроскопичность  	гіграскопічнасьць, вадаўбіральнасьць	die Hygroskopicität   
гидрография 	гідраграфія 	die Hydrographie, Gewässerkunde 
гипс	гіпс	der Gyps, Gips 
главконит	гляўконіт	der Glaukonit 
глеевой горизонт	глеявы пазем	der Gleyhorizont 
глей	глей	der Gley 
глееватый	глеяваты	gleyartig 
глина	гліна	der Lehm 
глина жирная 	гліна тлустая 	der fette Lehm, der bindige Lehm
глина лессовидная	гліна лёэсаватая	der lössartige Lehm 
глина лессовая	гліна лёэсавая	der Lösslehm 
глина осадочная  	гліна пластовая  	der Flottlehm, Fliesslehm, abgelagerte Lehm 
глина ленточная 	гліна стужкаватая, стужкавая	der bandartige Lehm  
глинистый	гліністы	lehmig, tönig 
глинозем	гліназем	die Tonerde 
гниение 	гніцьцё 	das Faulen, die Fäulniss 
голубой глей 	блакітны глей 	der blaue, hellblaue Gley 
горелка	пальнік	der Brenner
горизонт (почвенный)	пазем, слой 	der Horizont, die Schicht 
гравитационная вода	гравітацыйная вада	das Gravitationswasser 
гравий 	жвір, чвыр, баляс(т)	der Gruhs, der Kies, der Kiessand 
граница фаз 	мяжа адмены, стану	die Phasengrenze  
грива	грыва	der Kamm 
горизонтальное падение пластов	падольны спад пластоў, слаёў	die horizontale Neigung, Senkung d. S. 
гуматный 	гуматны, перагнойнакіслы	humat  
гуматы  	гуматы, солі перагнойных кіслот	das Humat   
гуминовая кислота	гумінавая кіслата	die Huminsäure 
гумин	гумін	das Humin 
гумозный	гумозны	humose 
гумусовая кислота 	гумусавая кіслата, перагнойная кіслата	die Humussäure   
гумусообразный  	гумусападабны, перагноенападобны	humusartig   
гумус	гумус, перагной	der Humus 
деградация 	дэградацыя; ападзольваньне	die Degradation, die Rückbildung 
декантация	дэкантацыя	das Dekantieren 
делювий	дэлюві	das Deluvium 
денитрификация 	дэнітрыфікацыя	die Denitrifikation  
десульфуризация  	дэсульфурызацыя, высеркаваньне	die Desulfurisation   
дернина	дзёран, дзярніна	die Rasenfläche 
диаспора (рассып. област.)	дыяспора 	die Diaspora  
дилювий	дылюві	das Diluvium 
дисперсная фаза	крышны стан	die Dispersionsphase 
дисперсность  	крышнасьць, дробнападзельнасьць	die Dispersität, Feinverteilung  
диссоциация	дысоцыяцыя	die Dissociation 
диффузия 	дыфузія, прасякненьне	die Diffusion  
длительность отмучивания	працягласьць адкаламучваньня	die Abschlämmdauer  
дождевой червь 	чарвяк-дажджавік	der Regenwurm  
дождевого червя отбросы	адкідкі дажджавога чарвяка	die Regenwurmkrümel 
дождевого червя ходы	ходы дажджавога чарвяка	die Regenwurmgänge, die Regenwurmröhren 
дренаж 	дрэнаж 	die Drainage, Trockenlegung 
дробить 	крышыць, драбіць	zerstückeln, körnen  
дутик	бульчок, дудзік	die Hohlknolle 
едкий	едкі	ätzend, scharf 
емкость поглощения	емасьць паглынаньня	die Absorptionsgrösse, der Absorptionsumfang 
естественная классификация 	натуральная, прыродная клясыфікацыя	die naturgemässe Klassifikation
железняк бурый 	жалязьняк буры, рудзяк	das Brauneisen [der Braunstein] 
железо закислое  	жалеза закіслае, падтленьнік жалеза	das Eisenoxydul   
железо окислое 	жалеза вокіснае, тленьнік жаілеза	das Eisenoxyd  
железобактерии	жалезабактэрыі	die Eisenbakterien 
желоб стока	рына рыштоку	die Abflussrinne 
желтозем 	жоўтазем, жоўтая глеба	die Gelberde  
жеод 	крыштальнік 	die krystallinische Kalkknolle 
жерства 	жарства 	der Trümmersand  [schwache] 
жидкий (раствор) 	рэдкі (рошчын) 	die Leichtlösung, leichte Lösung 
журавник 	жураўчык 	der Kalkstein, Kalkknollen 
заболачивание	забалочваньне	die Versumpfung 
заболоченный	забалочаны	versumpft 
завертывать (кран)	закручваць (крант)	einschrauben  
заводь	завой, завоіна	die Bucht 
зажим 	заціск 	der Zusammenpresser, Quetscher 
зажимать 	заціскаць 	quetschen, festquetschen, zudrücken 
заиление 	заглейваньне, абглейваньне	das Verschlammen, die Verschlammenung 
заключать	заключаць	umschliessen, einschliessen 
закарстовать 	закарставаць, абзападзініць	verkarsten  
закарстовывание 	закарстоўваньне, абзападжваньне	die Verkarstung  
залегание (породы)	паклад (пароды)	die Lagerung, Schicht 
замедление 	замаруджаньне 	die Verzögerung, der Verzug 
замещение (хим.)	замяшчэньне	das Ersetzen, Vertreten 
западина 	западзіна, за´падзь 	die Senkung, Einsenkung 
запаять	залітаваць	verlöten, zulöten 
заполнение	запаўненьне	die Füllung 
защитная кора 	ахоўная кара 	die Schutzkruste, Schutzkrusterinde 
засасывать	зацягваць	ansaugen, einsaugen 
засорение 	засьмечаньне 	die Verunreinigung, Verstopfung 
зернистый 	крупкаваты, зярністы	körnig, gekörnt  
зерно (физ.)	крупінка	das Korn 
золь	золь	das Sol, Solum 
зона лесо-степная(лесостепная) 	зона [пояс] лесастэпавая	die Waldsteppenzone  
зона подзолистая	зона падзолістая	die Podsolzone 
зона латеритная 	зона лятэрытавая, лятэрытная	die Lateritzone  
зона пустынностепная	зона пустыннастэпавая	die Steppenwüstenzone 
зона степная	зона стэпавая	die Steppenzone 
зона лесная 	зона лясная 	die Waldzone, Wälderzone 
зона черноземная 	зона чарназемная	die Tschernosjomzone 
зона тундровая	зона тундравая	die Tundrenzone 
зональный комплекс	зонавы комплекс 	der Zonalkomplex  
зонд 	зонд, тарфяны сьвідар	die Sonde  
зоны вертикальные	зоны простастаўныя	die vertikalen, senkrechten Zonen 
известковая кора	вапенная кара	die Kalkkruste 
известняк	вапняк	der Kalkstein 
известь 	вапна 	der Kalk, die Kalkerde 
извлечение (из раствора) 	выцягваньне, выцяг (з рошчыну)	das Ausziehen, der Auszug  
измельчение 	здрабненьне 	die Verbröckelung, Verkrümmelung 
изоморфные смеси	ізаморфныя (аднаформныя) сумесі	die isomorphen Mischungen 
изотерма 	ізатэрма, лінія роўнацёплая	die Isotherme  
ил	іл, мул	der Schlamm 
иллювиальный горизонт	ілювіяльны (умыўны) пазем	der Illuvialhorizont  
иллювий	ілюві, умыў	das Illuvium 
индикатор 	індыкатар, ціскамер	der Indikator, Spannungsmesser 
ион	іён	das Ion 
испарение (хим.)  	парава´ньне, выпар 	die Abdampfung, die Ausdampfung, Abdunstung, Verdunstung 
испаритель (Дояренко)	выпарнік (Даярэнкі)	der Verdampfer von Dojarenko 
исследование стационарное  	мясцовае дасьледваньне, мясцовыя досьледы	die stationsmässige Untersuchung, Erforschung  
исток	вытак, выплынь	der Ausfluss 
калиаппарат	каліапарат, калісушыльня	der Kaliapparat 
калий	калі	das Kalium 
калориметр 	калёрымэтр, цепламер	der Kalorimeter, Wärmermesser 
кальций	вапень	das Calcium 
каменистый	камяністы	steinig 
камень	камень	der Stein 
каолин 	каоліна, парцалянавая гліна	der Kaolin, die Рогzellanerde 
капельно-жидкий	кропельнавадкі	tropfbarflüssig 
капиляр 	капіляр 	das Kapillar, die Kapillarröhre 
капилярная влага  	валосная, капілярная вада, вільгаць	das Kapillarwasser   
капилярный подъем	капілярны пад’ём 	das Kapillaraufsteigen  
карбонат	карбонат, вугляк	das Karbonat 
карстовый ландшафт	карставы, западзінны краявід	die Karstgegend, das Karstgelände 
картографія	картаграфія	die Kartographie 
катион	катыён	das Kation 
каучуковая трубка 	гумавая трубка 	das Kautschuckrohr, Gummirohr 
кислородный метод	утляняльны (тленавы) мэтод	die Sauerstoffmethode  
кислотность почвы	кіслотнасьць глебы	der Bodensäurezustand 
кинетический	кінэтычны	kinetisch 
кипячение 	кіпячэньне, гатаваньне	das Kochen, Sieden  
кипущий	кіпячы	kochend, siedend 
клейкость	клейкасьць	die Klebrigkeit 
климат влажный 	клімат вільготны 	das humide, feuchte Klima 
климат полувлажный	клімат напаўвільготны	das Semihumide Klima 
климат полусухой 	клімат напаўсухі 	das Semiaride Klima 
климат сухой 	клімат cyxi 	das aride, trockene Klima 
климат морской 	клімат морскі 	das Seekiima, oceanische Klima 
климат переходный	клімат пераходны	das Übergangsklima  
климат континентальный 	клімат контынэнтальны 	das kontinentale Klima, Festlandsklima 
клочковатый	клаччаваты (Нс.)	klumpig  
коагуляция  	зьліпаньне, згусткаваньне, коагуляцыя	die Koagulation, das Gerinnen  
колба	коўба	die Kolbe 
колбочка	коўбачка	das Kölbchen 
колебание температуры	ваганьне тэмпэратуры	die Temperaturschwankung 
коллоид	колёід	das Kolloid 
колориметр 	фарбамер, колерамэтр	der Kolorimeter, Farbmesser 
кольцо (на штативе)	колца, абручык 	der Ring  
комковатый 	камякаваты, грудкаваты	klumpig, klumpenförmig, ballenförmig 
компаратор  	компаратар, фарбапараўнальнік	der Komparator   
комплекс	комплекс	der Komplex 
конденсация 	кондэнсацыя, згушчэньне	die Kondensation,Verdichtung 
конкреция 	конкрэцыя, сьцяжэньне	die Ausscheidung, Konkretion 
конгломерат 	конглёмэрат, зьліпняк	das Konglomerat, die Anhäufung 
контакт 	контакт, сутык 	der Kontakt, Berührungspunkt 
контактный горизонт 	контактовы пазем, супаземнік	der Berührungshorizont  
конус выноса 	конус (стажок) намыву	die keilförmige Abschlämmung 
концентрация 	концэнтрацыя, гушчыня	die Konzentration  
концентрация водородных ионов 	концэнтрацыя  (гушчыня) іёнаў вадароду	die Wasserstoffionenkonzentration  
коренное месторождение 	асноўнае, первястковае родавішча	das Ursprungsgebiet, Urlager  
клапан	затамка	die Klappe, das Ventil 
красновато-бурый 	чырванавата-буры	rotbraun  
краснозем 	чырвоназем 	die Roterde, "Terra Rossa" 
кремний	сыліцы, крэмні	das Silicium 
кремнекислота 	сыліцыевая кіслата	die Kieselsäure  
креновая кислота 	крэнавая кіслата, крынічная кіслата	die Krensäure  
кренаты	крэнаты	die Krenate 
кристаллический осадок	крышталёвы ападак	der krystallische Niederschlag 
крупность	буйнасьць	die Grösse, Stärke 
крупнозем	буйназем	die Groberde 
купорить 	каркаваць, закаркоўваць	verstopfen, verspünden, verkorken 
крутой склон 	стромкі схіл, спад	der Steilabhang, steile Abhang 
кротовина 	кратаві´на, крато´віна	der Maulwurfsgang, die Krotowine 
куполообразный (холм)	стагаваты (узгорак)	der kuppelartige Hügel 
капельница	кропельніца	das Tropfgefäss 
кучевидные отложения	кучавідныя адклады	die haufenförmige Ablagerungen 
кремнезем	крэмнязем	die Kieselerde 
лаборатория	лябораторыя	das Laboratorium 
латерит	лятэрыт	der Laterit 
ледник	ледавік	der Gletscher 
ледниковое отложение	ледавіковы адклад	die Gletscherablagerung, Eisablagerung 
лесная подстилка	лясны падсьціл	die Waldstreu 
лесное насаждение 	лесазасеў (Н. T. 3), пасадка лесу (H. Т. 8)	der Waldbestand   
лёсс 	лёэс [Н. Т. 3 і 5], жоўтая гліна	der Löss  
лёсс желтый	лёэс жоўты	der gelbe Löss 
лёсс ореховый 	лёэс арэхавы, арэхаваколерны	der nussbraune Löss  
лёсс палевый 	лёэс па´левы; палавы	der hellgelbe, paille Löss 
лессовая порода	лёэсавая парода	das lössartige Gestein 
лжегрибница	нібыгрыбня	der Scheinpilz 
локализация солей 	лёкалізацыя, згушчэньне соляў	die Lokalisierung, Ortsbeschränkung d. S. 
лом	лом	die Brechstange 
лопата 	рыдлёўка 	die Schaufel, der Spaten 
лопатка (мех. ан.)	мешалка	der Spatel 
лощина 	лагчына 	die Vertiefung, Einsenkung 
луг	луг	die Wiese 
луг альпийский 	луг альпійскі 	die Alm, die Alpenwiese 
луг заливной	поплаў	die Rieselwiese 
луг болотный	луг балотны	die Sumpfwiese 
луг сухой  	сухадол, луг мурожны, сухадольны	die trockene Wiese   
марганцевая конкреция	манганавая конкрэцыя	die Manganausscheidung 
массив	масыў	das Massiv 
массивная порода	масыўная парода	das Gesteinsmassiv 
масштаб съемки	маштаб здымкі 	der Massstab der Aufnahme 
материал взвешенный	каламута 	die Trübigkeit, Geschlämme 
материал растворенный	распушчаны матар’ял	das aufgelöste, gelöste Material 
материнская порода	мацярынская парода	das Muttergestein  
медитеранский  	мэдытэранскі,  міжземляморскі	Mediterran-, gehörig zu Mittelmeer  
межледниковае отложение	міжледавіковы адклад	die Zwischenablagerung im Gletscher 
макрорельеф 	макрорэльеф 	das Makrorelief, Makrogelände 
мел	крэйда, мел	die Kreide 
мелкозем	дробназем	die Feinerde 
мелкозернистый  	дробнакрупкаваты, дробназярністы	feinkörnig   
мензурка 	мэнзурка 	die Mensur, der Flüssigkeitsmesser 
мергель пресноводный	маргель азерны 	der Seemergel  
мерный стакан [мех. ан.] 	вымерная падзельная шклянка	das Messglass   
местность волнистая	мясцовасьць хваляватая	das wellenförmige Gelände 
местность равнинная	мясцовасьць раўнінная	das ebene Gelände  
метазоматический 	мэтазоматычны 	metasomatisch, selbstverdrängend 
метка сливания 	рыска, метка зьліваньня	der Abstrich, die Grenze des Abgusses 
механический состав	мэханічны склад 	die mechanische Zusammensetzung 
микрорельеф 	мікрорэльеф 	das Mikrorelief, Mikrogelände 
микроскоп двойной	бінокуляр, мікроскоп падвойны	das Binokular, Doppelmikroskop 
минерал	мінэрал	das Mineral 
модер [вид гумуса]	модэр 	der Moder  
молекула 	моле´кула, частачка	das Molekül, die Molekel 
монолит 	моноліт, цэльнасьць	der Monolith  
монтировка 	монтаваньне, наладжваньне	das Montieren, die Montur 
морена 	морэна, чырвоная гліна	die Moräne  
морена валунная 	морэна камяністая	die Steinmoräne, Geröllmoräne 
морена конечная	морэна канцавая	die Endmoräne 
морена кремневая 	морэна крамнёвая	die Kieselmoräne  
морена местная 	морэна мясцовая, мясцоўка	die örtliche Moräne, Ortsmoräne 
морена поддонная	морэна падысподняя [Н. Т. 3]	die Grundmoräne  
моренный ландшафт	морэнавы краявід 	die Moränengelände  
морфология почв 	морфалёгія глебы 	die Morphologie des Bodens 
мох	мох	das Moos 
мулл [вид гумуса]	муль	der Mull 
мутный	мутны, каламутны	trübe 
муфель	муфаль, насадка	die Muffel 
мощность горизонтов	таўшчыня, грубіня паземаў	die Mächtigkeit des Horizontes
навеска	наважка, узважка	die Gewichtsprobe 
нагромождение  	накучваньне, награмаджэньне, навал	die Anhäufung   
нагревать до кипения	награваць да кіпеньня	wärmen, erwärmen, erhitzen bis zum Kochen 
наклон 	нахіл 	die Neigung, -slehne, die Lehne 
накопление [в хим. см.]	сьцягваньне, набіраньне	die Häufung, Aufhäufung, Ansammlung 
наконечник 	наканечнік, канча´р	das Endstück  
намоина 	на´плынь 	die Anwaschung, Anschwemmung 
напластование	напластава´ньне	das Schichten, Lagern 
наплыв	наплыў	das Anschwemmen 
направление пластов	кірунак слаёў, пластоў	die Richtung der Schichten 
наружный вид [общий] 	знадворнасьць, знадворны выгляд	die Form   
нарушение в напластовании	зьмена пароды 	die Störung in der Schichtrichtung 
напряжение	напружэньне	die Anspannung, Spannung 
наслоение 	наслойваньне, наслаеньне	die Schichtung  
насыщенность почвы	насычанасьць глебы	die Sättigung des Bodens 
нашатырь, хлораммоний	хлёрыд амонію  [нашатыр]	der Salmiak, das Chlorammonium 
невесомый	невагомы	unwägbar 
нейтрализовать	нэўтралізаваць	neutralisieren 
некапилярный 	неваласаваты, некапілярны	unkapillar  
недовешивать 	недаважваць 	knapp wägen, nicht voll auswägen 
ненарушенный	непаварушаны	ungestört 
неорганический	неарганічны	anorganisch 
непрозрачный	непразрысты	undurchsichtig 
непроницаемость 	непранікальнасьць	die Undurchlässigkeit, Undurchdringlichkeit 
несоразмерность 	несуразьмернасьць	die Unverhältnissmässigkeit 
нестойкий 	нятрывалы, хісткі 	unbeständig, wechselnd 
нерастворимый	нераспушчальны	unlöslich 
низкоствольный лес	нізкаствольны лес	der kurzstämmige Wald 
нижний пласт  	сподні, падысподні пласт, слой	die Unterschicht   
нитрификация	нітрыфікацыя	die Nitrifikation 
новообразование	новаўтварэньне	die Neubildung 
ноздреватый	наздраваты	porös, schwammartig 
нормальный выход	нормальны выхад 	der Normalaustritt, Normalausgang 
объемный вес почвы	аб’ёмная вага глебы	das Volumengewicht des Bodens 
обжигать	абпальваць	anbrennen, brennen 
обломочная порода	абломная, клястычная парода	das Schaftgelände  
обжигательная трубка	апальная трубка 	das Verbrennenrohr, Verbrennungsrohr
обмен	замена	der Austausch 
обменные основания	заменныя асновы 	die Austauschbasen  
образец почвенный	узор глебы 	die Bodenprobe, das Muster 
обсушивать 	абсушваць, абсушаць	abtrocknen  
обнажение (по оврагам и пр.)	абгаленьне, зрэз 	die Nacktheit, Entblössung 
оболочка 	абалонка, павало´ка	der Mantel, die Hülle  
общая кислотность	агульная кіслотнасьць	die Totalacidität  
овраг 	роў, яр 	die Schlucht, der Hohlweg 
оглеение	агляе´ньне	das Gleybildung 
оглеенный	агле´ены, абгле´ены	in Gley umgebildet 
огнестойкий  	агнятрывалы, агняадпорны, агнястойкі [H. T. 5]	feuerfest, feuersicher   
оголенные места  	аголеныя месцы, лапіны 	die Kahlstellen, Scheinstellen, Schwindstellen 
обугливать 	абвугліваць, абвугліць	ankohlen, karbonisieren 
однородный состав	аднародны, аднастайны склад	die einheitliche Zusammensetzung 
озолять, озаливать	апапяляць, апапёльваць	veraschen  
озы 	озы, пескавыя грады	die Sandbeete, Sandbänke, Ösen 
скатанный	абка´чаны	abgerundet 
окисление 	утляненьне 	die Oxydation, das Säuern 
оледенение 	абледзяненьне, зьледзяненьне	das Vereisen, Erstarren 
оподзаливание	ападзольваньне	die Podsolierung 
опока 	апока 	der kalkfreie Mergelstein 
опускание 	зьніжэньне, ападаньне	das Herablassen, Versenken 
ортзанд	ортзанд	der Ortsand 
ортштейн	ортштэйн	der Ortstein 
осадок (хим.) 	асадак 	der Bodensatz, das Sediment 
осадочная порода	пластовая парода [H. T. 5]	das Ablagerungsgestein 
осаждение	асаджваньне	der Niederschlag 
освеженный (срез) 	асьвежаны, адноўлены	aufgefrischt, erneuert  
осветление 	прасьвятленьне, пасьвятленьне	die Klärung, Läuterung 
освобождать от извести	вывапноўваць 	entkalken  
освобождать от кислотности	выкіслочваць 	entsäuern  
осколок минеральный	адшчэпак мінэральны	der Mineralsplitter  
осмос	осмос	die Osmose 
осмотическое давление	осмотычны ціск 	der osmotische Druck  
основание [хим.] 	аснаваньне, аснова	die Base  
останец [моренный]	астатнік [морэнавы]	der Nachbleibsel  
отдельность [физ.]	асобнасьць 	die Abgeschiedenheit  
отложение 	адклад 	die Ablagerung, das Abfallen 
отмучивание 	адкаламучваньне, сартаваньне	die Abschlämmung  
отмывать [мех. спос.]	адмываць, адпалоскваць	abwaschen, auswaschen, abspülen 
относительный вес	адносная вага 	das relative Gewicht  
отстаивание 	адстойваньне; асаджваньне	das Abstehen, Abklären 
оттянутый	адцягнуты	ausgezogen 
отфильтровывать 	адцэджваць, адфільтроўваць	abfiltrieren  
охлаждать  	ахалоджваць, халадзіць, астуджваць	kühlen, abkühlen   
очищение (хим.)	ачышчэньне	die Reinigung 
ощелочение	аблугаваньне	die Alkalisierung 
падение 	спад, спаданьне, апад, па´даньне	das Fallen, Herabfallen, Hinabfallen 
па´левый 	палавы, жаўтаваты	hellgelb, paille 
пахотный горизонт	ворны пазем, ральлёвы пазем	die Ackerkrume  
паяльная горелка 	літавальны пальнік	der Lotbrenner  
перегиб 	перагін 	die Knickung, Beugung 
перегруженный (материал)	перакладзены, пераладованы	verfrachtet  
перегной 	перагной; гумус 	die verrottete organische Substanz 
перемешивать	перамешваць	durchmischen, vermischen 
перенос [частиц] 	перанос [часьцінак]	der Übergang der Teilchen 
переслаивание  	перапластаваньне, перапластоўваньне	die Durchschichtung   
переходный [горизонт]	пераходны [пазем] 	das Übergangsschicht  
песок	пясок	der Sand 
песок зандровый 	зандра, пясок зандравы	der Fliesssand, Flutsand  
песок кварцевый 	пясок кварцавы, шкляны	der Quarzsand  
песок крупный 	буйнец, пясок буйны	der grobe Sand  
песок мелкий 	драбнец, пясок дробны	der feine Sand  
песок сыпучий 	пясок сыпучы	der Streusand, Triebsand, Flugsand 
песчаник	пескавік	der Sandstein 
песчаник пестрый 	пескавік стракаты, страка´ль	der bunte Sandstein, Buntsandstein 
пестик [хим.] 	таўкачык 	die Mörserkeule, das Pestill 
петрография	пэтрографія	die Petrographie 
печь Густавсона 	печ, палільня Густаўсонава	der Gustavson'sche Ofen 
пиезометр	піезомэтр	das Piezometer 
пикнометр 	пікномэтр, густамер	das Pyknometer  
пласт	пласт	die Schicht 
пластичность	плястычнасьць	die Plasticität 
пластовой [мергель, глина]	слаёвы, пластовы 	Geschiebe-(lehm, -mergel) 
плато 	плято 	das Plateau, die Hochebene 
плёнка	плеўка, абалонка	das Häutchen 
плесень 	плесьня, цьвіль; бросьня	der Schimmel  
плодородие почв 	урадлівасьць, ураджайнасьць глебы	die Fruchtbarkeit  
плотность [хим.] 	густасьць 	die Dichte, Dichtigkeit 
плотность [физ.] 	шчыльнасьць 	die Festigkeit, Dichtigkeit 
поверхностная энергия	паверхневая энэргія	die Oberflächenergie  
пленочная влага 	абалонкавая, плевачная вільгаць	die hautartige Wasserschicht 
поглощение	паглынаньне	die Adsorption 
поглотительная способность 	паглынальная здольнасьць, naглынальнасьць	die Adsorptionsfähigkeit  
подгоризонт	супадземнік	der untere Horizont 
подзол	падзол	der Podsol 
подзолистый 	падзолісты 	podsolartig, podsolisch 
подготовка почвы 	падгатоўка, падгатаваньне глебы	die Vorbereitung des Bodens 
поднятие воды 	вадапад’ём, прыбываньне вады	die Steigung, Erhebung, Erhöhung 
подзолообразовательный	падзолаўтваральны	der podsolbildende  (Prozess) 
подстилаемый 	падсьціланы, паднасьцелены	unterliegend, untergelagert 
поглощающий комплекс	паглынальны комплекс	der Adsorptionskomplex 
поверхностное натяжение	паверхневае нацяжэньне	die Oberflächenspannung, die Adhäsion 
подпочва	падглеб'е, грунт	der Untergrund 
подпочвенный 	падглебны, грунтавы	Untergrund- 
покров [почвенный]	насьціл, пакро´ў, покрыва глебы 	die Bodendecke, die Oberschicht, Oberkrume 
покровная порода 	пакрыўна´я, пакроўная парода	die Oberschicht, Oberkrume 
полиморфный 	многаформны 	polymorph, vielgestaltig 
полнота осаждения 	паўната асаджваньня 	die Gesammtmenge des Niederschlages 
положение пластов	палажэньне пластоў	die Schichtenlage  
полевой шпат	палявік	der Feldspat 
полуторный окисел	паўтаратленьнік 	das Oxyd (dreiwertige) 
помешивать	памешваць	rühren 
по´ра	сітавінка	die Pore 
пористый	сіткаваты	porös 
пористость	сіткаватасьць	die Porosität 
порода кіслая	парода кіслая	die sauere Gesteinsart 
порода коренная 	парода асноўная 	der Grundgestein, Urgestein 
порода щелочная	лужная парода	der alkalische Gestein 
последовательное сливание	паступовы зьліў 	das nachfolgende Abgiessen 
послеледниковый (об отложениях)	паледавіковы  (аб адкладах)	nacheiszeitlich, postdeluvial 
постепенно продолжающийся	паступоўны 	continuirlich, fortlaufend 
потеря (в весе) 	страта, зьмяншэньне (вагі)	der Gewichtsverlust  
почва 	глеба 	der Boden, das Solum 
почва азональная	глеба азональная	der azonale Boden 
почва аллювиальная	глеба алювіяльная 	der Alluvialboden  
почва болотистая 	глеба абалочаная 	der Sumpfboden, Moorboden 
почва болотная	глеба балотная	der Moorboden 
почва бурая	глеба бурая	die Braunerde 
почва влажно-луговая	глеба вільготна-лугавая	feuchte Wiesenboden  (der) 
почва глубоко-подзолистая	глеба глыбока-падзолавая	der tiefpodsolierte Boden 
почва горно-луговая 	глеба горна-лугавая 	der Gebirgswiesenboden, der Almenboden 
почва глубокая 	глеба глыбокая 	der tiefgründige Boden 
почва древняя 	глеба старадаўняя 	der altertümliche Boden 
почва диафорская	глеба дыяфорская	der diaphorische Boden 
почва зональная 	глеба паясовая, зонавая	der Zonenboden, zonale Boden 
почва интразональная	глеба інтразонавая 	der intrazonale Boden  
почва ископаемая 	глеба выкапнёвая 	der fossile, vorweltliche Boden 
почва дерновоподзолистая	глеба дзярновападзолавая	der rasige Podsolboden 
почва каштановая 	глеба каштанавая 	der kastanienbraune Boden 
почва красноцветная	глеба чырвонакаляровая	der rotgefärbte Boden  
почва легкая	глеба лёгкая	der leichte Boden 
почва луговая	глеба лугавая	der Wiesenboden 
почва лугово-степная	глеба лугава-стэпавая	der Boden der Steppenwiese 
почва намытая 	глеба намытая 	der angewaschene Boden 
почва наносная 	глеба наносная 	der angeschwemmte Boden 
почва насыщенная	глеба насычаная	der gesättigte Boden 
почва ненасыщенная	глеба ненасычаная, кіслая	der ungesättigte Boden 
почва нейтральная	глеба нэўтральная	der neutrale Boden 
почва неглубокая 	глеба няглыбокая 	der flache, seichte Boden 
почва нормальная	глеба нормальная	der normale Boden 
почва оподзоленная	глеба ападзоленая 	der podsolierte Boden  
почва перегнойноглеевая	глеба перагнойнаглеістая	der verrottete Gleyboden 
почва погребенная 	глеба пахованая 	der verschüttete, überlagerte, begrabene Boden
почва полуболотная	глеба паўбалотная 	der schwachsumpfige Boden 
почва подзолисто-болотистая	глеба падзолава-абалочаная	der podsolischsumpfige Boden 
почва первобытная	глеба пярвесная 	der ursprüngliche Boden, Grundstein 
почва первично-подзолистая	глеба пярвесна-падзолавая	der primärpodsolische Boden 
почва вторично-подзолистая	глеба паўторна-падзолавая	der secundärpodsolische Boden 
почва маршевая	глеба маршавая	der Marschboden 
почва мангровая 	глеба мангравая 	der Mangroveboden 
почва перегнойно-карбонатная	глеба перагнойна-карбонатная(карбанатная)  (H. T. 5.)	der verrottete Kalkboden  
почва подзолистая 	глеба падзолавая 	der podsolische Boden, Podsolboden 
почва светло-серая 	глеба шараватая, сьветла-шэрая	der hellgraue Boden   
почва сильно-подзолистая 	глеба моцна ападзоленая, падзолавая	der starkpodsolierte Boden  
почва слабо-подзолистая	глеба слабападзодавая	der schwachpodsolierte Boden 
почва средне-подзолистая	глеба сярэдняпадзолавая	der mittelpodslierte Boden 
почва смытая 	глеба змытая 	der abgeschwemmte Boden 
почва солонцеватая	глеба саланцаватая	der salzhaltige Boden  
почва сырая	глеба вільготная	der feuchte Boden 
почва солончаковая	глеба (гл. солончак)	der Salzboden, Solontschack 
почва солонцовая	глеба (гл. солонец)	der Solonetz 
почва палевая подзолистая	глеба палавая падзолавая	der hellgelbe podsolische Boden 
почва темно-цветная	глеба цёмна-каляровая	der dunkelfarbige Boden 
почва торфяно-болотистая	глеба тарфяна-балотавая	der sumpfige Torfboden 
почва торфяно-подзолистая	глеба тарфяна-падзолавая 	der sumpfige Podsolboden  
почва хрящеватая 	глеба храсткаватая	der Kiesboden  
почва черноземевидная	глеба чарназемападобная	der tschernosjomartige Boden 
почва черноземевидно-луговая	глеба чарназемападобна-лугавая	der tschernosjomartige Wiesenboden  
почва щебенчатогравельная	глеба жарствяна-жвіраватая	der gruhsartige Steinschuttboden 
почва эндодинамоморфная	глеба ўнутрана-ўтво´раная	der endodynamomorphe Boden 
почва эктодинамоморфная	глеба знадворна-ўтво´раная	der ektodynamomorphe Boden 
почва элювиальная	глеба вымытая, элювіяльная	der Eluvialboden  
почвоведение 	глебазнаўства, глебаведаньне	die Bodenkunde  
пояс растительный	паласа, пас расьлінны	die Vegetationszone, Vegetationsgürtel, der Vegetationsumfang 
предел вмывания 	мяжа ўмыву 	die Einschwemmungsgrenze 
приемник	прыемнік	der Aufnahmeapparat 
прибор Копецкого	прылада Капецкага	der Kopeckische арparat 
присыпка (солей и пр.)	прысыпка 	die Beigabe, Einpuderung, Bestäubung 
признак заболачивания	прымета забалочваньня	das Versumpfungsanzeichen, Versumpfungsmerkmal
примесь 	дамешка 	der Zusatz, Mischanteil 
притертый	прыцёрты	angeschliffen 
притяжение взаимное	прыцягваньне ўзаемнае	die gegenseitige Anziehung 
примазка (солей)	прымазка	das Flecken, Tupfen 
препарат 	прэпарат, спо´рабак	das Präparat  
проба	спроба	die Probe 
продолжительность отмучивания	працяжнасьць адкаламучваньня	die Abschlämmungsdauer 
предледниковый суглинок 	даледавіковы, перадледавіковы суглінак	der vorglaciale sandige Lehm  
прокалить, прокаливать	выпаліць, выпальваць	durchglühen  
продукт выветривания	продукт выветрываньня	das Verwitterungsprodukt 
промывалка 	прамывалка, прамывачка	der Waschapparat  
промывать	прамываць	durchwaschen, auswaschen 
прозрачный 	празрысты, сьветлы	durchsichtig  
пролювий	пролюві	das Proluvium 
промоина	ры´твіна, прамывіна	der Wasserdurchbruch, Wasserriss 
пропускать (через прибор)	прапушчаць	durchlassen 
пропласток 	перапла´стка, перапла´стак	die Zwischenschicht  
прослойка 	праслойка 	die Zwischenlage, Zwischenschiebt 
просеивать	прасяваць	sieben, durchsieben
простирание пластов	распасьціраньне пластоў	die Ausdehnung, Verbreitung d. Sch. 
прохладный (климат)	халажава´ты 	das kühle Klima  
псевдомицелий	псэўдаміцэлі	das Scheinmycel 
псевдоморфизм  	псэўдаморфізм, несапраўдная форма	der Pseudomorphismus  
псевдораствор 	псэўдараствор 	die Scheinlösung, Pseudolösung 
псевдофибры 	паўтаратленьнікавыя пражылкі	die Pseudofibren  
пылеватая частица	пылаватая часьцінка	das Staubteilchen  
прикопка	прыкопка	die Schurfgrube 
развевание	разьвейваньне	das Anwehen 
разделение (мех. ан.)	падзяленьне, падзел	die Verteilung  
раздробленность  	раздробленасьць, пакрышанасьць 	die Zerkleinerung, Verpulverung, Zersplitterung 
размывание	размываньне	die Auswaschung 
разнородный (нанос) 	рознастайны, неаднастайны нанос	die verschiedenartige Aufschlämmung 
разогревать	разаграваць	erwärmen 
разрез почвенный 	перарэз, разрэз глебавы	der Bodendurchschnitt 
разрез (профиль) почвенный продольный	перарэз, разрэз прадоўжны 	der Längstdurchschnitt  
разрез (профиль) почвенный поперечный	перарэз, разрэз папярэчны 	der Querdurchschnitt der Abbau  
разрушение (породы)	разбурэньне 	die Zerstörung d. Gest  
разрыхление	пухкаваньне	die Auflockerung 
равновесие системы	роўнавага сыстэмы	das Systemsgleichgewicht 
раскалять	распаляць, распальваць	glühen 
раскисленный	адтленены	entsäuert 
распахивать 	разворваць, узво´рваць	aufpflügen  
рассыпление областей	дыяспора 	die Diaspora  
раствор почвенный	раствор глебавы 	die Bodenlösung  
раствор коллоидальный	раствор колёідальны	die Kolloidlösung  
растворимый	растворны	löslich 
растворитель 	растворнік, рашчыньнік	das Lösungsmittel  
растительный покров	расьлінны покрыў  	die Vegetationsschicht, Vegetationskrume, Oberkrume
реакция	рэакцыя	die Reaktion 
реакция обменная 	рэакцыя паменная, памену	die Austauschreaktion  
реакция среды 	рэакцыя асярэдзіны 	die Reaktion des Mittels, Milieu 
реакционная способность	рэакцыйная здольнасьць	die Reaktionsfähigkeit  
реактив	рэактыў, ператвор	das Reagens 
растереть	расцерці	zerreiben 
рельеф котловинный	рэльеф катлінны	das kesselartige Gelände, -relief 
рельеф расчлененный	рэльеф пачленаваны	das Erosionsrelief, Erosionsgelände 
регур 	рэгур (індыйскі чарназем)	der Regur  
раствор жидкий 	рэдкі, нягусты´ раствор	die leichte, verdünnte Lösung  
региональное почвоведение 	рэгіянальнае, абшарнае глебазнаўства	die regionale Bodenkunde  
рендзина	рэндзіна	die Rendsine 
рыхлый	пухкі	locker 
рухляк 	пацяруха, трухляк	die Trümmer, der Schutt 
свертываться (коллоид. в.)	сьсядацца	gerinnen  
свинцовозем	волавазем	die Bleierde 
свойственный (породе), генеральный	уласьцівы пародзе	generell, arteigen  
связность 	зьвязнасьць, клейкасьць	die Zusammenhangsfähigkeit 
сгущенный 	згусьцелы, згушчаны	kondensiert  
сдувание	зьдзьмухваньне	das Abblasen, Wegblasen 
серозем 	шэразем 	der Grauboden, Fahlboden 
серобактерии  	серкавыя бактэрыі, серкабактэрыі	die Schwefelbakterien   
серый лесной суглинок	шэры лясны суглінак	der graue sandige Lehm des Waldes 
сжигать	спальваць	verbrennen 
силикатный комплекс	сылікатны комплекс	der Silikatkomplex  
система зональная 	сыстэма (уклад, склад) зонавая	das Zonensystem  
система (пластов) 	уклад (пластоў) 	das System (d. Schicht.) 
ситовый анализ 	сітавы, правява´льны аналіз	die Siebanalyse  
сифон	лівар, сыфон	der Heber 
скат 	спад 	der Abhang, Abhangssturz, die Lehne 
скважность 	шчыліннасьць 	die Spaltigkeit, Porosität 
скелетная часть почвы	касьцяк глебы 	das Skelett, die Gerüstteil, das Gerüst 
скопление (солей)  	зграмаджэньне, скупнасьць (H. Т. 3)	die Kalkanhäufung   
скрытослоистый	нявыразнаслаісты	scheinschichtenförmig 
склон 	схіл 	der Abhang, Hang, die Lehne 
сливание (сифоном) 	зьліваньне, сыфанаваньне, выцягваньне	das Abhebern   
слоистость	слаістасьць	die Schichtigkeit 
слой	слой	die Schicht 
след (вещества, породы)	сьлед (матэрыі, пароды)	die Spur  
смывание 	змыў, змываньне 	das Abwaschen, die Abwaschung 
содержимое	зьме´сьціва	der Inhalt 
содовая вытяжка	содавая вы´цяжка	der Sodaauszug 
солеобразный	солепадобны	salzartig
солонец	саланец	der Solonetz 
солонец глубокостолбчатый	саланец глыбокаслупаваты	der starksäulenartige Solonetz 
солонец корковостолбчатый 	саланец скарыначна-слупаваты	der säulenförmige, mit Oberkruste versehene Solonetz 
солонец столбчатый	саланец слупаваты 	der säulenartige Solonetz  
солончак 	саланчак 	der Salzboden, Solontschack 
солодь 	со´ладзь 	der entsalzte Solonetzboden 
соотношение горизонтов	суадносіны паземаў	das gegenseitige Verhältnis d. Horiz. 
сортирование 	сартава´ньне 	das Sortieren, das Trennen 
сплавлять 	стапляць, стопліваць	zusammenschmelzen  
сплющенный 	сьціснуты, сплюшчаны	abgeplattet, zusammengedrückt 
сползание	спаўзаньне	die Abrutschung 
среда  	асярэдзіна  	die Mitte, der Wirkungskreis, das Milieu 
средняя проба 	сярэдняя проба 	die Durchschnittsprobe 
старица	старарэчча	das alte Flussbett 
стекло часовое 	шкло гадзіньнікавае	das Uhrglas  
стеклянный колпак	шкляны клёш, каўпак	der Glasaufsatz, die Glaskappe 
стеклянная палочка	шкляная па´лачка 	das Glasstöckchen  
степень оподзоливания	ступень ападзо´льваньня	der Podsolierungsgrad, die Podsolierungsstufe 
степь доисторическая	дагістарычны стэп	die prähistorische Steppe 
стойка	стаяк, стойка	der Ständer 
столик подъемный	столік пад’ёмны	der Aufziehtisch 
строение почвы 	будова глебы 	die Textur, der Aufbau des Bodens 
структура почвы	структура глебы 	die Struktur  
структура глыбистая 	структура глызаватая, брылаватaя	die schollenartige Struktur  
структура листоватая	структура ліставатая	die blattähnliche Struktur 
структура ореховатая	структура apaxaватая	die nussartige Struktur 
структура пластинчатая	структура пласткаватая	die lamellenschichtartige Struktur
структура плитчатая	структура пліткаватая	die plattenartige, plietenförmige Struktur
структура чешуйчатая	структура лускаватая	die schuppenartige Struktur 
структура ячеистая	структура ячкаватая	die zellenförmige Struktur 
струйчатый ортзанд	цуркаваты ортзанд	der geflammte Ortsand
струя	струмень	der Strom, Strah 
студенистый 	студзяністы, галярэтны	gallertartig  
ступка (фарфоревая)	мажджэр, ступка (парцэлянавая)	der Porzellanmörser  
суслик	сусла	die Zieselmaus 
сушильный шкаф	сушыльная шафа	der Trockenschrank 
сцепление 	зьвязнасьць, шчапленьне	die Kohärenz, der Zusamenhang
суглинок	суглінак	der sandige Lehm 
суглинок крупнопесчаный	суглінак буйна-пяшчаны	der grobsandige Lehm  
суглинок легкий 	суглінак лёгкі 	der leichte sandige Lehm 
суглинок лесной 	суглінак лясны 	der sandige Waldlehm 
суглинок лессовидный	суглінак лёэсавідны, лёэсаваты	der lössartige sandige Lehm 
суглинок лессовый 	суглінак лёэсавы 	der sandiglehmige Lössboden 
суглинок средний 	суглінак сярэдні	der mittlere sandige Lehm 
суглинок тяжелый 	суглінак цяжкі 	der schwere, bindige sandige Lehm 
супесь	су´песак	der lehmige Sand 
супесь грубая 	су´песак грубы´, буйны´	der grobe lehmige Sand 
супесь тонкая 	су´песак тонкі, дробны	der feine lehmige Sand 
сфагнум 	сфагнум, белы мох	das Sphagnum  
сложение почвы	стан глебы	die Bodenschichtung 
твердость	цьвёрдасьць	die Festigkeit, Stärke 
текстура 	тэкстура, пабудова глебы	die Textur, der Aufbau des Bodens 
температура осаждения	тэмпэратура асаджваньня	die Temperatur des Niederschlages 
теплоемкость	цёплаёмасьць	die Wärmekapacität 
термическое выветривание 	тэрмічнае, цяплынёвае выветрываньне	die thermische Verwitterung, Wärmeverwitterung 
термодинамическая оболочка	тэрмадынамічная абалонка	die thermodynamische Oberschicht 
терраса	тэраса, прыступка	die Terrasse 
тление 	трухленьне, тленьне	die Verwesung  
толща 	тоўшча 	die Dicke der Tiefe nach, die Mächtigkeit 
толщина пластов 	грубіня, таўшчыня пластоў	die Tiefe der Schichten 
тигель	тыгель, тыглік	der Tiegel 
трение внутреннее	цярцё нутраное 	die innere Reibung  
треножник	трыножак	der Dreifuss 
третичный 	трацічны, трацьцёвы (H. T. 5)	tertiär  
трещина	расколіна	der Spalt, die Ritze 
трещинковатое строение 	расколісты склад, расколістая пабудова	der spaltenreiche Aufbau  
тройник	трайнік	das Dreiecksrohr 
трубка	трубка; рурка	das Rohr 
трубка паяльная 	трубка, рурка літавальная	das Lötrohr  
тугоплавкий	тугатопкі	schwerschmelzbar 
убыль веса	упад вагі	der Gewichtsverlust 
увлажнение избыточное	абвільгаценьне надмернае	die überflüssige Niederschlagsmenge 
увлажнять	абвільго´чваць	befeuchten 
углекислота почвы	вуглекіслата глебы	die Kohlensäure des Bodens 
углерод гумуса 	вуглярод перагною	der Humuskohlenstoff  
углесоли	карбонаты	die Kohlensalze 
удельный вес 	спэцыфічная, адносная вага	das spezifische Gewicht 
ульмин	ульмін	das Ulmin 
ульминовая кислота	ульмінавая кіслата	die Ulminsäure  
у-образная трубка 	у-падобная трубка, рурка	das U-förmige Rohr  
уплотненный горизонт	ушчытнены пазем 	die verdichtete Schicht 
уравновесить 	зроўнаважыць 	ins Gleichgewicht bringen 
установление горизонтов 	азначэньне паземаў 	die Bestimmung, Feststellung d. Horiz.
устройство поверхности	склад паверхні 	die Oberflächenbildüng 
утолщение 	стоўсьць 	die Verdickung, das Verdicken 
усыхание 	усыханьне 	das Eintrocknen, Vertrocknen, Austrocknen 
фаза 	фаза 	die Phase, der Abschnitt 
фактор почвообразования	глебавытворны фактар	der bodenbildende Faktor 
фарфоровый 	парцэлянавы, фарфо´равы	Porzellan-, porzellanartig 
фёрна (лесной войлок)	фэрна, лясны падсьціл, лямец	die Förna  
физические свойства	фізычныя ўласьцівасьці	die physikalischen Eigenschaften 
физико-географический	фізыка-геаграфічны	physikalisch-geographisch 
флексура	згібіна, флексура	die Flexur 
флювиальный (относительно области)	краіна рачных размываў 	fluvial, Fluss-, Fliess-(gelände)  
флювио-гляциальный (об отложениях)	ледавікова-рачныя адклады	fluvioglacial  
флюидальные отложения  	адклады водных струменяў, патопаў, флюідальныя адклады	die fluidale Ablagetrung, die Flutablagerung  
фильтр	фільтар	das Filter 
фильтрат	фільтрат	das Filtrat 
фильтровать	фільтраваць	filtrieren 
фракция (мех. ан.)	фракцыя 	die Fraction  
фосфатная смесь 	фосфатнік 	die Phosphatmischung 
хаотическое напластование	бязладнае напласта´ньне	die chaotische Schichtenlagerung 
хвойный лес	іглясты лес	der Nadelwald 
химический	хэмічны	chemisch 
холм	узгорак	der Hügel 
холмистый рельеф 	узгорчаты рэльеф	das hügelige Relief, Gelände 
холодильник 	халадзільня 	der Kühler, das Kühlapparat 
хребет	хрыбет, сьцяг	der Bergrücken 
хрупкий	крохкі	zerbrechlich 
хрящ 	храсток 	der Kies, Gries, Kiessand 
целина	цаліна	der unberührte Boden 
центр вмывания 	асяродак, цэнтр умыву	das Zentrum der Einschwemmung 
цеолит	цэаліт	der Zeolith 
цеолитный комплекс	цэалітны комплекс	der Zeolithenkomplex  
цилиндрическая форма конкреций 	цыліндрычная форма сьцяжэньняў	die zylinderartige Konkretion, Ausscheidung 
цинковая призма 	цынкавая прызма	das Zinkprisma  
циркуляция воды 	цыркуляцыя вады	die Wassercirkulation  
цитратная смесь	цытратнік	die Citratmischung 
частица 	часьцінка, частачка	das Teilchen  
чашка	міска, місачка	die Schale 
черта сливания 	рыса зьліваньня 	die Grenze der Abheberungen 
червь дождевой 	чарвяк-дажджавік	der Regenwurm  
чередование пластов 	пластазьмен, чаргаваньне пластоў	der Wechsel der Schichten  
чернозем 	чарназем 	der Tschernosjoin, die Schwarzerde 
чернозем обыкновенный	чарназем звычайны 	der gewöhnliche Tschernosjom 
чернозем деградированный	чарназем дэградаваны	der degradierte Tschernosjom
чернозем мощный 	чарназем тоўсты, глыбокі	der tiefgründige Tschernosjom 
чернозем северный	чарназем паўночны	der nördliche Tschernosjom 
чернозем южный 	чарназем паўднёвы	der südliche Tschernosjom 
четвертичная система  	сыстэма апошніх адкладаў (H. T.), чацьвярынная сыстэма	das Quartärsystem    
шаробразная частица	куляпадобная часьцінка	das kugelförmige Teilchen 
штанга	штанга	die Stange 
штатив 	штатыў 	das Stativ, Gestell, die Stütze 
шурф 	шурф, глыбокая яма	der Schürf, Stollen  
щебенка 	жарствяк, жарствень	der Schotter  
щелочь 	луг, шчолак, аснова	das Alkali  
щелочная почва	лужная глеба	der alkalische Boden 
щелочная порода	лужная парода	das Alkaligestein 
щипцы для тиглей	шчыпцы тыгляныя	die Tiegelzange  
экватор	экватар, роўнік	der Equator 
эксикатор 	эксыкатар 	der Trockenapparat, Exsikator 
экспозиция  	экспозыцыя (накіраваньне да старон сьвету)	die Exposition, die Höhenlage  
экспедиционное обследование	экспэдыцыйнае дасьледваньне	die Expeditionsforschung 
электрод водородный	электрод вадародны	die Wasserstoffelektrode 
электрод каломельный	электрод каламельны	die Kalomelelektrode  
электрод хингидронный	электрод хінгідронны	die Chinhydronelektrode 
электролит	электраліт	das Elektrolyt 
электрометр капиллярный	капіляр-электро´мэтр	der Kapillarelektrometer 
электрометрический метод	электрамэтрычны мэтод	die elektrometrische Methode 
электропроводность	электраправоднасьць	die Elektrizitätsleitungsfähigkeit 
электротитрование	электратытрацыя, электратытраваньне	das elektrometrische Titrieren 
элювиальный горизонт 	пазем вымываньня, пазем элювіяльны	der Eluvialhorizont   
элювий	элюві	das Eluvium 
эмульсия	эмульсія	die Emulsion 
энергия поверхности	энэргія паверхні	die Oberflächenergie  
эоловый 	ветравы, эолёвы 	äolisch, von Wind und Wetter abhängig 
эпоха ледниковая	эпоха ледавіковая 	die Glacialepoche, Eiszeit 
эрозионный останец	эрозійны астанец 	die Erosionsrest  
эрозия 	эрозія, выяданьне	die Erosion  
эрратический валун 	эратычны, ледавіковы камень	der erratische Block   
ядро конденсации 	асяродак згушчэньня	der Kondensationskern, Kondensationsinhalt 
яма почвенная	яма глебавая	die Bodengrube 
