##Title: Слоўнік тэрміналёгіі агульнае расьлінагадоўлі (праект) (БНТ)
##HTMLDescription_BEGIN
<div>
	<p class="dictdesc-st">Створана на падставе:</p>
	<p><b>Слоўнік тэрміналёгіі агульнае расьлінагадоўлі (праект)</b>. Менск: Інбелкульт, 1930.</p>
</div>
<div>
	<p class="spoiler">Прадмова</p>
	<p>Гэты тэрміналёгічны слоўнік агульнай расьлінагадоўлі нельга прызнаць дасканалым з боку яго паўнаты і сыстэматычнасьці. Як і папярэднія тэрміналёгічныя слоўнікі, ён мае характар праекту. Кожны можа падаваць свае папраўкі і дадаткі, якія будуць прымацца пад увагу пры далейшай апрацоўцы тэрміналёгічных слоўнікаў у Тэрміналёгічнай Камісіі. Выпускаючы ў свет кожную тэрміналёгію, Тэрміналёгічная Камісія і далей зьбірае тэрміналёгмчны матар’ял − народны і літаратурны, каб у наступных выданьнях дапаўняць і выпраўляць тое, што на падставе новага матар’ялу будзе вымагаць належных дадаткаў і паправак. Тэрміналёгічная Камісія лічыць, што ўдасканаліць сваю работу яна зможа толькі ў тым выпадку, калі на помач ёй прыдзе актыўная праца ўсіх зацікаўленых асоб і ўстаноў.</p>
	<p>Пры ўкладаньні тэрміналёгіі выкарыстана наступная літаратура:</p>
	<p>1. Бараков П. Общее земледелие.</p>
	<p>2. Беларуская Навуковая Тэрміналёгія вып. III, V, VI, XVI.</p>
	<p>3. Биденко А. К вопросам теории и истории колективизации. </p>
	<p>4. Вильямс В. Р. проф. Общее земледелие.</p>
	<p>5. Винер В. В. проф. Общее земледелие.</p>
	<p>6. Винер В. В. проф. Растения полевой культуры.</p>
	<p>7. Винер В. В. проф. Сельско-хозяйственное опытное дело.</p>
	<p>8. Гедройц К. К. проф. Химический анализ почв.</p>
	<p>9. Дзямідовіч А: Бульба. Б. Дз. В. Менск. 1929 г.</p>
	<p>10. Домонтович М. К. Определение концентрации водородных ионов.</p>
	<p>11. Дояренко А. Г. проф. Краткое руководство к постановке вегетационных опытов.</p>
	<p>12. Егоров М. А. проф. Вопросы удобрения почв.</p>
	<p>13. Жегалов С. И. проф. Введение в селекцию.</p>
	<p>14. Каменский К. В. Методика исследования качества посевного материала.</p>
	<p>15. Киндеев К. Я. Как перейти к коллективному хозяйству. Изд. 4-ое. Москва. 1929.</p>
	<p>16. Котельников В. О. возделывании картофеля и корнеплодов. Изд. А. Девриена, 1917.</p>
	<p>17. Кравков С. П. проф. Общее земледелие.</p>
	<p>18. Ленис Ф. Начала сельско-хозяйственной бактериологии.</p>
	<p>19. Научно-Агрономический журнал за 1924, 1925 гг.</p>
	<p>20. Недокучаев Н. К. проф. Вегетационный метод.</p>
	<p>21. Недокучаев. Н. К. проф. Краткие основы полевого опыта.</p>
	<p>22. Павловский И. Я. Русско-Немецкий и Немецко-Русский словари.</p>
	<p>23. Палладин В. И. проф. Физиология растений.</p>
	<p>24. Прянишников Д. Н. проф. Химия растения.</p>
	<p>25. Прянишников Д. Н. проф. Частное земледелие.</p>
	<p>26. Ротмистров В. Г. Методика полевого опыта.</p>
	<p>27. Рытов Н. И. и Энгельгардт П. И. Исследование семян. 1929.</p>
	<p>28. Сапегин А. А. проф. Вариационная статистика.</p>
	<p>29. Тимирязев К. А. проф. Жизнь растений.</p>
	<p>30. Энциклопедия русского сельского хозяйства. Изд. А. Ф. Девриена.</p>
	<p>31. Alb. Christiansen. Taschenbuch einheimischer Pflanzen.</p>
	<p>32. Prof. Dr. Paul Ehrenberg. Die Bodenkolloide. Dritte Auflage. 1922.</p>
	<p>33. Prof. Dr. Paul Ehrenberg. Herausgegeben vom Stickstoff-Syndikat. Berlin.</p>
	<p>34. Prof. Dr. Paul Ehrenberg. Herausgegeben vom Kali-Syndikat. Berlin.</p>
	<p>35. J. Könik. Die Ermittlung des Düngerbedarfs des Bodens. Berlin. 1929. </p>
	<p>36. Prof. Dr. F. Löhnis. Landwirtschaftlich-bakteriologisches Praktikum. Zweite Auflage. Berlin. 1920.</p>
	<p>37. Dr. K. Maiwald u. Priv.-Doz. Dr. E. Ungerer. Agrikulturchemische Übungen. Dresden und Leipzig. 1926.</p>
	<p>38. Dr. Walter Mevrius. Reaktion des Bodens und Planzenwachstum. Freising-München. 1927.</p>
	<p>39. Dr. Leonor Michaelis. Praktikum der physikalischen Chemie insbesondere der Kolloidchemie. Berlin. 1926.</p>
	<p>40. Dr. E. Moller-Arnold. und K. Feichtinger. Der Feldver-such in der Praxis. Wien. 1919.</p>
	<p>41. Prof. Dr. Theodor Pfeiffer. Der Vegetationsversuch. Berlin. 1918.</p>
	<p>42. Prof. Dr. Schneidevind. Die Ernährung der Landwirtschaftl. Kulturpflanzen. Sechste Auflage. Berlin. 1928.</p>
	<p>43. L. Wittmack. Botanik. Fünfte Auflage.</p>
	<p>44. Dr. L. Wittmаck. Landwirtschaftliche Samenkunde. Berlin. 1922.</p>
	<p> </p>
	<p><i>Тэрміналёгічная Камісія.</i></p>
	<p>20/ІІ−30 г.</p>
</div>
##HTMLDescription_END
##ArticleLang: ru/be

абсолютный вес	абсолю´тная вага´
абсорбция	абсо´рбцыя, убіра´ньне агу´льнае 
автоматическая поливка	аўтаматы´чнае паліва´ньне 
агрегат	агрэга´т, ску´пнасьць 
агрикультура	агрыкульту´ра 
агрономия	аграно´мія 
адсорбция	адсо´рбцыя, убіра´ньне паве´рхневае 
азональная почва	бяззо´навая гле´ба 
азот	азо´т 
азот гумуса	азо´т гу´мусу, перагно´ю 
азот осадков	апа´дкавы азо´т 
азотистый тук	азо´цісты тук 
азотнокислое брожение	азотнакісьлі´ннае брузава´ньне 
азотный баланс	азо´тны баля´нс 
азотомер	азотаме´р 
азотопожиратель	азотажэ´р 
азотособиратель	азотазьбіра´льнік 
акклиматизация растений	акліматыза´цыя расьлі´н 
активная кислотность	акты´ўная кісьлі´ннасьць 
активная кислотность почвы	акты´ўная кісьлі´ннасьць глебы 
актинометр	актыно´мэтар 
алебастр	алеба´стар 
алкалоид растений	алькалё´ід расьлі´н 
аллювий	алю´ві, намы´ўнік 
алюмосиликат	алюмасыліка´т, алюмакрамня´к 
альбумин	альбумі´н 
альбуминоид	альбуміно´ід 
амбар	сьві´ран 
амбарная моль	сьвіро´начная моль 
амбарный долгоносик (Calandra granaria)	сьвіро´начны слонік 
аммиак	амоні´як 
аммиачный азот	амонія´чны азо´т 
аммонизация	амоніза´цыя 
аммонийное удобрение	амоні´йнае ўгнае´ньне 
аммонпермутит	амонпэрмуты´т 
аммон-селитровое удобрение	амон-сале´травае ўгнае´ньне 
аммон-фосфатная селитра	амон-фосфа´тная сале´тра 
амортизация	амортыза´цыя 
аморфный	амо´рфны, бясфо´рмны 
амплитуда	ампліту´да 
анализуемое вещество	аналізо´ўная матэ´рыя 
анаэробиозис	анаэрабіё´зыс, бястле´навае жыцьцё
анаэробный	анаэро´бны 
анион	аніё´н 
анис (Pimpinella anisum)	га´нус, га´нуш(слоўнік Насовіча)
антагонизм ионов	анатагоні´зм іё´наў 
антисептик	антысэ´птык 
антоциан	антоцыя´н 
апокреновая кислота	апакрэ´навая кісьлі´на 
аппарат для набивки вегетативных сосудов	апарат для набіўкі вэгетацыйных судзін 
аппарат для смешивания почвы	апарат для перамешваньня глебы 
аппробация	апраба´цыя 
артишок (Суnаrа Cardunculus)	артышо´к 
аспиратор	асьпіра´тар 
ассанизация	асаніза´цыя 
ассимиляция	асыміля´цыя 
асфальтовый известняк	асфа´льтавы вапня´к 
атавизм	атаві´зм 
атмосферный азот	атмасфэ´рны азо´т 
аэрация	аэра´цыя, праве´трываньне 
аэробная бактерия	аэро´бная бактэ´рыя 
аэробный процесс	аэро´бны працэ´с 
аэробы	аэро´бы, тленалю´бы 
бактериальное удобрение	бактэрыя´нальнае ўгнае´ньне 
бактерия	бактэ´рыя 
балансирный плуг	плуг з роўнава´жнікам 
безазотистый	безазо´цісты 
безводный	бязво´дны 
безнавозная почва	бязгно´йная гле´ба 
бекмановский аппарат	бэ´кманаўскі апара´т 
белая ржавчина	бе´лая іржа´ 
белковое вещество	белкаві´на, 6ялко´вая матэ´рыя 
белковые семена	бялко´вае насе´ньне 
белоглазка	белаво´чка 
белок семени	насе´нны бяло´к 
белоус (Nardus stricta)	сіве´ц 
бесплодие почвы	няпло´днасьць гле´бы 
бессменная культура	нязьме´нная культура 
бесструктурность почвы	бясструкту´рнасьць гле´бы 
бесхлорофильный	бесхлёрафільны 
бильная молотилка	бі´льная малата´рня 
биологическое выветривание	біёлёгі´чнае выве´трываньне 
биологическое поглощение	біёлёгі´чнае паглына´ньне 
биологическое свойство растений	біёлёгі´чная ўласьці´васьць расьлі´н 
биометр	біё´мэтар 
блеск семян	бляск насе´ньня 
блоха (земляная)	блыха´ (земляная) 
бобы конские (Vicia Faba vulgaris)	боб 
бобы огородные	боб гаро´дны
богатство почвы	бага´цьце гле´бы 
болезнь растений	хваро´ба расьлі´н 
болотистая почва	бало´тлівая глеба 
болотная почва	бало´тная глеба 
болотная руда	бало´тная руда´ 
болотный луг	бало´тны луг 
болото моховое	імша´ра 
болото топкое	ба´гна, дрыгва´ 
болото торфяное	бало´та тарфяно´е 
болото травяное	бало´та травяно´е 
бонитировка почвы	ацэ´нка гле´бы 
бор развесистый (Millium effusum)	прася´нік разло´жысты 
бордосская жидкость	бардо´ская жы´жка 
борозда	баразна´ 
бороздование посевов	гране´ньне, ляшэ´ньне засе´ваў 
борона	барана´ 
борона Аураса	барана´ Аўра´сава 
борона деревянная	барана´ драўля´ная 
борона дисковая	барана´ тале´рачная 
борона железная	барана´ жале´зная 
борона "Зигзаг"	барана´ "Зыгзаг" 
борона Лакке	барана´ Лякке´ 
борона лапчатая	барана´ лапча´стая 
борона легкая	барана´ лё´гкая 
борона луговая	барана´ сенажа´тная 
борона ножевая	барана´ нажо´вая 
борона норвежская	барана´ нарвэ´ская 
борона простая	барана´ про´стая 
борона пружинная	барана´-спружыно´ўка 
борона Рандаля	барана´ Рандалява 
борона тяжелая	барана´ ця´жкая 
боронование в два следа	баранава´ньне ў два сьляды´ 
боронование вдоль пласта	баранава´ньне ўдоўж скі´бы 
боронование в один след	баранава´ньне ў адзін сьлед  
боронование озими	скарадзьба´ азі´міны 
боронование пашни	скарадзьба´ па´хані 
боронование поперек пласта	скарадзьба´ ўпо´перак скі´бы 
боронование по диагонали	скарадзьба´ па дыягана´лі  
боронование посевов	скарадзьба´ засе´ваў 
борьба с вредителями	барацьба´ са шко´днікамі 
борьба с засухой	барацьба´ з су´шшу, з сухме´нем 
ботаническая спелость	ботані´чная сьпе´ласьць 
ботва	наці´ньне, ця´ўе 
ботва картофельная	бульбя´нік, картапля´нік 
ботва свекловичная	бацьві´ньне 
брожение	брузава´ньне 
бросовые земли	кідо´мыя зе´млі, няго´дныя абло´гі 
брюква (Brassica Napus rapifera)	бру´чка 
бугор	узго´рак 
бурение почвы	сьвідрава´ньне гле´бы 
бур почвенный	сьве´рдзел, сьві´дар гле´бавы 
бурт (корне- или клубнеплодов)	капе´ц 
бурьян	бы´льнік, быльлё´
буферная смесь	бу´фэрная ме´шанка 
буферное состояние	бу´фэрны стан 
буферный раствор	бу´фэрны ро´шчын, раство´р 
бухарник (Holcus)	смаргане´ц 
варьирование признаков	варыя´цыя азна´к, адме´на азна´к 
василек (Centaurea Суаnus)	васілё´к, вало´шка 
ваточник (Asclepias syriaca)	ва´тачнік 
вегетационный аппарат	вэгетацы´йны апара´т 
вегетационный домик	вэгетацы´йная ха´тка, вэгетацы´йны павільё´н 
вегетационный опыт	вэгетацы´йны до´сьлед 
вегетационный период	вэгетацы´йны пэры´ёд 
вегетационный сосуд	вэгетацы´йная судзі´на 
вегетационный фактор	вэгетацы´йны фа´ктар, чы´ньнік 
вегетация	вэгета´цыя 
вереск (Calluna vulgaris)	ве´рас звыча´йны 
верхний травяной ярус	ве´рхні травяны´ я´рус 
верховое прореживание	верхаво´е прарэ´джваньне 
верхушечный рост	верхаві´нны рост 
вес абсолютный	вага´ абсолю´тная 
вес об’емный	вага´ аб’ё´мная 
вес удельный	вага´ спэцыфі´чная 
весенняя вспашка	веснаво´е во´рыва 
весенняя обработка	веснавы´ вы´раб 
весовой процент	вагавы´ про´цант 
весы Реймона	ва´гі Рэ´йманавы 
ветвление растений	галінава´ньне расьл´ін 
ветка растений	галі´на, галі´нка расьлі´н 
вех ядовитый (Cicuta virosa)	цыку´та атру´тная 
веялка	а´рфа, ве´ялка 
веялка ручная	веялка ручна´я 
веялка-сортировка	а´рфа-сарто´ўка 
взмет	ара´ньне пе´ршае 
взрыхление почвы	пухкава´ньне гле´бы 
взрыхлитель	пухна´ч 
вивианит	вівіяні´т 
вид (б. т.) (Species)	від 
вика мохнатая (Vісіа villosa)	вы´ка махра´стая, лы´га махра´стая 
вика нарбонская (V. narbonensis)	вы´ка нарбо´нская, лы´га нарбо´нская 
вика озимая (V. villosa)	вы´ка-зімо´ўка, лы´га-зімо´ўка 
вика посевная (V. sativa)	вы´ка се´ўная, лы´га се´ўная 
виковая смесь	вы´кавая ме´шанка, лы´гавая ме´шанка 
винтовый плуг	шрубавы´ плуг 
вискозиметр	выскозымэ´тар 
влагалище листа	по´хва ліста´ 
влагоемкость почвы	вільгаё´мнасьць гле´бы 
влажность почвы	вільго´тнасьць 
внекорневое питание	пазакаранё´вае жыўле´ньне 
водная вытяжка	во´дны экстракт, во´дная выцяжка 
воднорастворимое вещество	воднараство´рная матэ´рыя 
водонагревающий аппарат	ваданаграва´льны апара´т 
водопод’емность почвы	вадапад’ё´мнасьць гле´бы 
водопроводность почвы	вадаправо´днасьць гле´бы 
водопроницаемость почвы	вадапраніка´льнасьць гле´бы 
водосточная борозда	вадасьце´чная баразна´ 
водоудерживающая способность	вадаўтрымоўчая здо´льнасьць 
возбудитель роста	узбу´джальнік ро´сту 
возделываемый слой	вырабны´ пласт гле´бы 
возделывание растений	гадава´ньне расьлі´н, культу´ра расьлі´н 
воздухоемкость почвы	паветраё´мнасьць гле´бы 
воздухопроницаемость почвы	паветрапраніка´льнасьць гле´бы 
воздушная культура	паве´траная культу´ра 
воздушно-сухая почва	паве´трана-суха´я гле´ба 
воздушно-сухое вещество	паве´трана-суха´я матэ´рыя 
возобновление пашни	аднаўле´ньне па´хаці 
возраст семян	узро´ст насе´ньня 
волокно	валакно´ 
волоколамский севооборот	волакала´мскі севазваро´т 
волокушка (борона)	смык 
волчьи бобы (Lupinus)	во´ўчы боб, лу´бін 
вольная система	во´льная сыстэ´ма 
ворсильная шишка (Dipsacus fullonum)	варсава´нка 
восстановление	аднаўле´ньне 
восстановление плодородия почвы	аднаўле´ньне ўрадлі´васьці гле´бы 
вредная примесь	шко´дная даме´шка 
время посева	пара´ сяўбы´ 
вскипание почвы	ускіпа´ньне гле´бы 
вспашка	узо´рваньне 
вспашка в развал	узо´рваньне ў ро´скідку 
вспашка в свал	узо´рваньне ў склад 
вспашка на зябь	узо´рваньне на´ зіму, зябле´ньне 
вспомогательное удобрение	дапамо´жнае ўгнае´ньне 
всходы	усхо´ды 
всхожесть семян	узыхо´днасьць насе´ньня 
вторичная вспашка	мяша´ньне, друго´е ўзо´рваньне 
выведение сортов	вывядзе´ньне гату´нкаў 
выветривание почвы	вывятрэ´ньне гле´бы 
выветривание почвы биологическое	вывятрэ´ньне гле´бы біёлёгі´чнае 
выветривание почвы механическое	вывятрэ´ньне гле´бы мэхані´чнае 
выветривание почвы органическое	вывятрэ´ньне гле´бы органі´чнае 
выветривание почвы химическое	вывятрэ´ньне гле´бы хэмічнае 
выводной клин	вывадны´ пале´так 
выгон	вы´ган 
выгонный севооборот	вы´ганны севазваро´т 
выгорание посевов	выгара´ньне засе´ваў 
вылегание посевов	выляга´ньне засе´ваў 
вымерзание посевов	вымярза´ньне засе´ваў 
вымочка посевов	вымака´ньне засе´ваў 
вымывание гумозных коллоидов	вымыва´ньне гумо´зных (перагно´йных) калё´ідаў 
вымывание почвенных коллоидов	вымыва´ньне гле´бавых калё´ідаў 
выпадение растений	выпа´дваньне расьлі´н 
выпревание растений	выправа´ньне расьлі´н 
выравнивание посевов	выро´ўніваньне засе´ваў 
высадка	вы´садка 
высевание	вы´сеў, высява´ньне 
высевающий аппарат	высяўны´ апара´т 
высевающий аппарат катушечный	высяўны´ апара´т шпу´лечны 
высевающий аппарат мотыльковый	высяўны´ апара´т матылё´вы 
высевающий аппарат ячеистый	высяўны´ апара´т камо´рысты, камо´рачны 
высокостебельное растение	высокасьцябло´вая расьлі´на 
высушивание почвы	высу´шваньне гле´бы 
высыхание почвы	высыха´ньне гле´бы 
вытеснение почвы	выцясьне´ньне гле´бы 
выщелачивание почвы	вылужне´ньне гле´бы, выпало´скваньне гле´бы 
выход в трубку растений (фаза развития)	стрэлкава´ньне расьлі´н 
вьющееся растение	паво´йная расьлі´на 
вязка снопов	вяза´ньне снапо´ў 
вязкая почва	гру´зкая, вя´зкая гле´ба 
вязкость	гру´зкасьць, вя´зкасьць 
габитус растений	га´бітус расьлі´н 
газоизмеритель	газаме´р 
газообмен почвы	газапаме´н гле´бы 
газопроводность почвы	газаправо´днасьць гле´бы 
галофобное растение	галяфо´бная расьлі´на 
гамета	гамэ´та 
гашенная известь	га´шаная ва´пна 
гелиотропизм растений	гэ´ліятропі´зм расьлі´н 
гель	гель, згу´стак сту´дневы 
генетический горизонт	генэты´чны гарызо´нт, пазе´м 
географический посев	геаграфі´чны засе´ў 
география почв	геагра´фія гле´баў 
геотропизм растений	геатропі´зм расьлі´н 
гессенская муха (Cecidomya destructor)	ге´сэнская му´ха 
гетерозиготное растение	гетэразыго´тная расьлі´на 
гибрид	гібры´д, мяша´нец 
гигроскопичность почвы	гіграскопі´чнасьць гле´бы 
гидролиз	гідро´ліз 
гидролиз в почве	гідро´ліз у гле´бе 
гидролитическая кислотность	гідраліты´чная кісьлі´ннасьць 
гидротация	гідрата´цыя 
гидрофит	гідро´фіт 
гипсование почвы	гіпсава´ньне гле´бы 
главконитовый песок	гляўкані´тавы пясо´к 
глина	глі´на 
глинозем	гліназе´м 
глубина вспашки	глыбіня´ ўзо´рваньня 
глубина заделки семян	глыбіня´ запраўкі, заво´рваньня насе´ньня 
глубокоукореняющееся растение	глыбокаўкарэ´нлівая расьлі´на 
глыба	гру´да, глы´за 
глыбодроб	глызадро´б 
гнилостная бактерия	гні´льная бактэ´рыя 
гниль картофельная	гнілі´зна бульбяна´я, картопельная 
годность хозяйственная	прыда´тнасьць гаспада´рчая 
головня (Ustilago)	са´жа 
головня каменная	са´жа каме´нная 
гомозиготное растение	гомазыго´тная расьлі´на 
горечь люпина	го´ркасьць, гарката´ лубіну 
горицвет (Lychnis)	сьве´тнік 
горох (Pisum)	гаро´х 
горох восковой (P. sativum)	гаро´х васкавы´ 
горох зеленый (P. sativum)	гаро´х зялё´ны 
горох кормовой (P. sativum)	гаро´х кармо´вы 
горох мозговой (P. sativum)	гаро´х мазгавы´ 
горох огородный (P. sativum)	гаро´х гаро´дны 
горох полевой (P. arvense)	гаро´х палявы´ 
горох посевной (P. sativum)	гаро´х се´ўны 
горох сахарный (P. sativum)	гаро´х цукро´вы 
горох тычковый (P. sativum)	гаро´х тычко´вы 
горох штамбовый (P. sativum)	гаро´х штамбо´вы 
гороховый зерновик (Bruchus pisi)	зерняжэ´р гаро´хавы 
горошек двузерный	гаро´шак двузярнё´вы 
горошек душистый	гаро´шак паху´чы 
горошек заборный (Vicia sepium)	гаро´шак падпло´тны 
горошек мышиный (V. Cracca)	гаро´шак мышы´ны 
горошек серый	гаро´шак шэ´ры 
горошек узколистый (V. angustifolia)	гаро´шак вузкалі´сны 
горчица (Linapis, Brassica)	гарчы´ца 
горчица белая (L. alba)	гарчы´ца бе´лая 
горчица дикая (L. arvensis)	гарчы´ца дзі´кая 
горчица сарептская (В. juncea)	гарчы´ца сарэ´пцкая 
горчица черная (В. nigra)	гарчы´ца чо´рная 
грабли	гра´блі 
грабли конные	гра´блі ко´нныя 
гравитационная вода	гравітацы´йная вада´
гребневая культура	грабянё´вая культу´ра 
гречиха (Polygonum Fagopyrum)	грэ´чка 
гречиха вьюнок (P. Convolvulus)	грэ´чка-паво´й, грэ´чка паво´йная 
гречиха каемчатая (F. emarginatum)	грэ´чка кра´йкавая, шля´чная 
гречиха красильная (P. tinctorium)	грэ´чка фа´рбная 
гречиха крылатая	грэ´чка крыла´тая 
гречиха обыкновенная (F. esculentum)	грэ´чка звыча´йная 
гречиха сахалинская	грэ´чка сахалі´нская 
гречиха серебристая	грэ´чка срабры´стая 
гречиха татарская (F. tartaricum)	грэ´чка тата´рская 
гречишная болезнь	грача´ная хваро´ба 
гречневый крахмал	грэ´цкі крухма´л 
грибная гниль	гры´бная гнілі´зна 
грибная гниль клубней	гры´бная гнілі´зна бу´льбін 
грибная гниль корней	гры´бная гнілі´зна карэ´ньня 
грибница	гры´бніца, грыбня´ 
грибок плесневой	грыбо´к цьві´льны 
грибок уксусный	грыбо´к во´цатны 
грохот	драцяно´е рэ´шата 
групповая изменчивость	групава´я зьме´нлівасьць 
гряда	града´, ляха´ 
грядиль плуга	плу´жны ды´шаль 
грядка	гра´дка, ле´шка 
грядковая культура	гра´дкавая культу´ра 
гуано	гуа´но 
гумин	гу´мін 
гуминовая кислота	гу´мінавая кісьлі´на 
гуминовокислая известь	гумінавакі´слая ва´пна 
гумификация	гуміфіка´цыя 
гумозная почва	перагно´істая гле´ба 
гумус	перагно´й, гу´мус 
гумусовый порощок	перагно´йны (гу´мусавы) парашо´к 
гусеница гороховой совки	ву´сень гаро´хавага начніка 
гусеница капустной совки	ву´сень капу´снага начніка
гусеница корневой совки	ву´сень каранё´вага начніка
гусеница лугового мотылька	ву´сень лугаво´га, сенажатнага начніка 
гусеница совки	ву´сень начніка´ 
густота посадки	гушчыня´ паса´дкі 
густота посева	гушчыня´ засе´ву 
густота стояния растений	гушчыня´ стая´ньня расьлі´н 
дваение (вспашка)	мяша´ньне, двае´ньне 
двойной суперфосфат	падво´йны супэрфосфа´т 
двузернянка	двухзярнё´ўка 
двузубая мотыка	двухзу´бая маты´ка, капані´ца 
двупольное хозяйство	двухпо´льная гаспада´рка 
двуростость растений	двухро´стасьць расьлі´н 
двусторонний плуг	двухбако´вы плуг 
двухкальциевый фосфат	двухвапнё´вы фосфа´т 
деградация	дэграда´цыя 
дезинфекция	дэзынфэ´кцыя 
действие солей в почве	дзе´яньне со´ляў у гле´бе 
действие удобрений	дзе´яньне ўгнае´ньняў 
декада	дэка´да 
делянка	дзяля´нка 
денитрификация	дэнітрыфіка´цыя 
денитрифицирующие организмы	дэнітрыфікацы´йныя органі´змы 
дерн	дзірва´н, дзярно´ 
дерновой плуг	дзірва´нны плуг, дзярно´вы плуг 
дерновоподзолистая почва	дзірвановападзо´лістая гле´ба 
дернорез	дзірванарэ´з, дзернарэ´з 
дерносним	дзірваназды´м, перадплу´жнік 
десятина	дзесяці´на 
дефекационная грязь	дэфэкацы´йная гразь 
деформация пласта	дэформа´цыя пласта´, скі´бы 
деятельная почва	дзе´йная гле´ба 
джонсонова трава (Andropogon Sorghum)	джансо´нава трава´ 
джугара (Sorghum cernuum)	джуга´ра 
диалис почвенного раствора	дыя´ліз гле´бавага раство´ру, рошчыну 
диафаноскоп	дыяфанаско´п 
дивала однолетняя (Scleranthus annuus)	галадо´к аднагадо´вы 
дикая редька (Raphanus Raphanistrum)	сьвірэ´пка звыча´йная 
дисковая борона	тале´рачная барана´
дисперсность почвы	дыспэ´рснасьць гле´бы 
доброкачественность семян	добрая´каснасьць насе´ньня 
дождевой червь	дажджавы´ чарвя´к, дажджаві´к 
дозревание семян	дасьпява´ньне насе´ньня 
дозреть	дасьпе´ць 
долгоносик	сло´нік, шашо´лка 
долгосрочная залежь	доўгатэрміно´вая абло´га 
доминирующий признак	перава´жная азнака, прыме´та 
донник (Melilotus)	барку´н 
дополнительное удобрение	дадатко´вае ўгнае´ньне 
драпач	драпа´к, драпа´ч 
дренаж	дрэна´ж 
дренирование почвы	дрэнава´ньне гле´бы 
дробление почвы	драбле´ньне гле´бы 
дробный учет	дро´бнае ўлічэ´ньне 
дыня (Cucumis Melo)	ды´ня 
дыхание почвы	дыха´ньне гле´бы 
едкая известь	пяку´чая ва´пна
ежа сборная (Dactylis glomerata)	ку´пкаўка звыча´йная 
ежовка ((Triticum cornpactum)	е´жаўка 
емкость поглощения	ёмнасьць паглына´ньня 
естественная залежь	натура´льная абло´га 
естественная классификация	натура´льная клясыфіка´цыя 
естественное удобрение	натура´льнае ўгнае´ньне 
естественно-историческое условие	натура´льна-гістары´чныя ўмовы 
жатва	жніво´ 
жатвенная машина	жнівя´рная машы´на 
железобактерии	жалезабактэ´рыі 
железо закисное	жале´за падтле´ньнікавае 
железо окисное	жале´за тле´ньнікавае 
железо-пермутитовое удобрение	жале´за-пэрмуты´тавае ўгнае´ньне 
желтозем	жоўтазе´м 
живой cop	жыво´е сьмяцьцё´ 
жидкое удобрение	рэ´дкае, ва´дкае ўгнае´ньне 
жижа навозная	жыжка гнаё´вая 
жизнедеятельность почвы	жыцьцядзе´йнасьць гле´бы 
житняк(Triticum cristatum)	жытня´к 
жнейка	жнівя´рка 
жнейка лобогрейка	жнівя´рка-лобагрэ´йка 
жнейка сноповязалка	жнівя´рка-снопавя´зка 
жнивье	жні´вішча 
жнивье овсяное	жнівішча аўся´нае; аўся´нішча 
жнивье ржаное	жні´вішча жы´тняе; іржы´шча 
жнивье ячменное	жні´вішча ячнае; ячме´нішча 
заболачивание почвы	забало´чваньне гле´бы 
завядание растений	завяда´ньне расьлін 
завязь	плодаза´вязь, за´вязь 
загонная пахата(пахота)	ара´ньне ў заго´ны 
заготовка семян	загато´ўка насе´ньня 
заделка навоза	заво´рваньне, запра´ўка гно´ю 
заделка семян	заво´рваньне, запра´ўка насе´ньня 
задернение почвы	задзірване´ньне гле´бы 
зазубренность	шчарба´тасьць 
заиление лугов	загле´йваньне сенажа´ці 
закисание почвы	закісьле´ньне гле´бы 
закладка опыта	закла´дваньне до´сьледу 
закон гомологических рядов	зако´н гомалёгі´чных радо´ў 
закон калийного питания	зако´н калі´йнага жыўле´ньня 
закон максимума	зако´н ма´ксымуму 
закон минимума	зако´н мі´німуму 
закон убывающего плодородия	зако´н спада´льнай урадлі´васьці 
закон физиологического отношения	зако´н фізыялёгі´чных адно´сін 
закрепление азота в почве	замацава´ньне азо´ту ў гле´бе 
закрепление оврагов	замацава´ньне раво´ў, расто´каў 
закрепление песков	замацава´ньне пяско´ў 
залежная система	абло´жная сыстэ´ма 
залежное хозяйство	абло´жная гаспада´рка 
залежь (почвенная)	абло´га 
заливной луг	заліўны´ луг, по´плаў 
залужение	запуска´ньне пад сенажа´ць 
замачивание семян	замо´чваньне насе´ньня 
замерзание растений	замярза´ньне расьлі´н 
занятой пар	заня´ты папа´р 
заостренная ость	заво´страны асьцю´к 
западина	запа´дзіна 
запаздывание созревания	запо´зьніваньне пасьпява´ньня 
запал растений	прыпа´л расьлі´н 
запах семян	пах насе´ньня 
запахивание навоза	заво´рваньне гно´ю 
заплесневелое семя	цьвіло´е зе´рня, цьвіло´е насе´ньне 
запольный участок	пазапо´льны вуча´стак 
заражение почвы	заражэ´ньне гле´бы 
заразиха (Orobanche)	зара´за 
засев	за´сеўкі 
засоренность семян	засьме´чанасьць насе´ньня 
засыхание	засыха´ньне 
затенение растений	зацяне´ньне расьлі´н 
затхлые семена	за´тхлае насе´ньне 
захват посевов	прыхва´т засе´ваў 
защита растений	ахо´ва, абаро´на расьлі´н 
защитная полоса	ахо´ўная, абаро´нная паласа´ 
защитные коллоиды	абаро´нныя калё´іды 
зеленоглазка (Chlorops)	зялё´наво´чка 
зеленое удобрение	зялё´нае ўгнае´ньне 
зеленый пар	зялё´ны папа´р 
зелень	зеляні´на 
земледелие	земляро´бства 
земледелие общее	земляро´бства агу´льнае 
земледелие частное	земляро´бства спэцыя´льнае 
земледельческая машина	земляро´бская машы´на 
земляная блоха (Haltica vittula)	земляна´я блыха´ 
земляной клоп (Cassida nebulosa)	земляны´ клоп 
земляной орех (Arachis hypodaea)	земляны´ арэ´х, бульбяны´ вятро´ўнік 
зернистая структура	кру´пчастая структу´ра 
зернистый коллоид	зярні´сты калё´ід 
зерно	зе´рня, збо´жжа 
зерно бочковидное	зе´рня пука´тае 
зерно грубопленчатое	зе´рня грубапле´ўчастае 
зерно злакавых растений	зе´рня збажы´нных, травяны´х расьлін 
зерно крупное	зе´рня буйно´е 
зерно мелкое	зе´рня дро´бнае 
зерно морщинистое	зе´рня маршчы´ністае 
зерно остроконечное	зе´рня сьпіча´стае 
зерно угловатое	зе´рня вуглава´тае 
зерно хлорофильное	зе´рня хлёрафі´льнае 
зерно щуплое	зе´рня шчу´плае 
зерно ячменообразное	зе´рня ячме´ністае 
зерновая фабрика	збо´жжавая фа´брыка 
зерновик	зерняжэ´р 
зерновка	зярнё´ўка 
зерновой хлеб	збо´жжа 
зернохранилище	магазы´н 
зерноочистительный пункт	зерняачысны´ пункт 
зернышко	зе´рнятка 
злак	збажына´, трава´ 
злаки кислые	збажы´ны, тра´вы кі´слыя 
злаки колосовые	збажы´ны каласавы´я 
злаки кормовые	збажы´ны кармо´выя 
злаки корневищные	збажы´ны сьцябло´-карэ´нныя 
злаки кустовые	збажы´ны куставы´я 
злаки метельчатые	збажы´ны мяцё´лкавыя 
злаки сладкие	збажы´ны сало´дкія 
злаки хлебные	збажы´ны хле´бныя 
змейка (сортировка)	зьмяё´ўка 
зола	по´пел 
зольное вещество	по´пельная матэ´рыя 
зольные элементы	по´пельныя элемэ´нты 
зрелость семян	сьпе´ласьць насе´ньня 
зубец колосковой чешуи	зубе´ц каласко´вай лускі´
зубовой культиватор	зубавы´ культыва´тар 
зябра (Galeopsis speciosa)	зя´бер вялі´кі 
избирательная способность	выбіра´льная здо´льнасьць 
избыточное увлажнение	збы´тнае ўвільгатне´ньне 
известкование почвы	вапнава´ньне гле´бы 
известково-аммонийная селитра	вапняко´ва-амоні´йная сале´тра 
известковое молоко	вапня´нае малако´ 
известковые растения	вапня´ныя расьліны, вапналю´бы 
известь	ва´пна 
измельчение	здрабле´ньне 
изменчивость видов	зьме´нлівасьць ві´даў 
изменчивость растений	зьме´нлівасьць расьлін 
измерение	выме´рваньне 
изолирование	ізолява´ньне 
изолированное питание	ізолява´нае жыўленьне 
изоляция	ізоля´цыя 
израстание клубней	параста´ньне бу´льбін 
ил	глей 
илистая частица	гле´йкая ча´стка 
имбитационная вода	імбітацы´йная вада 
иммунитет	імунітэ´т 
инвентарь	інвэнта´р 
индивидуальность растений	індывідуа´льнасьць расьлін 
индивидуальный отбор	індыві´дуа´льны адбо´р 
индикатор	індыкатар 
инсектисид	інсэктысы´д 
интенсивность культуры	інтэнсы´ўнасьць культу´ры 
интенсивность роста	інтэнсы´ўнасьць ро´сту 
интенсивность хозяйства	інтэнсы´ўнасьць гаспада´ркі 
ионы водорода	іё´ны вадаро´ду 
ирригация	ірыга´цыя, абвадне´ньне 
искусственная залежь	шту´чная абло´га 
искусственная почва	шту´чная гле´ба 
искусственное затенение	шту´чнае зацяне´ньне 
искусственное удобрение	шту´чнае ўгнаеньне 
искусственный луг	шту´чная сенажа´ць 
испарение почвы	парава´ньне, выпа´раваньне гле´бы 
использование почвы	скарыста´ньне гле´бы 
испольщина	палаві´ншчына 
испытание семян	выпрабава´ньне насе´ньня 
исследование	дасьле´дваньне 
исследование семян	дасьле´дваньне насе´ньня 
исследование почвы	дасьле´дваньне гле´бы 
исследование удобрений	дасьле´дваньне ўгнае´ньняў 
иссу´шение почвы	высу´шваньне гле´бы 
истощение почвы	спусташэ´ньне гле´бы 
истребление сорняков	зьнішчэ´ньне пустазе´льля, сарні´н 
исходный материал	першпачатко´вы матар’я´л 
исчезновение	зьніка´ньне 
кабачки	кабачкі´
каинит	каіні´т 
кали-аппарат	ка´лі-апара´т 
калий	ка´лі 
калийная соль	калі´йная соль 
калимагнезиальное удобрение	ка´лімагнэзі´йнае ўгнае´ньне 
калипермутит	каліпэрмуты´т 
калипермутитовое удобрение	каліпэрмуты´тавае ўгнае´ньне 
калориметр	калёры´мэтар, цепламе´р 
калькоммон (удобрение) (17% N; 30% СаСОз)	калькамо´н 
кальций	ва´пень 
кальций-пермутит	ва´пень-пэрмуты´т 
каменистая почва	камяні´стая гле´ба 
каменная болезнь	каме´нная хваро´ба 
канареечник (Phalaris)	чаро´тніца 
кандирование семян	угно´йваньне насе´ньня 
капиллярная влага	капіля´рная ві´льгаць 
капиллярный электрометр	капіля´рны электро´мэтар 
капуста качанная	капу´ста кача´нная 
капуста листовая	капу´ста лістава´я 
капуста огородная (Brassica oleracea)	капу´ста гаро´дная 
капустная кила	капу´сная кіла´ 
капустник	капу´сьнік 
капустный долгоносик	капу´сны сло´нік 
каркас	карка´с 
карналит	карналі´т 
картофелекопатель	бульбакапа´лка 
картофелесажалка	бульбасаджа´лка 
картофелесобиратель	бульбазьбіра´лка 
картофель (Solanum tuberosum)	бу´льба, карто´пля 
картофель Альма	бу´льба А´льма 
картофель Апал	бу´льба Апа´л 
картофель Бове	бу´льба Бовэ´ 
картофель Вид	бу´льба Від 
картофель Вольтман	бу´льба Во´льтман, верабі´наўка 
картофель всегда хороший	бу´льба заўсё´ды до´брая 
картофель Гавронек	бу´льба Гаўро´нак 
картофель Жнич	бу´льба Зьніч 
картофель заводской	бу´льба брава´рка 
картофель кормовой	бу´льба кармо´вая 
картофель Крюгер	бу´льба Кру´гер 
картофель Меркер	бу´льба Мэ´ркер 
картофель народный	бу´льба наро´дная 
картофель пирожок	бу´льба піражо´к 
картофель ранний розовый	бу´льба ра´ньняя ружо´вая 
картофель Рудзинский	бу´льба Рудзінская 
картофель синий слон	бу´льба сі´ні слонь 
картофель скороспелка	бу´льба скорасьпе´лка 
картофель сладкий	бу´льба сало´дкая 
картофель снежинка	бу´льба сьняжы´нка 
картофель столовый	бу´льба стало´вая 
картофель урагвайский	бу´льба урагва´йская 
картофель Фуксинка	бу´льба Фуксы´нка 
картофель шестинедельный	бу´льба шасьцітыднё´вая 
картофель Элла	бу´льба Э´ля 
картофельная бацилла	бульбяна´я бацы´ла 
картофельная болезнь	бульбяна´я хваро´ба 
картофельная ботва	бульбя´нік, картапля´нік 
картофельная гниль	бульбяны´ гніле´ц 
картофельная парша	бульбяны´я шо´лудзі 
картофельный жучок	бульбяны´ жучо´к 
кастрация растений	кастра´цыя расьлі´н 
катион	катыён 
качество семян	я´касьць насе´ньня 
квадрат (рама для взятия проб. растений)	квадра´т 
квадратная посадка	квадра´тная паса´дка 
кварцевый песок	ква´рцавы пясо´к 
кислота	кісьлі´на 
кислота азотная	кісьлі´на азо´тная 
кислота апокреновая	кісьлі´на апокрэ´навая 
кислота кремневая	кісьлі´на сылі´цыевая 
кислота креновая	кісьлі´на крэ´навая 
кислота лимонная	кісьлі´на цытры´навая 
кислота серная	кісьлі´на сярча´ная 
кислота соляная	кісьлі´на саля´ная 
кислота угольная	кісьлі´на ву´гальная 
кислота уксусная	кісьлі´на во´цатная 
кислота фосфорная	кісьлі´на фо´сфарная 
кислотная вытяжка	кісьлі´нны экстра´кт 
кислотность почвы	кісьлі´ннасьць гле´бы 
кислый гумус	кі´слы гу´мус 
клас (б. т.)	кля´са 
классификация	клясыфіка´цыя 
клевер (Trifolium)	канюшы´на 
клевер альпийский (Т. alpestre)	канюшы´на альпі´йская 
клевер белый (Т. repens)	канюшы´на бе´лая; дзя´цельніца 
клевер бурый	канюшы´на бруна´тная, бу´рая 
клевер горный (Т. montanum)	канюшы´на гарава´я 
клевер желтый (Anthyllis wulneraria)	канюшы´на жо´ўтая 
клевер заячий (A. wulneraria)	канюшы´на за´йчая, зае´чая 
клевер инкарнатный (Т. incarnatum)	канюшы´на інкарна´тная 
клевер красный (Т. pratensis)	канюшы´на чырво´ная 
клевер паннонский (Т. pannonicum)	канюшы´на пано´нская 
клевер пашенный (Т. агwense)	ко´цікі 
клевер персидский (Т. resupinatum)	канюшы´на пэрсы´дзкая 
клевер полевой (Т. agrarium)	канюшы´на палява´я 
клевер пунцовый (Т. incarnatum)	канюшы´на пунцо´вая 
клевер шведский (Т. hybridum)	канюшы´на швэ´дзкая 
клеверная терка	канюшы´нная малата´рня, канюшы´нная це´рніца 
клеверный пар	канюшы´нны папа´р 
клеверный paк (Sclorotinia Trifoliorum)	канюшы´нны рак 
клевероутомление	канюшыназмо´ранасьць 
клетчатка	абало´ніна 
клещевина (Ricinus communis)	рыцы´ньнік 
клин полевой	пале´так 
клубень	бу´льбіна 
клубеньки	баро´даўкі, бу´льбінкі 
клубеньковые бактерии (Bacillus radicicola)	корнябаро´даўкавыя бактэ´рыі 
клубнеплоды	бульбінапло´ды 
коагуляция	коагуля´цыя 
коллективный опыт	калекты´ўны до´сьлед 
коллекционный питомник	калекцы´йны гадава´льнік 
коллекция	коле´кцыя 
коллоид	колёід 
коллоидальный раствор	колёіда´льны ро´шчын, раство´р 
коллоидное соединение	колё´іднае злучэ´ньне 
коллоидный анализ	колё´ідны ана´ліз 
колорадский жук (Doryphora decemlineata)	колёра´дзкі жук 
колориметр	колёры´мэтар, колераме´р 
колос	ко´лас 
колос граненый	ко´лас канто´вы 
колос двурядный	ко´лас двухра´дны 
колос квадратный	ко´лас квадра´тны 
колос ложный	ко´лас непраўдзі´вы 
колос ломкий	ко´лас кро´хкі 
колос плотный	ко´лас шчы´льны 
колос поникающий	ко´лас паніклі´вы 
колос простой	ко´лас про´сты 
колос рыхлый	ко´лас пу´хкі 
колос сложный	ко´лас склада´ны 
колос стоячий	ко´лас стая´чы 
колосовая чешуя	кало´сная луска´ 
колосожнейка	коласажнівя´рка 
колосок	каласо´к 
колосок многоцветковый	каласо´к многакра´сачны 
колосок одноцветковый	каласо´к аднакра´сачны 
колошение	выплыва´ньне, каласава´ньне 
кольраби	кольрабі 
комбайн	комбайн 
комбинация удобрений	камбіна´цыя ўгнае´ньняў 
комковатость почвы	грудкава´тасьць гле´бы 
комплекс почвенный	ко´мплекс гле´бавы 
комплексный посев	ко´мплексны засе´ў 
компоратор	компора´тар 
компост	кампо´ст 
компостирование	кампостава´ньне 
компостная куча	кампо´сная ку´ча 
компрессор	компрэсар 
конденсация	кондэнса´цыя, згушчэ´ньне 
конопля (Cannabis sativa)	кано´плі 
коноплянник	канапля´нішча 
контрактация	контракта´цыя 
контроль	кантроль, паве´рка 
контрольная станция	кантро´льная, паве´рачная ста´нцыя 
концентрированное удобрение	концэнтро´ванае ўгнае´ньне 
коренное улучшение	грунто´ўнае паляпшэ´ньне 
корень растений	ко´рань расьлі´н 
корешок	карэ´нчык 
кориандр (Coriandrum sativum)	коле´ндра 
корка почвенная	скары´нка гле´бавая 
кормовая площадь	кармо´вая плошча 
кормовая смесь	кармо´вая ме´шанка, трася´нка, тру´шанка 
кормовые травы	кармо´выя тра´вы 
корневая система	каранё´вая сыстэ´ма 
корневище	сьцябло´-ко´рань 
корневые волоски	каранё´выя валаскі´
корневые овощи	каранё´вая гаро´дніна 
корнеплод	корняпло´д 
корреляция	корэля´цыя 
косвенное удобрение	пасрэ´днае, узбо´чнае ўгнае´ньне 
косилка	каса´рка 
косовище	касьсё´ 
костер безостый (Bromus inermis)	гі´рса безасьцюко´вая 
костер полевой (В. arvensis)	гі´рса палява´я 
костер ржаной (В. secalinus)	гі´рса жы´тная 
костяная зола	касьцяны´ по´пел 
костяная мука	касьцяна´я мука´ 
костяная пыль	касьцяны´ пыл 
кочерыжка капустная	кача´н 
кочка	ку´піна 
кочкарник	ку´пнік 
кочкорез	куп’ярэ´з 
коэффициент изменчивости	коэфіцые´нт зьме´нлівасьці 
коэффициент транспирации	коэфіцые´нт трансьпіра´цыі 
крапива (Urtica Tourn)	крапіва´ 
красильные растения	фа´рбныя расьлі´ны 
краснозем	чырвоназе´м 
краткосрочная залежь	кароткатэрміно´вая абло´га 
крахмал	крухма´л 
крахмалистость	крухма´лістасьць 
крахмальное зерно	крухма´льна´е зе´рне, крухма´льныя га´лачкі 
крахмальный агар	крухма´льны ага´р 
кремнезем	крэмнязе´м 
крестоцветные растения	крыжацьве´тныя расьлі´ны 
кривая роста	крыва´я ро´сту 
кривая урожая	крыва´я ўраджаю 
кристаллизационная вода	крышталізацы´йная вада´ 
критическая влажность	крыты´чная вільго´тнасьць 
кровянное удобрение	крывя´ное ўгнае´ньне 
крокеровский картофельный ареометр	кро´кераўскі бульбяны´ арэо´мэтар 
кротовина	крато´віна 
круговорот азота	кругазваро´т азо´ту 
крупнозем	буйназе´м 
крупнозернистость	буйназярнё´васьць 
ксантофил	ксантафі´л 
ксерофитные растения	ксэрафітныя расьліны, сухалю´бы 
куколеотборник	кукалеадбо´рнік 
куколь (Agrostemma Githago)	куко´ль 
кукуруза (Zea Mays)	кіяхі´, кукуру´за 
кулевая солома	кулява´я сало´ма 
культиватор	гра´ца, культыва´тар 
кунжут (Sesamus orientalis)	кунжу´т 
куриное просо (Echinochloa Crusgalli)	бры´ца звыча´йная 
курчавость листьев	кучара´васьць лісьцяў 
кущение	кустава´ньне 
латерит	лятэры´т 
легкая почва	лё´гкая гле´ба 
ледяная корка	ледзяна´я скары´нка 
лейнакальк (80% CaCo3; 4% N)	ле´йнака´льк 
лейнасальпетер (26% N)	ле´йназальпэ´тар (лейнасалетра) 
леммермановский метод	ле´мэрманаўскі мэ´тад 
лемех	наро´г, ляме´ш 
лен (Linum usitatissimum)	лён 
лен ветвистый	лён галі´ністы 
лен долгунец	лён даўгуне´ц 
лен кудряш	лён кучара´вы 
лен новозеландский (Rhormium tenax)	лён новазэля´ндзкі 
ленточный посев	сту´жачны засе´ў 
лесная подстилка	лясны´ по´сьціл 
лёсс	лё´эс 
лессовидный суглинок	лёэсава´ты суглі´нак 
лизиметр	лізымэ´тар 
лисохвост (Alopecurus)	лісахво´ст 
листоблошки (Psyllidae)	лістаско´чкі 
листоед (Chrysomella)	лістажэ´р 
листоед хлебный (Lema melanopa)	лістажэ´р збо´жжавы 
листорасположение	лістаразьмяшчэ´ньне 
луг	луг 
луг суходольный	луг сухадо´льны; муро´г 
луговая почва	лугава´я гле´ба 
луговая трава	лугава´я трава´ 
лужок в поле, в огороде	або´рак, по´жанька 
лук (Allium Сера)	цыбу´ля 
лунка	я´мка 
лупулин	люпулі´н 
лущение почвы	лушчэ´ньне гле´бы 
лущильник	луска´ч, лужчы´льнік 
льнище	ільні´шча 
льноводство	ільня´рства 
льномялка	це´рніца, лама´ч, мя´ліца 
льняная трещетка	ільня´ная бражджотка 
льнянка (Linaria Juss)	зарні´ца 
льняное семя	ільня´нае насе´ньне, се´мя 
люпин (Lupinus)	лу´бін 
люпин белый (L. albus)	лу´бін бе´лы 
люпин желтый (L. luteus)	лу´бін жо´ўты 
люпин многолетний	лу´бін шматгадо´вы 
люпин синий (L. angustifolium)	лу´бін сі´ні 
лютик (Ranunculus)	казяле´ц 
люцерна (Medicago)	люцэ´рна 
люцерна голубая	люцэ´рна блакі´тная 
люцерна посевная (М. sativa)	люцэ´рна засе´ўная 
люцерна хмелевидная (М. lupulina)	люцэ´рна хмелява´тая 
мадия (Madia sativa)	ма´дыя 
мак (Papaver somniferum)	мак 
мальва (Malva)	ма´льва, праску´рнік 
манильская пенька	мані´льская пянька´ 
манник (Glyceria)	ма´ньнік 
маннит	мані´т 
марена красильная (Rubia tinctorum)	марэ´на фа´рбная 
маркер (с.-х. орудие)	ма´ркер, зна´чнік 
марь белая (Chenopodium album)	лебяда´ 
масличное растение	але´йная расьлі´на 
масличные семена	але´йнае се´мя 
масло горчичное	алей гарчы´чны 
масло конопляное	алей канапля´ны 
масло кунжутное	алей кунжу´тны 
масло льняное	але´й ільня´ны 
масло подсолнечное	але´й слане´чны 
масло рапсовое	але´й ра´псавы 
масло растительное	але´й расьлі´нны 
масса растительная	ма´са расьлі´нная 
массовой отбор	ма´савы адбо´р 
материнская порода	мацяры´нская паро´да 
материнский клубень	мацяры´нская бу´льбіна 
матроклиния	матраклі´нія 
мацерация	мацэра´цыя 
машинно-тракторная станция	машы´нна-тра´ктарная ста´нцыя 
медведка (Gryllotalpa vulgaris)	мядзьве´дзік звыча´йны, сяка´ч 
медный купорос	сі´ні ка´мень, медзяны´ купарва´с 
медоносное растение	мядо´вая расьлі´на 
межа	мяжа´ 
междоузлие	цэ´ўка 
междупарье	міжпапа´р’е 
междурядие	міжра´дзьдзе, міжрадко´ўе 
межник	узьме´жак, сьце´нка 
мел	мел; крэ´йда 
меласса	мэля´са 
мелкая заделка	плы´ткае заво´рваньне, плы´ткая запра´ўка 
мелкая пахота	плы´ткае во´рыва 
мелкое семя	дро´бнае насе´ньне 
мелкое хозяйство	дро´бная гаспада´рка 
мелкозем	дробназе´м 
мелкозернистая почва	крупкава´тая гле´ба 
меловой известняк	крэ´йдавы вапня´к, мелавы´ вапня´к 
менделирующий признак	мэндалява´льная азна´ка 
мергелевание почвы	маргелява´ньне гле´бы 
мергель	марге´ль 
мергельный песок	марге´льны пясо´к 
мертвый запас влаги	мё´ртвы запа´с ві´льгаці 
мертвый покров	мё´ртвае акры´цьце 
месторасположение делянок	разьмяшчэ´ньне дзяля´нак 
метелка	мяцё´лка 
метелка вверх идущими ветвями	мяцё´лка разга´тая 
метелка восходящая	мяцё´лка ўзыхо´дная 
метелка кустообразная	мяцё´лка кустападо´бная 
метелка одногривая	мяцё´лка аднагры´вая 
метелка пониклая	мяцё´лка пахі´лая 
метелка развесистая	мяцё´лка разло´жыстая 
метелка скученная или комовая	мяцё´лка камяко´вая 
метельчатый злак	мяцё´лкаватая збажына´ 
метлица (Apera spica venti)	мятла´ 
метод вегетационный	мэ´тад вэгетацы´йны 
метод водных культур	мэ´тад вадзяны´х культу´р 
метод изолированного питания	мэ´тад ізолява´нага жыўле´ньня 
метод комбинирования признаков	мэ´тад камбінава´ньня адзна´к, прыметаў 
метод лабораторный	мэ´тад ляборато´рны 
метод песчаных культур	мэ´тад пескавы´х культу´р 
метод полевой	мэ´тад палявы´ 
метод полосок	мэ´тад шнуро´ў 
метод разжижения	мэ´тад разрэ´джваньня 
механический состав	мэхані´чны склад 
микорица	мікары´дза 
микроб	мікро´б 
микроб нитратный	мікро´б сале´травы, нітра´тны 
микроорганизмы	мікраоргані´зм 
микрорельеф	мікрарэлье´ф 
минерализация почвы	мінэраліза´цыя гле´бы 
минеральная теория	мінэра´льная тэо´рыя 
минеральное удобрение	мінэра´льнае ўгнае´ньне 
митчерлиховский метод	мітчэ´рліхаўскі мэ´тад 
мицелий	міцэ´лі 
многолетник	многале´тнік 
многопольный севооборот	шматпо´льны севазваро´т 
могар (Panicum germanicum)	мага´р 
модификация	модыфіка´цыя, відазьме´на 
мокрая гниль (болезнь картофеля)	мо´края гнілі´зна 
мокрица (Sttellaria media)	макры´ца 
молотилка	малата´рня 
молочай (Euphorbia)	малача´й 
молочная зрелость	мало´чная сьпе´ласьць 
молочно-кислое брожение	малочнакісьлі´ннае брузава´ньне 
моль зерновая (Tinea granella)	моль зярнё´вая 
монолит	моналі´т 
монтановская селитра	манто´навая сале´тра 
морена	морэ´на 
морковь (Daucus Carota)	мо´рква, мо´ркаў 
морковь белая	мо´рква бе´лая 
морковь желтая	мо´рква жо´ўтая 
морковь зеленоголовая	мо´рква зялё´нагаловая 
морковь исполинская	мо´рква вялі´кая 
морковь коротель	мо´рква караце´лька 
морковь кормовая	мо´рква кармо´вая 
морозостойкость растений	марозатрыва´ласьць расьлі´н 
морфология почвы	морфолё´гія гле´бы 
морфология растений	морфолё´гія расьлі´н 
моторная вспашка	мато´рнае во´рыва 
моторная жатвенная машина	мато´рная жнівя´рная машы´на 
мотыга	маты´ка, капані´ца 
мотыжение	матыкава´ньне 
мотыльковые растения	стручко´выя расьлі´ны 
моховое болото	імша´ра 
моховой торф	мо´хавы торф 
мочевина	мачаві´на 
мочевинное удобрение	мачаві´ннае ўгнае´ньне 
мочевино-кали-фосфорное удобрение	мачаві´на-ка´лі-фо´сфарнае ўгнае´ньне 
моченец	мача´нец 
мочило	са´жалка, ко´панка 
мочка льна	мачэ´ньнё лё´ну, ільну 
мочка пеньки	мачэ´ньне пянькі´ 
мочки корневые	махра´чыкі каранё´выя 
мочковатый корень	махра´ты ко´рань 
мощность развития	пату´жнасьць разьвіцьця´ 
мутация	мута´цыя 
мучнистая роса	мучні´стая раса´ 
мучнистость семян	мучні´стасьць насе´ньня 
мучной жук	мучны´ жук 
мякина	мякі´на 
мялка	це´рніца, лама´ч, мя´ліца 
мясокостная мука	мясакасьця´ная мука´ 
набивка сосудов	набі´ўка, набіва´ньне судзі´н 
наблюдение	назіра´ньне, нагля´д 
набухание глины	набрыня´ньне, набра´класьць глі´ны 
набухание почвенных коллоидов	набрыня´ньне гле´бавых калё´ідаў 
набухание почвы	набрыня´ньне гле´бы 
набухание семян	набрыня´ньне насе´ньня 
навоз	гной 
навоз горячий	гной гара´чы 
навоз конский	гной ко´нскі 
навоз крупного рогатого скота	гной быдля´чы 
навоз овечий	гной аве´чы 
навоз перепрелый	гной перапрэ´лы 
навоз птичий	гной птушы´ны 
навоз свежий	гной сьве´жы 
навоз свиной	гной сьвіны´ 
навоз смешанный	гной мяша´ны 
навоз холодный	гной хало´дны 
навозная жижа	гнаё´вая жы´жка 
навозное удобрение	угнае´ньне 
навозоразбрасыватель	гнояраскіда´льнік 
навозохранилище	гно´ішча, гнаёўня 
нагревание почвы	награва´ньне гле´бы 
наклонная сортировка	нахі´льная сарто´ўка 
наклон решет	нахі´л рэ´шат 
накопление азота	намнажэ´ньне азо´ту 
накопление органических веществ	намнажэ´ньне органі´чнае матэ´рыі 
налет восковой	павало´ка васко´вая 
налет извести	павало´ка вапе´нная 
намачивание семян	намо´чваньне насе´ньня 
наследственность	спа´дчыннасьць 
насыпная культура	насыпна´я культу´ра 
насыщенность почвы	насы´чанасьць гле´бы 
насыщенный раствор	насы´чаны ро´шчын, раство´р 
натриевая селитра	на´травая сале´тра 
натронная известь	натро´нная ва´пна 
натура семян	нату´ра насе´ньня 
начало вегетации	пача´так ро´сту, вэгета´цыі 
начало цветения	пача´так красава´ньня 
невосприимчивость	няўспрыма´льнасьць 
негашенная известь	няга´шаная ва´пна 
недеятельная почва	нядзе´йная гле´ба 
недозрелость	недасьпе´ласьць 
недород	недаро´д 
незрелость	нясьпе´ласьць 
нейбауеровский метод	нэйба´ўэраўскі мэтад 
неистощимость	невычарпа´льнасьць 
нейтрализация	нэўтраліза´цыя 
некапилярная скважность	некапіля´рная зяўры´стасьць 
нематода корневая (Heterodera radicola)	немато´да каранё´вая 
нематода свекловичная (H. Schantii)	немато´да бура´чная 
немочь бледная	не´мач бле´дная 
ненасыщенность почвы	ненасы´чанасьць гле´бы 
непроницаемость почвы	непраніка´льнасьць гле´бы 
неравномерность посева	няроўнаме´рнасьць засе´ву 
неразбухающие семена	ненабрыня´льнае, ненабрака´льнае насе´ньне 
неудобная земля	няўдо´біца 
неустойчивость	нятрыва´ласьць 
нитрагин	нітрагі´на 
нитрат	нітра´т 
нитратный азот	нітра´тны азо´т 
нитрит	нітры´т 
нитритовый агар	нітры´тавы ага´р 
нитрификация	нітрыфіка´цыя 
нитробактерии	нітрабактэ´рыі 
нитрофоска I (17,5%N; 13%Р2О5; 22% СаО)	нітрафоска I 
нитрофоска II (15%N; 11%Р2О5; 26% СаО)	нітрафоска II 
нитрофоска III (16,5%N; 16,5% Р2О5; 20% СаО)	нітрафоска III 
нож плуга	раза´к, нож да плу´га 
норвежская селитра	нарвэ´ская сале´тра 
нормальный раствор	нарма´льны раство´р, ро´шчын 
норфольский севооборот	нарфо´льскі севазваро´т 
ночное золото	начно´е зо´лата 
нуклеин	нукле´іна 
нут (Cicer arietinum)	нут 
обеднение почвы	зьбядне´ньне гле´бы 
обеззараживание семян	дэзынфэ´кцыя насе´ньня 
обжигание извести	апа´льваньне ва´пны 
обкашивание	абко´шваньне 
облога	абло´га 
обновление луга	абнаўле´ньне сенажа´ці 
обогащение почвы	узбагачэ´ньне гле´бы 
оболочка зерна	абало´нка зе´рняці 
оборот пласта	абаро´чваньне, адваро´т скі´бы, пласта´ 
обработка почвы	апрацо´ўка, вы´раб гле´бы 
образец почвы	узо´р гле´бы 
образец семян	узо´р насе´ньня 
образование ортштейна	вытварэ´ньне ортштэ´йна 
образцовый раствор	узо´рны ро´шчын, раство´р 
общая кислотность	агу´льная кісьлі´ннасьць 
общее земледелие	агу´льнае земляро´бства 
об’емный вес	аб’ё´мная вага´ 
овес австралийский	авё´с аўстралі´йскі 
овес африканский (Avena byzantina)	авё´с афрыка´нскі 
овес венгерский (A. orientalis)	авё´с вэнге´рскі
овес восточный (A. orientalis)	авё´с усхо´дні 
овес голый (A. nuda)	авё´с го´лы 
овес дикий (A. fatlia)	авё´с дзі´кі, аўсю´к 
овес дуппавский	авё´с ду´паўскі 
овес желтый (A. flavescens)	авё´с жо´ўты 
овес заячий (A. pubescens)	авё´с за´йчы, зае´чы 
овес золотой дождь	авё´с залаты´ до´ждж 
овес канадский	авё´с кана´дзкі 
овес китайский (A. sat. chinesis)	авё´с кіта´йскі 
овес колокольчатый	авё´с званко´вы 
овес лейтевецкий	авё´с Лейтаве´цкі 
овес Лигово	авё´с Лі´гава 
овес луговой (A. pratensis)	авё´с лугавы´ 
овес метельчатый (A. sativa)	авё´с мяцё´лкавы 
овес обыкновенный (A. sativa)	авё´с звыча´йны 
овес одногривый (A. orientalis)	авё´с аднагры´вы 
овес Победа	авё´с Перамо´га 
овес пробштейнский	авё´с пробштэ´йнскі 
овес Пфлюг	авё´с Пфлюг 
овес раскидистый (A. diffusa)	авё´с раскі´дзісты 
овес Рихлик	авё´с Ры´хлік 
овес северянин	авё´с паўно´чнік 
овес татарский (A. nuda)	авё´с тата´рскі 
овес Теодозиу	авё´с Тэадо´зіум 
овес шатиловский	авё´с шаці´лаўскі 
овес шведский	авё´с швэ´дзкі 
овес щетинистый (A. strigosa)	авё´с шчэ´цісты 
овин	е´ўня, асе´ць 
овраг	роў 
овсяница красная (Festuca rubra)	муро´жніца чырво´ная 
овсяница луговая (F.pratensis)	муро´жніца сенажа´тная, лугава´я 
овсяница овечья (F. ovina)	муро´жніца аве´чая 
огневая система	агнява´я сыстэ´ма 
огородные семена	гаро´днае насе´ньне 
огрех	узрэ´х, агрэ´х 
огурец	гуро´к 
однодольные растения	адналісьце´невыя расьлі´ны 
однокальциевый фосфат	аднавапнё´вы фосфа´т 
однолетнее растение	аднагадо´вая расьлі´на 
одностороннее удобрение	аднабако´вае ўгнае´ньне 
однотипность	аднатыпо´васьць 
озимая вика (Vicia villosa)	лы´га-зімо´ўка, вы´ка-зімо´ўка 
озимая пшеница (Triticum vulgare aestivum)	пшані´ца-зімо´ўка 
озимая рожь (Secale сеreale hіbernum)	жы´та 
озимое растение	зі´мава´я расьлі´на 
озимый посев	зімавы´ засе´ў 
озимь	азі´міна 
окраска почвы	ахварбо´ўка гле´бы 
окраска почвы посредством бактерий	ахварбо´ўка гле´бы бактэ´рыямі 
окучивание	абсыпа´ньне, абво´рваньне 
окучник	абсы´пнік, ляшні´к 
оплодотворение растений	запладне´ньне расьлі´н 
оподзоленная почва	ападзо´леная гле´ба 
определитель	вызна´чнік, азна´чнік 
опрыскивание растений	абпы´рскваньне расьлі´н 
опрыскиватель	пы´рскаўка 
оптимальные условия	опты´мальныя ўмо´вы 
оптимум	о´птымум 
опыление	апылкава´ньне 
опыт	до´сьлед 
опыт вегетационный	до´сьлед вэгетацы´йны 
опыт лабораторный	до´сьлед ляборато´рны 
опыт лизиметрический	до´сьлед лізымэтры´чны 
опыт полевой	до´сьлед палявы´ 
опыт с севооборотом	до´сьлед з севазваро´там 
опытная станция	дасьле´дчая ста´нцыя 
опытное поле	дасьле´дчае поле 
опытное хозяйство	дасьле´дчая гаспада´рка 
оранжерея	аранжарэ´я 
орех земляной (Arachis hypodaea)	арэ´х земляны´ 
ореховатая структура	арэ´хаватая структу´ра 
ориентировочный опыт	орыентырава´льны до´сьлед 
орошение	абвадне´ньне 
ортзанд	ортза´нд 
осадки атмосферы	апа´дкі атмосфэ´ры 
осажденный фосфат	апа´лы, асе´лы фосфа´т 
освежение дернины	асьвяжэ´ньне дзірвані´ны 
осветление раствора	асьвятле´ньне ро´шчыну, раство´ру 
оседание почвы	асяда´ньне гле´бы, апада´ньне гле´бы 
осенняя обработка	во´сенскі, асе´ньні вы´раб 
осмос	о´смос 
осмотическое давление	осмоты´чны ціск 
осока (Carex)	асака´ 
осот (Cirsium)	асо´т 
ость гладкая	асьцю´к гла´дкі 
ость грубая	асьцю´к гру´бы 
ость коленчатая	асьцю´к кале´нчасты 
ость спирально-скрученная	асьцю´к сьпіра´льна-скру´чаны 
ость шероховатая	асьцю´к шурпа´ты 
осушение почвы	асушэ´ньне гле´бы 
осушительная борозда	асуша´льная, асу´швальная баразна´ 
отава	ата´ва 
отбор естественный	адбо´р натура´льны 
отбор семян	адбо´р насе´ньня 
отброс	адкі´дак 
отвал винтовой	адкладня´, палі´ца шру´бавая 
отвал культурный	адкладня´ культу´рная 
отвал цилиндрический	адкладня´ вальцо´вая, цыліндры´чная 
отдых почвы	адпачы´нак гле´бы 
отклонение	адхіле´ньне 
отложение	адклада´ньне, адкла´д 
отложение почвенных коллоидов	адкла´д, адкла´даньне гле´бавых калё´ідаў 
отмерзание	адмярза´ньне 
отмучивание	адкаламу´чваньне 
отмывка	адмы´ўка 
относительная влажность	адно´сная вільго´тнасьць 
отросток	адро´стак, па´сынак, па´растак 
оттаивание почвы	адтава´ньне гле´бы 
охвостье	паза´дкі, абме´цьце, аме´цьце 
охлаждение почвы	ахаладжэ´ньне гле´бы 
оценка почвы	ацэ´нка гле´бы 
очистка семян	ачы´стка насе´ньня 
ошибка опыта	памы´лка ў до´сьледзе 
пар (поле)	папа´р 
пар американский	папа´р амэрыка´нскі 
пар занятой	папа´р заняты´
пар зеленый	папа´р зялё´ны 
пар поздний	папа´р по´зьні 
пар пропашной	папа´р право´рачны, прапа´шны 
пар черный	папа´р чо´рны 
паразитные растения	чужае´дныя, паразы´тныя расьлі´ны 
параллельный опыт	парале´льны до´сьлед, роўнале´жны до´сьлед 
парижская зелень	пары´ская зе´лень 
парник	парні´к 
парниковая культура	парніко´вая культу´ра 
паровая молотилка	парава´я малата´рня 
паровое поле	папа´р 
паровые растения	папа´рныя расьлі´ны 
парша	шо´лудзі 
пасленовые растения	лі´сьнікавыя расьлі´ны 
пассивная кислотность	пасы´ўная кісьлі´ннасьць . 
пастбище	па´ша 
пастинак (Pastinaca sativa)	пастарна´к 
пахотный горизонт	во´рны пазе´м, ральлё´вы пазе´м 
пашня	ральля´, па´хань, во´рыва 
пелюшка	пялю´шка, кармо´вы гаро´х 
перевал	перава´л 
перегной	перагно´й 
перегнойное вещество	перагно´йная матэ´рыя 
передвижение	перасо´ўваньне 
перекрестное опыление	крыжаво´е апылкава´ньне 
переложная система	абло´гавая, абло´жная сыстэ´ма 
перемешивание почвы	пераме´шваньне гле´бы 
перерод	пераро´д 
перестой	перасто´й 
перетирание семян	пераціра´ньне насе´ньня 
переутомление почвы	пераўтамле´ньне, змо´ранасьць гле´бы 
переходный севооборот	перахо´дны севазваро´т 
период вегетации	пэры´ёд вэгета´цыі 
периодичность	пэрыёды´чнасьць 
пермутитовое удобрение	пэрмуты´тавае ўгнае´ньне 
пестрополье	стракатапо´льле 
песчаная почва	пяшча´ная гле´ба 
песчаный фильтр	пясо´чны фі´льтар 
пигмент	пігмэ´нт 
пикировка	піко´ўка 
пикнометр	пікно´мэтар 
питание растений	жыўле´ньне расьлін 
питательная смесь	пажы´ўная су´месь 
питательная среда	пажы´ўнае асяро´дзьдзе 
питательное вещество	пажы´ўная матэ´рыя 
питательный раствор	пажы´ўны ро´шчын, раство´р 
питательный режим	пажы´ўны рэжы´м 
планет	плянэ´т 
плантация	плянта´цыя 
пластичность растений	плясты´чнасьць расьлі´н 
пластовый клин	пластавы´ пале´так 
плевел льняной (Lolium linicola)	жы´цік ільняны´ 
плевел опьяняющий (L. tumulentum)	дурнап’я´н 
пленка	пле´нка 
пленчатость	пленкава´тасьць 
плодоношение	плодано´снасьць 
плодопеременный севооборот	плодапераме´нны севазваро´т 
плодородие почвы	урадлі´васьць гле´бы 
плодосмен	плодазьме´н 
плотнокустовый злак	шчыльнакустава´я збажы´на 
плотность почвы	шчы´льнасьць гле´бы 
площадь кормовая	пло´шча кармо´вая 
площадь посевная	пло´шча засе´ўная 
плуг винтовой	плуг шру´бавы 
плуг колонистский	плуг калёні´цкі 
плуг крестьянский	плуг сяля´нскі 
плуг культурный	плуг культу´рны 
плуг многолемешный	плуг шматнаро´жны, шматляме´шны 
плуг моторный	плуг мато´рны 
плуг оборотный	плуг з адваро´там 
плуг передковый	плуг з перадко´м     
побурение листьев	пажо´ўкласьць лі´сьцяў 
поверхностное удобрение	паве´рхневае ўгнае´ньне 
поверхность почвы	паве´рхня гле´бы 
повилика (Cuscuta)	павіту´ха 
повилика американская (С. arvensis)	павіту´ха амэрыка´нская 
повилика венгерская (С. racemosa)	павіту´ха вэнге´рская 
повилика европейская (С. europaea)	павіту´ха эўрапэ´йская 
повилика клеверная (C.Trifolii)	павіту´ха канюшы´нная 
повилика льняная (С. epilimum)	павіту´ха лё´навая, і´льня´ная 
повреждение растений	ушкаджэ´ньне расьлі´н 
повторность опыта	паўто´рнасьць до´сьледу 
повышение урожаев	падвышэ´ньне ўраджа´яў 
поглотительная способность	паглына´льная здо´льнасьць 
поглощающая деятельность	паглына´льная дзе´йнасьць 
поглощающая сила почвы	паглына´льная сі´ла гле´бы 
поглощающий комплекс	паглына´льны ко´млекс 
поглощение	паглына´ньне 
погрешность опыта	хі´бнасьць до´сьледу 
подбор растений	падбо´р расьлі´н 
подвижность	руха´васьць 
подвяливание картофеля	падвя´льваньне бу´льбы 
подготовка почвы	падрыхто´ўка гле´бы 
подготовка семян	падрыхто´ўка насе´ньня 
поддерживание плодородия	паддзе´ржваньне, падтрымо´ўваньне ўрадлі´васьці 
подзол	падзо´л 
подзолистая почва	падзо´лавая гле´ба 
подзолистый тип	падзо´лавы тып 
подзолообразование	падзо´лавытварэ´ньне 
подковка	падко´ўка 
поднятие плодородия	падвышэ´ньне ўрадлі´васьці 
подорожник (Plantago)	трыпу´тнік, падаро´жнік 
подпахотный слой	падво´рыўны пласт; жыве´ц 
подпочва	падгле´б’е, гру´нт 
подпочвенная вода	падгле´бная вада´, грунтава´я вада´ 
подрезка	падрэ´зка 
подросток	падле´так 
подсев	падсе´ў 
подсевные культуры	падсе´ўныя культу´ры 
подсолнечник (Helianthus annuus)	со´нечнік, сланэ´чнік звыча´йны 
подсолнечник грызовой	со´нечнік лузга´льны, лушча´к 
подсолнечник масличный	со´нечнік але´йны 
подсолнечник панцырный(панцирный)	со´нечнік па´нцырны 
подстилка	по´дсьціл 
подсушивание	падсу´шваньне 
поемный луг	по´ймавая сенажа´ць, заліўна´я сенажа´ць 
пожнивная культура	пажні´ўная культу´ра 
пожнивные остатки	по´валач, по´зьбіркі 
пойменная почва	по´ймавая гле´ба, заліўна´я гле´ба 
показательный опыт	паказа´льны до´сьлед 
покров почвенный	акрыцьцё´ гле´бавае 
покровное растение	пакры´ўная расьлі´на 
покровный слой	пакрыўны´ пласт 
полба (Triticum Spelta)	по´лба 
полевая доска (в плуге)	бакаві´на 
полевица белая (Agrostis alba)	мятлі´ца бе´лая 
полеводство	палява´я гаспада´рка 
полевое травосеяние	палявы´ травасе´ў 
полевой клин	пале´так, зьме´на 
полевой опыт	палявы´ до´сьлед 
полевой участок	палява´я дзяля´нка 
полевой шпат	паляві´к, палявы´ шпат 
полегание растений	выляга´ньне расьлі´н 
полезная влага	кары´сная ві´льгаць 
ползучее растение	паўзу´чая расьлі´на 
поливка	паліва´ньне, палі´ўка 
полиморфизм	поліморфі´зм 
полная зрелость	по´ўная сьпе´ласьць 
полное удобрение	по´ўнае ўгнае´ньне 
полнозерность	поўназе´рнасьць 
полозок, пятка (в плуге)	палазо´к 
полупар	палупа´р 
полупрелый навоз	няўпрэ´лы гной 
полуторная окись	поўтаратле´ньнік 
поля орошения	палі´ абвадне´ньня 
помидор (Solanum Licopersicum)	памідо´р 
понижение плодородия	паніжэ´ньне ўрадлі´васьці 
популяция	популя´цыя, мешані´на сарто´ў 
порозность	сіткава´тасьць 
порошок торфа	тарфяны´ парашо´к 
посадка	саджэ´ньне, паса´дка 
посадка в грунт	саджэ´ньне ў грунт 
посадка в лунки	саджэ´ньне ў я´мкі 
посадочная машина	паса´дачная машы´на 
посадочный материал	паса´дачны матэр’я´л 
посев	сяўба´, засе´ў 
посев гнездовый	сяўба´ ў гне´зды 
посев двухстрочный	сяўба´ ў два радкі´
посев ленточный	сяўба´ ў сту´жкі 
посев машинный	сяўба´ машы´наю 
посев пятистрочный	сяўба´ ў пяць радко´ў 
посев разбросный	сяўба´ ў ро´скідку 
посев ручной	сяўба´ руко´ю 
посев рядовой	сяўба´ ў радкі´ 
посев смешанный	сяўба´ мяша´ная 
посев широкорядный	сяўба´ ў шыро´кія радкі´ 
посевной материал	засе´ўны матэр’я´л 
последействие удобрений	пасьлядзе´яньне ўгнае´ньняў 
постановка опытов	пастано´ўка до´сьледу 
посторонние семена	старо´ньняе насе´ньне 
поташ	пата´ш 
потенциометр	потэнцыё´мэтар 
потеря азота	стра´та азо´ту 
початок	кіё´ўка 
почва	гле´ба 
почва вересковая	гле´ба вераско´вая 
почва глинистая	гле´ба глі´ністая 
почва известковая	гле´ба вапні´стая 
почва лесовая	гле´ба лёэсавая 
почва перегнойная	гле´ба перагно´йная 
почва подзолистая	гле´ба падзо´льная 
почва рыхлая	гле´ба пу´хкая 
почва связная	гле´ба зьвя´зная 
почва суглинистая	гле´ба суглі´ністая 
почва супесчаная	гле´ба супяшча´ная 
почва торфяная	гле´ба тарфяна´я 
почва черноземная	гле´ба чарназе´мная 
почвенное брожение	гле´бавае брузава´ньне 
почвенный анализ	гле´бавы ана´ліз 
почвенный образец	гле´бавы ўзо´р 
почвенный перегной	гле´бавы перагно´й 
почвенный покров	гле´бавае акрыцьцё´, по´крыва 
почвенный профиль	гле´бавы про´філь 
почвенный разрез	гле´бавы разрэ´з 
почвенный слой	гле´бавы пласт 
почвенный термометр	гле´бавы тэрмо´мэтар 
почвоведение	глебазна´ўства 
почвообразование	глебавытварэ´ньне 
почвоуглубитель	глебапаглы´бнік 
почвоутомление	глебаўто´мленасьць, глебазмо´ранасьць 
почка верхушечная	пу´пышка верхаві´нная 
почкование	пупышкава´ньне 
предшественник (растение)	папярэ´днік 
прес почвенный	прас, сьціска´ч гле´бавы 
преципитат	прэцыпіта´т 
прививка	прышчэ´пка, прышчэ´пліваньне 
придаточные корни	дадатко´вае карэ´ньне 
признак варьирующий	варыяцы´йная, зьме´нлівая азна´ка 
прикатывание посевов	вальцава´ньне засе´ваў 
прилипаемость почвы	прыліпа´льнасьць гле´бы 
прирост	прыро´ст 
приспособляемость	прыстасава´льнасьць 
пристил навозом	прысьці´л гно´ем 
проба семян	про´ба насе´ньня 
пробная площадь	про´бная пло´шча 
пробный сноп	про´бны сноп 
проветривание почвы	праве´трываньне гле´бы 
проволочный сосуд с парафиновой покрышкой	драцяна´я судзі´на з парафі´навай на´крываткай 
продолжительность	праця´жнасьць, праця´г 
продукт выветривания	праду´кт выве´трываньня 
продукт гниения	праду´кт гніцьця´ 
продукт разложения	праду´кт распа´ду, раскла´ду 
продуктивность paстений	прадукцы´йнасьць расьлі´н 
производительность почвы	прадукцы´йнасьць гле´бы 
промежуточная культура	праме´жная культу´ра 
промежуточная обработка	праме´жная апрацо´ўка, праме´жны выраб 
промерзание	прамярза´ньне 
промышленный севооборот	прамысло´вы севазваро´т 
проницаемость почвы	праніка´льнасьць гле´бы 
пропашной пар	право´рыўны папа´р 
пропашные культуры	право´рыўныя, абсы´пныя культу´ры 
проращивание семян	праро´шчваньне насе´ньня 
прореживание растений	прарэ´джваньне раслі´н 
проростание семян	прараста´ньне насе´ньня 
просо (Panicum miliaceum)	про´са, пшано´ 
просо комовое (P. m. compactum)	про´са камяко´вае 
просо пониклое (P. m. contractum)	про´са пахі´лае 
просо развесистое (P. m. diffusum)	про´са разло´жыстае 
протравливание семян	пратру´чваньне насе´ньня 
прочность структуры	трыва´ласьць структу´ры 
пружинная борона	барана´-спружыно´ўка 
прядильное растение	прадзі´льная расьлі´на 
прямое удобрение	непасрэ´днае ўгнае´ньне 
пряное растение	пе´рная расьлі´на 
псевдоморфизм	псэўдаморфі´зм 
пудрэт	пудрэ´т 
пурка	пу´рка 
пустоцвет	пустацьве´т 
пустошь	пустэ´ча, пу´стка 
пушица (Eriophorum latifolium)	падве´й 
пшеница (Triticum vulgare)	пшані´ца звыча´йная 
пшеница английская (Т. turgidum)	пшані´ца анге´льская 
пшеница Арнаутка (Т. durum)	пшані´ца Арна´вутка 
пшеница Банатка	пшані´ца Бана´тка 
пшеница безостая	пшані´ца безасьцюко´вая 
пшеница белозерная	пшані´ца белазе´рная 
пшеница белоколосая	пшані´ца белакало´сая 
пшеница Белотурка (Т. durum)	пшані´ца Белату´рка 
пшеница Высоколитовская	пшані´ца Высокаліто´ўская 
пшеница Гарновка	пшані´ца Гарно´ўка 
пшеница генеологичеекая	пшані´ца генэалёгі´чная 
пшеница двузернятка (Т. dicoccum)	пшані´ца двухзярнё´ўка 
пшеница Ежовка (Т. cornpactum)	пшані´ца е´жаўка 
пшеница Карликовая (Т. compactum)	пшані´ца Каральцо´вая 
пшеница квадратноголовая	пшані´ца квадра´тагало´вая 
пшеница Костромка	пшані´ца Кастро´мка 
пшеница краснозерная	пшані´ца чырвоназе´рная 
пшеница красноколосая	пшані´ца чырвонакаласо´вая 
пшеница Кубанка (Т. durum)	пшані´ца Куба´нка 
пшеница мягкая (Т. vulgare)	пшані´ца мя´ккая 
пшеница однозернятка (Т. monococcum)	пшані´ца адназярнё´ўка 
пшеница озимая (Т. hibernum)	пшані´ца зімо´ўка 
пшеница остистая	пшані´ца асьцюко´вая 
пшеница Полтавка	пшані´ца Палта´ўка 
пшеница польская (Т. polonicum)	пшані´ца по´льская 
пшеница Пробштейнская	пшані´ца пробштэ´йнская 
пшеница Пулавка	пшані´ца Пула´ўка 
пшеница Русак	пшані´ца Руса´к 
пшеница Сандомирка	пшані´ца Сандамі´рка 
пшеница Черноуска	пшані´ца Чорнаву´ска 
пшеница яровая	пшані´ца я´рыца 
пылеватая почва	пылава´тая гле´ба 
пылевой гумус	пылавы´ перагно´й 
пыльная головня (Ustilago)	пы´лная са´жа 
пыльца растений	краса´, пыло´к расьлі´н 
пырей (Agropyrum)	пы´рнік 
пятипольный севооборот	пяціпалё´вы севазваро´т 
пятнистость листьев	пля´містасьць лі´сьцяў 
равномерность семян	роўнаме´рнасьць насе´ньня 
разбивка делянок	падзел на дзялянкі 
разбросная сеялка	раскідны´ сяўні´к, раскідна´я сявя´рка 
разбросной посев	засе´ў у ро´скідку 
развитие растений	разьвіцьцё´ расьлі´н 
раздробление почвы	раздрабле´ньне гле´бы 
раз’емная борозда	ро´скідзь, разо´ра 
размножение	размно´жваньне 
размножение бесполое	размно´жваньне бяспло´цьнае 
размножение вегетативное	размно´жваньне вэгетацы´йнае 
размножение половое	размно´жваньне пло´цьнае 
разновидность	адме´на, адме´ннасьць 
разработка	распрацо´ўка 
разрез	разрэ´з 
разрушение	разбурэ´ньне 
разрыв	пярэ´рва 
разрыхление	распухкава´ньне 
райграс английский (Lolium perenne)	жы´цік трыва´лы 
райграс итальянский (L. italicum)	жы´цік італья´нскі 
райграс французский (Arrhenatherum elatium)	аўся´нік высо´кі, францу´скі ра´йграс 
рапс (Brassica Napus oleifera)	рапс 
распад белков	распа´д бялко´ў 
распашка	разо´рваньне, узво´рка 
расположение делянок	разьмяшчэ´ньне дзяля´нак 
распределение удобрений	разьмеркава´ньне ўгнае´ньняў 
распыление почвы	распыле´ньне гле´бы 
рассада	раса´да 
рассадник	раса´днік 
раствор	ро´шчын, раство´р 
растворитель	рашчы´ньнік, раство´рнік 
растение	расьлі´на 
растениеводство	расьлінагадо´ўля, расьлінаво´дзтва 
растительность	расьлі´ннасьць 
растительный покров	расьлі´ннае акрыцьцё´, по´крыва 
расчистка (кустарника)	расьцяро´бка 
расщепление	рашчапле´ньне 
рациональная обработка	рацыяна´льная апрацо´ўка, рацыяна´льны вы´раб 
реакция почвы	рэа´кцыя гле´бы 
реакция среды	рэа´кцыя асяро´дзьдзя 
редукционное деление	рэдукцы´йны падзе´л 
редька дикая (Raphanus Raphanistrum)	рэ´дзька дзі´кая 
редька огородная (R. sativa)	рэ´дзька гаро´дная 
режим	рэжы´м 
результат опыта	вы´нік до´сьледу 
рекогнисцировочный посев	спро´бная сяўба´, спро´бны засе´ў 
рельеф почвы	рэлье´ф гле´бы 
ренания фосфат	рэна´нія-фосфа´т 
рендзина	рэндзі´на 
рентабельность удобрений	рэнта´бэльнасьць угнае´ньняў 
репа (Brassica Rapa)	рэ´па 
репа кормовая	рэ´па кармо´вая 
репа майская	рэ´па маё´вая 
репа огородная	рэ´па гаро´дная 
репродукция семян	рэпраду´кцыя насе´ньня 
рецессивный признак	рэцэсы´ўная прыме´та, азна´ка 
ржавчина хлебная	іржа´ збо´жжавая 
рига	гумно´ 
рис (Orysa sativa)	рыс 
рожь обыкновенная (Seсаlе cereale)	жы´та звыча´йнае 
рожь "Ваза"	жы´та "Ваза" 
рожь ветвистоколосая	жы´та галі´ністакало´сае 
рожь Загницкая	жы´та Загні´цкае 
рожь Звезда	жы´та "Зьвязда´" (Зорка) 
рожь Ивановская	жы´та Іва´наўскае 
рожь кустовая	жы´та кусто´ўка 
рожь Лоховская	жы´та Ло´хаўскае 
рожь местная	жы´та мясцо´вае 
рожь Немышлянская	жыта Нямышля´нскае 
рожь озимая (S. с. hibernum)	жы´та зімо´вае 
рожь Петкуская	жы´та Пэ´ткускае 
рожь Пробштейнская	жы´та Пробштэ´йнскае 
рожь Тулунская	жы´та Тулу´нскае 
рожь Шатиловская	жы´та Шаці´лаўскае 
рожь Шатская	жы´та Ша´цкае 
рожь Шланштедская	жы´та Шлянштэ´дзкае 
рожь яровая (S. с. aestivum)	жы´та я´рыца 
росток растений	па´растак расьлі´н 
рубление льна	сьцярэ´бліваньне лё´ну, ільну 
рубчик семян	ру´бчык насе´ньня 
рыжик масличный	рыжа´к але´йны 
рыжик посевной (Camelina sativa)	рыжа´к засе´ўны 
рытвіна	ры´цьвіна 
рыхлая почва	пу´хкая гле´ба 
рыхление почвы	пухкава´ньне гле´бы 
рыхлитель	пухка´ч 
рядовая сеялка	радко´вая сявя´рка 
рядовой посев	сяўба´ ў радкі´, засе´ў у радкі´
самозащита растений	самаабаро´на расьлі´н 
самоопыление	самаапылкава´ньне 
самосейка	самасе´йка 
саранча перелетная (Pachytylus migratorius)	шаранча´ пералё´тная 
сафлор (Carthamus tinctorius)	сафлё´р, крако´с 
сбережение влаги	захава´ньне ві´льгаці 
сбрасыватель	скіда´льні´к 
свекла арним-кривенская	буракі´ арнім-крыве´нскія 
свекла Вейбуля	буракі´ Вэ´йбуля 
свекла кормовая	буракі´ кармо´выя 
свекла маммут	буракі´ мамут 
свекла обендорфская	буракі´ о´бэндо´рфскія 
свекла огородная (Beta vulgaris)	буракі´ гаро´дныя 
свекла полусахарная	буракі´ напаўцукро´выя 
свекла сахарная	буракі´ цукро´выя 
свекла Сутон	буракі´ Суто´н 
свекла эккендорская	буракі´ экендо´рскія 
свеклокопатель	бура´чная капалка 
свеклоуборочная машина	бура´чная прыбіра´льная машы´на 
свеклоутомление	бура´чная змо´ранасьць 
свойство почвы	уласьці´васьць гле´бы 
связность почвы	зьвя´знасьць гле´бы 
севооборот	севазваро´т 
селекционная станция	сэлекцы´йная ста´нцыя 
селекция	сэле´кцыя 
селитра	сале´тра 
селитра норвежская	сале´тра нарвэ´ская 
селитра чилийская	сале´тра чылі´йская 
селитрообразование	салетравытварэ´ньне 
сельско-хозяйственная артель	сельска-гаспадарчая арце´ль 
сельско-хозяйственная годность	сельска-гаспадарчая прыда´тнасьць 
сельско-хозяйственная коммуна	сельска-гаспадарчая кому´на 
сельско-хозяйственное товарищество	сельска-гаспада´рчае тавары´ства 
семена	насеньне 
семенная станция	насе´нная ста´нцыя 
семенник	насе´ньнік, вы´садкі 
семенное хозяйство	насе´нная гаспада´рка 
семеноведение	насеньнезна´ўства 
семядоля	лісьце´нь, насе´нная ча´стка 
семяед (Аріоn)	насеньняжэ´р 
сеносушилка	сенасушы´лка, сенасу´шня 
сераделла (Ornithopus sativus)	сэрадэ´ля, птушано´жка 
серно-аммиачная соль	сярча´на-амонія´чная соль 
серп	серп 
сеялка (машына(машина))	сявя´рка 
сеялка комбинированная	сявя´рка комбінава´ная 
сеялка разбросная	сявя´рка раскідна´я 
сеялка ручная	сяўні´к, сяўня´ 
сеялка рядовая	сявя´рка радко´вая 
сжатие почвы	сьціска´ньне, сьціск гле´бы 
сидерационная система	сыдэрацы´йная сыстэ´ма 
сидерация	сыдэра´цыя, зялё´нае ўгнае´ньне 
силикат	сыліка´т 
силос	сіло´с, ква´шаны корм 
силосование	сілосава´ньне, заква´шваньне 
симбиоз	сымбіё´з, сужы´цьцё 
система	сыстэ´ма 
система вольная	сыстэ´ма во´льная 
система выгонная	сыстэ´ма выпасная 
система залежная	сыстэ´ма абло´жная 
система земледелия	сыстэ´ма земляро´бства 
система лесопольная	сыстэ´ма лесапо´льная 
система плодопеременная	сыстэ´ма плодазьме´нная 
система полеводства	сыстэ´ма паляво´е гаспада´ркі 
система хозяйства	сыстэ´ма гаспада´ркі 
систематика растений	сыстэма´тыка расьлі´н 
скарификатор	скарыфіка´тар, грацаўні´к 
скважность	зя´ўрыстасьць 
скелетная почва	шкіле´тная гле´ба 
склон	схіл 
скороспелость растений	скорасьпе´ласьць расьлі´н 
скорость проростания	ско´расьць прараста´ньня 
скрещивание	скрыжава´ньне 
слизевик (Limax agaestis)	смоўж, сьліма´к 
смесь посевная	ме´шанка се´ўная 
смешанный посев	мяша´ны засе´ў 
сноповязалка	снопавяза´лка 
советское хозяйство	саве´цкая гаспадарка; саўга´с 
совка-гамма (Plusia gammа)	ву´са-га´ма 
совка-озимая (Agrotis segetum Hülk)	начні´к азі´мінны 
совка-пшеничная (А. Тrіtici)	начні´к пшані´чны 
содовая почва	со´давая гле´ба 
созревание	высьпява´ньне 
сок растений	сок расьлі´н 
солевая ошибка индикаторов	салява´я памы´лка індыка´тараў 
соликамская соль	соліка´мская соль 
соломотряс	сало´матру´ска 
солонец	салане´ц 
солончак	саланча´к 
солончаковая флора	саланчако´вая флёра, расьлі´ннасьць 
соплодие	супло´дзьдзе 
сорго комовое (Sorghum contractum)	сорго´ ко´мавае 
сорго развесистое (S. effusum)	сорго´ разло´жыстае 
сорго сахарное (S. saccharatum)	сорго´ цукровае 
сорго черное S. (nigrum)	сорго´ чо´рнае 
сорная растительность	пустазе´льле 
сорные семена	пустазе´льнае насе´ньне 
сорт	сорт, гату´нак 
сортировка	сартава´ньне, сарто´ўка 
сортировочный стол	сартава´льны стол 
сортоиспытание	сортавыпрабава´ньне 
состав семян	склад насе´ньня 
сосуд вегетационный	судзі´на вэгетацы´йная 
сосуд четырехгранный	судзі´на чатырохканто´вая 
соха	саха´ 
сохранение семян	захава´ньне насе´ньня 
соцветие	сукве´цьце 
соцветие плотное	сукве´цьце шчы´льнае 
соцветие рыхлое	сукве´цьце пу´хкае 
соцветие Сошник	наро´г 
соя (Soja hyspida)	со´я 
спаржа	шпаржа´ 
спаржевое растение	шпаржо´вая расьлі´на 
спелость растений	сьпе´ласьць расьлі´н 
сплошной посев	суцэ´льная сяўба´, суцэ´льны засе´ў 
спора	заро´днік 
споровое растение	заро´днікавая расьлі´на 
спорынья (Claviceps purpurea)	ражо´к, ражкі´
спорыш (Polygonum aviculare)	драсё´н птушы´ны 
способ посева	спо´саб сяўбы´ 
способность прорастания	здо´льнасьць прараста´ньня 
среднее качество	сярэ´дняя я´касьць 
средний урожай	сярэ´дні ўраджа´й 
средняя всхожесть	сярэ´дняя ўзыхо´днасьць 
средняя проба	сярэ´дняя про´ба 
срок посева	тэ´рмін сяўбы´, пара´ сяўбы´ 
стадия спелости	ступе´нь сьпе´ласьці 
сталон	сталё´н, сьцябло´-ко´рань 
стандартный метод	штанда´ртны мэ´тад 
стассфуртская соль	шта´сфурцкая соль 
стационарное наблюдение	стацыяна´рнае назіра´ньне 
стебель	сьцябло´ 
стеблевание	сьцеблява´ньне 
стекловидность семян	шклаві´днасьць, шклі´стасьць насе´ньня 
стелющийся стебель	ні´цае сьцябло´, пазе´мнае сьцябло´ 
степь	стэп 
стержень	стрыжэ´нь 
стержневой корень	стрыжанё´вы ко´рань 
стерилизация семян	стэрыліза´цыя насе´ньня 
стерильность	стэры´льнасьць 
стернь	іржы´шча 
стимулянт	стымуля´нт 
стимуляция	стымуля´цыя 
стланец (лён)	лён-слане´ц 
строение корня	будо´ва ко´раня 
строение почвы	будо´ва гле´бы 
строение растения	будо´ва расьлі´ны 
структура почвы	структу´ра гле´бы 
субстрат	субстра´т 
суглинок	суглі´нак 
суммарны учет	сума´рнае ўлічэ´ньне 
суперфосфат	супэрфосфа´т 
супесь	су´песак 
сурепка (Brassica Rapa oleifera)	сьвірэ´пка 
суслик	сусла´к, су´сла 
сусловый агар	суславы´ ага´р 
суслон	ба´бка 
суспензия	суспэ´нзія 
суховей	сухаве´й 
суходол	сухадо´л 
сухое вещество	суха´я матэ´рыя 
сухое земледелие	сухо´е земляро´бства 
сухолюбивое растение	расьлі´на-сухалю´б 
сухость зерна	су´хасьць зе´рняці 
сушилка	су´шня 
сфагновое болото	сфа´гнавае бало´та, імша´ра 
схема опыта	схэ´ма до´сьледу 
сыпучий песок	сыпу´чы пясо´к 
табак обыкновенный (Nicotiana Tabacum)	туту´н звыча´йны 
твердые семена	цьвё´рдае насе´ньне 
теплица	цяплі´ца, цяпля´рня 
теплоемкость почвы	цеплаё´мнасьць гле´бы 
теплопроводность почвы	цеплаправо´днасьць гле´бы 
теребление льна	вырыва´ньне лё´ну 
терка картофельная	та´рка бульбяна´я 
терка клеверная	та´рка канюшы´нная 
терка свекловичная	та´рка бура´чная 
термостат	тэрмоста´т, сушы´льная ша´фа 
техника обработки	тэ´хніка апрацо´ўкі 
техника полеводства	тэ´хніка паляво´е гаспада´ркі 
техническое растение	тэхні´чная расьлі´на 
тимофеевка (Phleum pratense)	цімафе´йка 
тип зерна	тып зе´рняці 
тип зерна заостреный	тып зе´рняці сьпіча´сты
тип зерна лейтевицкий	тып зе´рняці лейтаве´цкі 
тип зерна местный	тып зе´рняці мясцо´вы 
тип зерна овальный	тып зе´рняці ова´льны 
тип зерна пробштейнский	тып зе´рняці Пробштэ´йнскі 
тип зерна ромбический	тып зе´рняці ромбі´чны 
тип зерна удлиненный	тып зе´рняці падо´ўжаны 
тип зерна шатиловский	тып зе´рняці шаці´лаўскі 
тип зерна шведский	тып зе´рняці швэ´дзкі 
тип зерна шиловидный	тып зе´рняці шылава´ты 
тип зерна элиптический	тып зе´рняці эліпты´чны 
тип зерна яйцевидный	тып зе´рняці яйцава´ты 
тип зерна ячменообразный	тып зе´рняці ячменява´ты 
тип почвы	тып гле´бы 
титровальная кислотность	тытрава´льная кісьлі´ннасьць 
тля растительная (Aphis)	тра´ўніца расьлі´нная 
тмин (Carum Carvi)	кмін 
тождественность условий	то´еснасьць умоў 
томасов шлак	тамашо´ўка 
томат (см. помидор)	тама´т 
тонкокожистость семян	тонкалушпі´ннасьць насе´ньня 
тонкость помола	то´нкасьць млі´ва 
топинанбур (Helianthus tuberosus)	топінанбур, со´нечнік бульбяны´ 
торф	торф 
торфование почвы	тарфава´ньне гле´бы 
торфообразование	торфавытварэ´ньне 
торфяная подстилка	тарфяны´ по´дсьціл 
точка роста	пункт ро´сту 
точность опыта	дакла´днасьць до´сьледу 
травопольная система	травапо´льная сыстэ´ма 
травосеяние	травасе´ў 
травяная смесь	травяна´я мешані´на 
трактор	тра´ктар 
тракторная вспашка	тра´ктарнае ўзо´рваньне 
тракторная колонна	тра´ктарная калёна 
тракторная молотьба	тра´ктарная малацьба´ 
тракторная обработка	тра´ктарная апрацо´ўка 
тракторная станция	тра´ктарная ста´нцыя 
тракторный плуг	тра´ктарны плуг 
транспирация растений	трансьпіра´цыя расьл´ін 
требовательность растений	вымага´льнасьць расьлі´н 
трепание льна, пеньки	трапа´ньне лё´ну, ільну´, пянькі´
трехкратная повторность	трайна´я, трохкро´тная паўто´рнасьць 
трехполье	трохпалё´ўка 
триер	трые´р 
трипс ржаной (Trips secalina)	трыпс жы´тні 
тук	тук 
тургесценция	тургесцэ´нцыя 
турнепс (Brassica Rapa rapifera)	турнэ´пс, рэ´па кармо´вая 
турнепс белый шестинедельный	турнэ´пс бе´лы шасьцітыднё´вы 
турнепс бортвельдский	турнэ´пс бо´ртфэльдзкі 
турнепс зеленый шестинедельный	турнэ´пс зялё´ны шасьцітыднё´вы 
турнепс Норфольк	турнэ´пс Норфо´льк 
тщательность опыта	акура´тнасьць, пі´льнасьць до´сьледу 
уборка урожая	прыбо´рка ўраджа´ю 
уборочная машина	прыбо´рачная машы´на 
увлажнение почвы	увільгатне´ньне гле´бы 
увядание растений	зьвяда´ньне расьлі´н 
углевод	вугляво´д 
углекислота почвы	вуглякісьлі´на гле´бы 
угловое травосеяние	вуглавы´ травасе´ў 
углубление пашни	паглыбле´ньне во´рыва 
угодье сельско-хозяйственное	ужытко´ўнасьць се´льска-гаспада´рчая, уго´дзьдзе 
удельный вес семян	адно´сная вага´ насе´ньня 
удобоусвояемое вещество	лёгкаспажыўна´я матэ´рыя 
удобрение	угнае´ньне 
удобрение азотистое	угнае´ньне азо´цістае 
удобрение зеленое	угнае´ньне зялё´нае 
удобрение известковое	угнае´ньне вапняко´вае 
удобрение калийное	угнае´ньне калі´йнае 
удобрение компостное	угнае´ньне компо´снае 
удобрение концентрированное	угнае´ньне канцэнтрава´нае 
удобрение косвенное	угнае´ньне ўзбо´чнае, пасрэ´днае 
удобрение неполное	угнае´ньне няпо´ўнае 
удобрение поверхностное	угнае´ньне паве´рхневае 
удобрение полное	угнае´ньне по´ўнае 
удобрение торфяное	угнае´ньне тарфяно´е 
удобрение фекальное	угнае´ньне фэка´льнае 
удобрение фосфорнокислое	угнае´ньне фосфарнакі´слае 
удобрительное средство	угно´йны сро´дак 
узел кущения	ву´зел кустава´ньня 
узловязатель	вузлавя´з 
укатыванье почвы	вальцава´ньне гле´бы 
укладка снопов	склада´ньне снапо´ў 
укоренение	укаране´ньне 
укосный клевер	касьбяна´я канюшы´на 
укрепление песков	умацава´ньне пяско´ў 
укроп (Anethum graveolens)	кроп 
улучшение лугов	паляпшэ´ньне луго´ў 
улучшение почвы	паляпшэ´ньне гле´бы 
улучшение семян	паляпшэ´ньне насе´ньня 
ульмин	ульмі´на 
ульминовая кислота	ульмі´навая кісьлі´на 
ультрамикроскоп	ультрамікраско´п 
ультрафильтр	ультрафі´льтар 
ультрафильтрация	ультрафільтра´цыя 
умолот хлеба	умало´т збо´жжа 
унаваживание	угно´йваньне 
универсальный плуг	унівэрса´льны плуг 
уплотненность почвы	зьле´гласьць гле´бы 
уплотненный севооборот	ушчы´льнены севазваро´т 
уравнительный посев	зраўна´льны засе´ў 
урожай	ураджа´й 
урожайность растений	ураджа´йнасьць расьлі´н 
усвоение	засвае´ньне 
усвояемость	засвая´льнасьць 
установка плуга, сеялки	настро´йка плу´га, сяўніка´ 
устойчивость	трыва´ласьць, стойкасьць 
устьице листа	праду´шынка лістава´я 
утилизация удобрений	утыліза´цыя, выкарыста´ньне ўгнае´ньняў 
уход за растениями	дагля´д расьлі´н 
учет урожая	падрахо´ўка, улічэ´ньне ўраджаю´(магчыма памылка ў націску)
учет урожая по обмолоту всей делянки	падрахо´ўка, улічэ´ньне ўраджаю´(магчыма памылка ў націску) паво´дле абмало´ту ўся´е дзяля´нкі 
учет урожая по пробному снопу	падрахо´ўка, улічэ´ньне ўраджаю´(магчыма памылка ў націску) паво´дле про´бнага снапа´ 
учетная площадь	уліча´льная пло´шча 
фактор роста	фа´ктар ро´сту, чы´ньнік ро´сту 
факультативное растение	факультаты´ўная расьлі´на 
фальсификация семян	фальсыфіка´цыя насе´ньня 
фаринотом	фарыното´м 
фасоль (Phaseolus vulgaris)	пасо´ля, фасо´ля 
фасоль кустовая	пасо´ля кусто´ўка 
фасоль тычковая	пасо´ля тычко´вая, падпо´рачная
фацелия	фацэ´лія 
фекальное удобрение	фэка´льнае ўгнае´ньне 
фенологическое наблюдение	фэнолёгі´чнае назіра´ньне 
фигурная вспашка	фігу´рнае во´рыва 
физиологическая спелость	фізыялёгі´чная сьпе´ласьць 
физиологическая сухость почвы	фізыялёгі´чная су´хасьць гле´бы 
физиология растений	фізыялё´гія расьлі´н 
физическая глина	фізы´чная глі´на 
физическое свойство	фізы´чная ўласьці´васьць 
фиксация азота	фікса´цыя азо´ту 
филогения	філёге´нія 
фильтрат	фільтра´т, працэ´дка 
фильтрация почвы	фільтра´цыя гле´бы 
фитогеография	фітагеагра´фія 
фитопатология	фітапаталё´гія 
фитофтора (Phythophthora infestans)	фітафто´ра 
флавиан	флавія´н 
флора местная	флё´ра мясцо´вая, расьлі´ннасьць мясцо´вая 
флористическое исследование	флёрысты´чнае дасьле´дваньне 
флюктуационная изменчивость	флюктуацы´йная зьме´нлівасьць 
флюктуация	флюктуа´цыя 
фосфоритная мука	фосфоры´тная мука´ 
фосфоритование почвы	фосфорытава´ньне гле´бы 
фосфорнокальциевая соль	фосфорнавапнё´вая соль 
фосфорнокислая известь	фосфорнакісьлі´нная ва´пна 
фосфорный ангидрид	фо´сфорны ангідры´д 
фотопериодизм	фотапэрыяды´зм 
фунгисид	фунгісы´д 
хвощ полевой (Equiseturn arvense)	хвошч палявы´ 
химико-биологический метод	хеміка-біёлёгічны мэ´тад 
химический анализ	хемі´чны ана´ліз 
хингидронный метод	хінгідро´нны мэ´тад 
хингидронный электрод	хінгідро´нны электро´д 
хлебная жужелица (Labrus gibbus)	збо´жжавы жу´жаль 
хлебная толстоножка (Eurytoma Hordei)	збо´жжавая тоўстано´жка 
хлебная фабрика	хле´бная фа´брыка 
хлебный гигант	хле´бны гігант 
хлебный жук (Anisoplia austriaca)	збо´жжавы жук 
хлебный пилильщик (Cephus pugmalus)	збо´жжавы пі´льнік 
хлевной навоз	хле´ўны гной 
хлопчатник (Gossipium)	баво´ўнік 
хлопьевидный каинит	клаччава´ты каіні´т 
хлораминовое удобрение	хлёрамі´навае ўгнае´ньне 
хлороз растений	хлёро´з расьлі´н 
хлорофил	хлёрафі´л 
хлорофильное зерно	хлёрафі´льнае зе´рня 
хмелевидная люцерна	люцэ´рна хмелява´тая 
хмель (Humulus Lupulus)	хмель 
хозяйственная годность	гаспада´рчая прыда´тнасьць 
хозяйственная зрелость	гаспада´рчая сьпе´ласьць 
хозяйство	гаспада´рка 
хозяйство безнавозное	гаспада´рка бязгно´йная 
хозяйство интенсивное	гаспада´рка інтэнсы´ўная 
хозяйство коллективное	гаспада´рка калекты´ўная, калгас 
хозяйство крестьянское	гаспада´рка сяля´нская 
хозяйство поселковое	гаспада´рка пасё´лачная 
хозяйство пригородное	гаспада´рка прыгаро´дная 
хозяйство советское	гаспада´рка саве´цкая; саўга´с 
хозяйство хуторское	гаспада´рка хутарска´я 
хозяйство экстенсивное	гаспада´рка экстэ´нсыўная 
холмистая поверхность	узго´рчастая паве´рхня 
холодильник	халадзі´льнік 
хранение зерна	хава´ньне зе´рня 
хранение клубнеплодов	хава´ньне бульбапло´даў 
хранение корнеплодов	хава´ньне корняпло´даў 
хранение навоза	хава´ньне гно´ю 
хромозома	хромазо´ма 
хрящеватая почва	жвірава´тая гле´ба 
цвет почвы	ко´лер гле´бы 
цветение садов	цьвіце´ньне садо´ў 
цветение хлебов	красава´ньне збо´жжа 
цветень	краса´ 
цветковое растение	кве´ткавая расьлі´на, кра´скавая расьлі´на 
цветная капуста	цьвятна´я капу´ста 
цветоед	кветкажэ´р, краскажэ´р 
цветок	кве´тка, кра´ска 
цветоножка	кветано´жка, краскано´жка 
цветоносный стебель	кветано´снае, краскано´снае, цьветано´снае сьцябло´ 
цветочная муха	кве´тачная, кра´сачная му´ха 
цветочная пыль	кве´тачны, кра´сачны пылок 
цветочная чешуя	кве´тачная, кра´сачная луска´ 
целина	цаліна´ 
целлюлеза	цэлюлё´за, абало´ніна 
целлюлёзо-разрушающие бактерии	цэлюлё´заразбура´льныя бактэ´рыі 
центрофуга Кайзера	цэнтрафу´га Ка´йзерава 
цеолит	цэалі´т 
цеп	цэ´п 
цепь	ланцу´г 
цикл развития	цыкль разьвіцьця´ 
цикорий (Cichorium Intybus)	цыко´рыя 
цилиндрическая сортировка	цыліндры´чная сарто´ўка 
циркуляция	цыркуля´цыя 
цитология	цыталё´гія 
частицы почвы	часьці´нкі, ча´стачкі гле´бы 
частичная уборка	часьці´нная прыбо´рка 
частное земледелие	спэцыя´льнае земляро´бства 
чередование растений	чаргава´ньне расьлі´н 
череззерница	церазьзе´рніца 
черезполосица	цераспало´сіца 
черенок	зрэз, зразо´к 
чернобыль (Artemisia vulgaris)	чарно´быль 
чернозем	чорназё´м 
чернушка (Nigella sativa)	чарну´шка 
черный пар	чо´рны папа´р 
чертополох (Carduus)	чортапало´х 
чеснок (Allium sativum)	часны´к 
четверик (мера)	чацьвяры´к, асьмі´на 
четверть (мера)	чацьвё´ртка, бо´чка 
четырехполье	чатыро´хпалё´ўка
чехлик корневой	каптуро´к каранё´вы 
чечевица (Lens esculenta)	сачэ´ўка, сачаві´ца 
чилийская селитра	чылі´йская сале´тра 
чина (угловой горох) (Lathyrus sativus)	гаро´шак се´ўны 
чина луговая (L. pratensis)	гаро´шак сенажа´тны 
число хромозом	лік хромазо´м 
число хромозом гаплоидное	лік хромазо´м гаплё´ідны 
число хромозом гексаплоидное	лік хромазо´м гэксаплёідны 
число хромозом диплоидное	лік хромазо´м дыплё´ідны 
число хромозом пентаплоидное	лік хромазо´м пэнтаплё´ідны 
число хромозом полиплоидное	лік хромазо´м поліплё´ідны 
число хромозом театраплоидное	лік хромазо´м тэтраплё´ідны 
число хромозом триплоидное	лік хромазо´м трыплё´ідны 
чистец болотный (Stachys palustris)	чы´сцік бало´тны 
чистосортность семян	чыстасо´ртнасьць, чыстагатунко´васьць насе´ньня 
чистота семян	чыстата´ насе´ньня 
чистотел (Chelidonium)	падты´ньнік, чо´ртава срэ´бра 
чистый посев	чы´сты засе´ў 
чувствительность растений	чу´ласьць расьлі´н 
шасталка	ша´сталка, адбіва´лка 
шатиловский сорт	шаці´лаўскі сорт, гату´нак 
шафран (Crocus sativus)	шафра´н 
шахматная посадка	саджэ´ньне ў ша´хматы 
шведская муха (Osanis Frit)	швэ´дзкая му´ха 
шведский клевер	швэ´дзкая канюшы´на 
швырялка (сортировка)	шу´галка 
шелуха	шалупі´ньне 
шестипольный севооборот	шасьціпалё´вы севазваро´т 
широколиственное paстение	шырокалі´стая расьлі´на 
шкала кислотности	шкала´ кісьлі´ннасьці 
шлак томасов	тамашо´ўка 
шнейдеровский метод	шнэ´йдараўскі мэ´тад 
шпалерная культура	шпале´рная культу´ра 
шпат полевой	паляві´к 
шпергель полевой, торица пашенная (Spergula arvensis)	сьвінакро´п палявы´, шпэ´ргаль 
шпинат (Spinacia oleraсеа)	шпіна´т 
штандартная делянка	штанда´рная дзяля´нка 
штифтовая молотилка	зубава´я, шты´фтавая малата´рня 
штыковка почвы	штыхава´ньне глебы 
щавель (Rumex)	шча´ўе, шчаве´ль 
щелкун (Elater)	кава´ль 
щелочная вытяжкапочвы	лу´жная вы´цяжка гле´бы 
щелочная почва	лу´жная гле´ба 
щелочная реакция	лу´жная рэа´кцыя 
щелочно-земельный металл	лужназяме´льны мэта´л 
щелочность почвы	лу´жнасьць гле´бы 
щелочный сульфат	лу´жны сульфа´т 
щелочный цеолит	лу´жны цэалі´т 
щелочь	луг 
щетинка зерна	шчацінка зе´рняці
щетинка основная	шчацінка асно´ўная 
щетинник (Setaria)	мяшэ´й 
щуп семенной	шны´пар насе´нны 
щуплое зерно	шчу´плае зе´рня 
щуплые семена	шчу´плае насе´ньне 
щучка (Deschampsia caespitosa)	вастры´ца дзірвано´вая 
эвапорометр	эвапоро´мэтар 
экватационное деление	экватацы´йны падзе´л 
экология растений	эколё´гія расьлі´н 
экспедиционное изучение	экспэдыцы´йнае вывучэ´ньне 
экспедиционное обследование	экспэдыцы´йнае абсьле´дваньне 
эксплоатация почвы	эксплёата´цыя гле´бы 
экстенсивная культура	экстэнсы´ўная культу´ра 
экстенсивная система	экстэнсы´ўная сыстэ´ма 
экстирпатор	экстырпа´тар 
элеватор	элева´тар 
электрод водородный	электро´д вадаро´дны 
электрод каломельный	электро´д калё´мэльны 
электрод хингидронный	электро´д хінгідро´нны 
электрокультура	электракульту´ра 
электролит	электро´літ 
электрометрический метод	электрамэтры´чны мэ´тад 
электропроводность	электраправо´днасьць 
электротитрование	электратытрава´ньне 
эммульсия	эму´льсія 
эндосперм	эндаспэ´рм 
энергия всхожести	энэ´ргія ўзыхо´днасьці 
энергия колошения	энэ´ргія каласава´ньня 
энергия кущения	энэ´ргія кустава´ньня 
энергия проростания	энэ´ргія прараста´ньня 
энергия роста	энэ´ргія ро´сту 
энзима	энзы´ма 
эпидермис	эпідэ´рміс 
эспарцет (Onobrychis Tourn)	эспарцэ´та 
этикетка	этыке´тка 
этиолирование	этыёлява´ньне 
эфирное масло	э´тарны але´й 
эффект удобрений	эфэ´кт угнае´ньня 
южная культура	паўднёвая культу´ра 
южный склон	паўднё´вы схіл 
юнкерсовский аппарат для нагревания воды	ю´нкерсаў апара´т награва´ць ваду´ 
яд растительный	яд расьлі´нны 
ядовитость растений	ядаві´тасьць расьлі´н 
ядро клеточное	ядро´ камо´рачнае 
язвенник (Anthyllis Vulneraria)	пералё´т, пералё´тнік жо´ўты 
язычек листовой пластинки	язычо´к ліставо´га пластка´ 
язычек листовой пластинки закругленный	язычо´к ліставо´га пластка´ закру´глены 
язычек листовой пластинки короткий	язычо´к ліставо´га пластка´ каро´ткі 
язычек листовой пластинки острозубчатый	язычо´к ліставо´га пластка´ востразу´бчасты 
язычек листовой пластинки равноусеченный	язычо´к ліставо´га пластка´ роўназрэ´заны 
язычек листовой пластинки тупоусеченный	язычо´к ліставо´га пластка´ тупазрэ´заны 
язычек листовой пластинки яйцевидный	язычо´к ліставо´га пластка´ яйкава´ты 
язычковый цветок	язычко´вая кве´тка, кра´ска 
яма навозная	я´ма гнаё´вая 
яровая пшеница	пшані´ца-я´рыца 
яровая рожь	жы´та-я´рыца 
яровой посев	ярава´я сяўба´, яравы´ засе´ў 
яровые растения	яравы´я расьлі´ны 
ярославский севооборот	ярасла´ўскі севазваро´т 
ярус травостоя	я´рус травасто´ю 
ярутка полевая (Thlaspi arve´nse)	то´рбачнік палявы´ 
ясколка (Cerastium)	рагаві´нка 
яснотка (Lamium)	ясно´тка 
ячменная тля (Aphis hordei)	ячме´нная тра´ўніца 
ячмень (Hordeum)	ячме´нь 
ячмень Богемия	ячме´нь Богэ´мія 
ячмень безостый	ячме´нь безасьцюко´вы 
ячмень Браге	ячме´нь Бра´ге 
ячмень Брио	ячме´нь Бры´ё 
ячмень веерный (H. Leocrithum)	ячме´нь ве´ерны 
ячмень гималайский	ячме´нь гімаля´йскі 
ячмень голый (Н. соеlestre)	ячме´нь го´лы 
ячмень гривоподобный (Н. jubatum)	ячме´нь грыва´сты 
ячмень двурядный (Н. distichum)	ячме´нь двухра´дны 
ячмень золотой	ячме´нь залаты´ 
ячмень кофейный (Н. d. nudum)	ячме´нь каво´вы 
ячмень "Лебединая шея"	ячме´нь "Лебядзі´ная шы´я" 
ячмень местный	ячме´нь мясцо´вы 
ячмень небесный (Н. coeleste)	ячме´нь нябе´скі 
ячмень обыкновенный (Н. vulgare)	ячме´нь звыча´йны 
ячмень озимый	ячме´нь зімо´вы 
ячмень пивоваренный	ячме´нь бро´варны 
ячмень плотноколосый	ячме´нь шчытнакало´сы 
ячмень Пробштейнский	ячме´нь Пробштэ´йнскі 
ячмень ржаной (H. secalinum)	ячме´нь жы´тні 
ячмень рыхлоколосый	ячме´нь пухкакало´сы 
ячмень солончаковый (Н. pratense)	ячме´нь саланчако´вы 
ячмень тонкопленчатый	ячме´нь тонкапле´нчасты 
ячмень трехрогий	ячме´нь трохро´гі 
ячмень четырехрядный (Н. hexastichum)	ячме´нь чатырохрадко´вы 
ячмень Чехословацкий	ячме´нь Чэхаслава´цкі 
ячмень шестирядный (Н. tetrastichum)	ячме´нь шасьцірадко´вы 
