##Title: Ваенны руска-беларускі слоўнік
##HTMLDescription_BEGIN
<div>
	<p class="dictdesc-st">Створана на падставе:</p>
	<p><b>Ваенны руска-беларускі слоўнік</b>. Менск: Інстытут мовазнаўства, 1933. (часткова)</p>
</div>
<div>
	<p class="spoiler">Укладальнікі</p>
	<p>Ваенна-Тэрміналагічная камісія: Старшыня камісіі Кобленц, Члены камісіі: Калента, Карвоўскі, Мацюкевіч, Пятроў, Юргілевіч, Якубовіч, Яноўскі і сакратар Саломенік.</p>
	<p> </p>
	<p>Адказны рэдактар Я. Мацюкевіч.</p>
	<p>Стыльрэдактар А. Саломенік.</p>
	<p>Тэхнічны рэдактар Ул. Сьвірыдаў.</p>
	<p>Адказны карэктар Я. Раманоўская.</p>
	<p> </p>
	<p>Здана ў друк 13/II 1933 г.</p>
	<p>Вышла з друку 25-VI 1933 г.</p>
</div>
<div>
	<p class="spoiler">Прадмова</p>
	<p>Ваенна-тэрміналёгічная камісія пры Інстытуце Мовазнаўства АН паставіла перад сабой задачу − даць байцу Чырвонай арміі, асабліва тэрытарыяльных часьцей, слоўнік спэцыяльна ваенных тэрмінаў на беларускай мове.</p>
	<p>Пры ўкладаньні слоўніка ваенна-тэрміналёгічная камісія выходзіла з наступных прынцыпаў: 1) даць у невялікім слоўніку максымум тых тэрмінаў, якія зараз укараняюцца ў арміі ў сувязі з насычэньнем яе новай тэхнікай, матарызацыяй і мэханізацыяй; 2) даць такі слоўнік, які быў-бы пазбаўлены архаізмаў, палёнізмаў, што імкнупіся ўкараняць у армію нацдэмы, выходзячы з клясавых буржуазна-рэстаўратарскіх тэндэнцый, сваім „Практычным беларускім вайсковым слоўнікам”. </p>
	<p>Магчыма, слоўнік мае рад недахопаў. Гэтыя недахопы могуць быць выяўлены і выпраўленьі толькі пры актыўнай дапамозе саміх байцоу Чырвонай арміі. Таму ваен.-тэрм. кам. зварачаецца да ўсіх байцоў Чырвонай арміі, якія будуць карыстацца слоўнікам, прысылаць у камісію свае заўвагі на слоўнік, каб у другім выданьні ўсе недахопы выправіць.</p>
	<p>Для ўкладаньня рускага тэксту слоўніка скарыстаны статуты і настаўленьні для часьцей Чырвонай арміі, а таксама „Военный немецко-русский словарь“ і „Польско-русский словарь” Дзяржаўнага слоўніка-энцыклёпэдычнага выдавецтва (Москва, ОГИЗ, РСФСР, 1931 г.).</p>
	<p> </p>
	<p>В.-Т. К.</p>
</div>
##HTMLDescription_END
##ArticleLang: ru/be

##Chapter: 1. Агульная частка
абсорпционная жидкость (хим.)	абсарпцы´йная ва´дкасьць
абсцисса 	абсцы´са
авангард	аванга´рд
авангардный 	аванга´рдны
аванпост	аванпо´ст
авария	ава´рыя
август	жні´вень
авиатор	авія´тар
авиационный парк	авіяцы´йны парк
авиация	авія´цыя
авиетка	авіе´тка
авиограмма	авіягра´ма
авиоматка(авиаматка) (морск. - судно, приспособленное для несения большого числа самолетов)	авіяма´тка
авиопарк(авиапарк)	авіяпа´рк
авиоплощадка(авиаплощадка)	авіяпляцо´ўка
авиосоединение(авиасоединение)	авіязлучэ´ньне
авиочасть(авиачасть)	авіяча´сьць
аврал (морск. - общая работа на корабле, в которой принимае участие вся команда)	аўра´л
автол	аўто´л
автомат	аўтама´т
автоматизм	аўтаматы´зм
автоматический	аўтаматы´чны
автоматчик	аўтама´тчык
автомобиль	аўтамабі´ль
автомобильная колонная	аўтамабі´льная калё´на
автомобильное имущество	аўтамабі´льная маё´масьць
автомобильный транспорт	аўтамабі´льны тра´нспорт
автопереброска	аўтаперакі´дка
агент	агэ´нт
агентурная разведка	агэнту´рная выве´дка
агитавтомобиль	агітаўтамабі´ль
агитатор	агіта´тар
агитационно-пропагандистский	агітацы´йна-прапаганды´сцкі
агитация	агіта´цыя
агитировать	агітава´ць
агиткомпания	агіткампа´нія
агитповозка	агітпаво´зка
агитпункт	агітпу´нкт
агитснаряд	агітзнара´д
агитсуд	агітсу´д
агрегат	агрэга´т
агрессивный	агрэсы´ўны
адамсит (хим.)	адамсы´т
административный	адміністрацы´йны
администрация	адміністра´цыя
адрес	а´драс
ад'ютант	ад'юта´нт
азид свинца (хим.)	а´зід сьвінца´
азимут	а´зымут
азот (хим.)	азо´т
азотная кислота (хим.)	азо´тная кіслата´
азотный (хим.)	азо´тны
аккумулятор	акумуля´тар
акселератор (мал.танк.)	аксэлера´тар
актив	акты´ў
активированный уголь	актывізава´ны ву´галь
активист	актыві´ст
активная оборона	акты´ўная абаро´на
активный заряд	акты´ўны зара´д
актинический	актыні´чны
акустика	аку´стыка
акустический пеленгатор	акусты´чны пеленга´тар
акустический прибор	акусты´чны прыбо´р
алидада	аліда´да
алидада-высотомер	аліда´да-вышыняме´р
аллея	але´я
аллюминий	алюмі´ній
аллюр	алю´р
альвейер (ав.)	альвэ´ер
альтиметр	альтымэ´тр
альфа-гумин	а´льфа-гумі´н
амбразура	амбразу´ра
амбулатория	амбулято´рыя
аммиак (хим.)	амія´к
аммонийная селитра	амані´йная сялі´тра
амортизатор	амартыза´тар
амортизация	амартыза´цыя
ампер	ампэ´р
амперметр	ампэрмэ´тр
амплитуда	ампліту´да
ампула	а´мпула
амуниция	амуні´цыя
амуничивать	амуні´чваць
амуничник	амуні´чнік
амуничный	амуні´чны
ангар	анга´р
анемометр	анэмо´мэтр
анемометрическое обследование	анэмомэтры´чнае абсьле´даваньне
анилин	анілі´н
аннексия	анэ´ксія
аннулировать	анулява´ць
антабка(стр.)	анта´бка
антагонизм	антагані´зм
антена(антенна) (связь)	антэ´на
антииндуктор (св.)	антыінду´ктар
аппарат (св.)	апара´т
аппаратный	апара´тны
аппарель (в.-инж)	апарэ´ль
апрель	красаві´к
аптека	аптэ´ка
аптекарский	аптэ´карскі
арбитр	арбі´тр
аргумент	аргумэ´нт
ареометр	арэо´мэтр
арест	а´рышт
арестованный	арыштава´ны
арка	а´рка
аркан	арка´н
арматура	армату´ра
арматурный список	армату´рны сьпі´сак
армия	а´рмія
арсенал	арсэна´л
арсины (хим.)	арсі´ны
артезианский	артэзыя´нскі
артиллерия	артыле´рыя
артиллерия полковая	артыле´рыя палкава´я
артиллерия резерва Главного командования (АРГК)	артыле´рыя рэзэ´рву Гало´ўнага Кама´ндаваньня (АРГК)
артиллерийская часть	артылеры´йская часьць
артиллерийская школа	артылеры´йская шко´ла
артиллерийский огонь	артылеры´йскі аго´нь
артиллерийский полигон	артылеры´йскі паліго´н
артиллерийское довольствие	артылеры´йскае забесьпячэ´ньне
артиллерист	артылеры´ст
артхимстрельба	а´ртхімстральба´
арьергард	ар'ерга´рд
арьергардный	ар'ерга´рдны
асбест	азбэ´ст
асбестовый	азбэ´ставы
ассигновка	асыгно´ўка
асфальтированная оболочка (подр.дело)	асфальтава´ная абало´нка
атака	ата´ка
атаковать	атакава´ць
атмосфера	атмасфэ´ра
атташе	аташэ´
аттестат	атэста´т
аттестация	атэста´цыя
аттестовать	атэстава´ць
аудитория	аўдыто´рыя
ахтер-люк (морск. - внутреннее помещение в кормовой части корабля для хранения провизии)	ахцё´р-лю´к
ацетон	ацэто´н
аэродром	аэрадро´м
аэрометеорологическая станция	а´эрамэтэаралёгі´чная ста´нцыя
аэроплан	аэрапля´н
аэробомба	аэрабо´мба
аэроснимок	аэразды´мак
аэростат	аэраста´т
аэростатика	аэраста´тыка
аэротермометр	аэратэрмо´мэтр
аэрофотолаборатория	аэрафо´талябарато´рыя
аэрофотос'емка	аэрафо´тазды´мка
аэрохимбомба	а´эрахімбо´мба
аэрохимический налет	а´эрахімі´чны налё´т
аэрохимприбор	а´эрахімпрыбо´р
баба (мост.дело)	ба´ба
бабашка (автомоб.)	баба´шка
багор (отпорный крюк)	баго´р
база	ба´за
базис	ба´зіс
базисный	ба´зісны
бак (морск. - носовая часть судна до фок-мачты)	бак
бакан (в.-инж.)	бака´н
балансир (тракт.)	балянсі´р
балка	ба´лька
балласт	баля´ст
балластный реостат	баля´ставы рэаста´т
баллистика	балі´стыка
баллистические данные	балісты´чныя да´ныя
баллистический	балісты´чны
баллон	балё´н
бандаж (авт.)	банда´ж
банка	ба´нка
банкет (в.-инж)	банке´т
банник (артил.)	ба´ньнік
банно-прачечный отряд	ла´зня-пра´чачны атра´д
барабан	бараба´н
барабанщик	бараба´ншчык
барак	бара´к
барашек (в двуколе)	бара´шак
барбет (артил.)	барбэ´т
баржа	ба´ржа
барка	ба´рка
баркас	барка´с
барометр	баро´мэтр
баррикада	барыка´да
барьер	бар'е´р
баталер (морск. - военмор, заведующий хозяйственно-снабженческой частью на корабле)	батале´р
батальон	батальё´н
батальонный	батальё´нны
батарейный Командирский пункт (БКП)	батарэ´йны Камандзі´рскі пункт (БКП)
батарея	батарэ´я
батометр (морск. - прибор для доставания воды из глубины)	батамэ´тр
башмак тормозный 	башма´к тармазны´
башня	ве´жа
бебут	бэбу´т
беглый огонь	бе´глы аго´нь
бегом	бяго´м
бегство	бе´гства
беженцы	бе´жанцы
безвредный	бясшко´дны
бездействие	бязьдзе´йства
бездорожие	бе´здараж
бездымный порох	бязды´мны по´рах
беззаветная преданность	беззаве´тная, самаахвя´рная адда´насьць
беззаконно	беззако´нна
безмоторное летание	безмато´рнае лята´ньне
базначалие	безнача´льле
безопасный	бясьпе´чны, безапа´сьлівы, неапа´сьлівы
безоружный	бяззбро´йны
безостановочно	бязупы´нна
безотказно	безадмо´ўна, бесьперабо´йна
без разделений	без падзяле´ньняў
безразличие	абыя´касьць
безудержный	няўтры´мны
безустали	няўто´мна,бязуто´мна
бесцветный	бескаляро´вы
белит (хим.)	бэлі´т
белогвардеец	белагвардзе´ец
белый фосфор (хим.)	бе´лы фо´сфар
бенгальский огонь	бэнга´льскі аго´нь
бензин	бэнзі´на
бензол	бэнзо´л
бензохранилище	бэнзаскла´д
бергштрих	бэргштры´х
береговая стража	берагава´я ва´рта
береговой лежень (в.-инж.)	берагавы´ ле´жань
берма (в.-инж.)	бэ´рма
бертолетовая соль	бертале´тавая соль
бесперебойно	бесьперабо´йна
беспокоющий	непако´ячы
беспрекословно	бессупярэ´чна
беспрепятственный доступ	бесьперашко´дны до´ступ
беспрестанно	бязупы´нна
беспримерно	бяспрыкла´дна
беспричинный	бяспрычы´нны
бессрочный отпуск	бестэрміно´вы во´дпуск
бесхозяйственность	безгаспада´рчасьць
бета-гумин	бэ´та-гумі´н
бетон	бэто´н
бетонировать	бэтанава´ць
бетонный	бэто´нны
библиотека	бібліятэ´ка
бивак	біва´к
бикфордов шнур (подр.дело)	бікфо´рдаў шнур
билет отпускной	біле´т адпускны´
билиндер (морск.)	білі´ндэр
бинокль призматический	біно´кль прызматы´чны
бинт	бінт
бинтовать	бінтава´ць
биплан (ав.)	біпля´н
бирка	бі´рка
биссектриса	бісэктры´са
битва	бі´тва
бить тревогу	біць трыво´гу
благодарить	дзя´каваць
благодарность	падзя´ка
благодарю	дзя´кую
благоприятно	спрыя´юча
блеск	бляск
ближайшая задача	бліжэ´йшая зада´ча
ближайший об'ект действий	бліжэ´йшы аб'е´кт дзе´йстваў
ближний бой	блі´зкі бой
блиндаж	блінда´ж
блокада	блёка´да
блокгауз	блёкга´уз
бобина (катушка высокого напряжения - трансформатор)	бабі´на (кату´шка высокага напру´жаньня - трансфарма´тар)
боевая единица	баява´я адзі´нка
боевая выучка	баява´я вы´вучка
боевая готовность	баява´я гато´ўнасьць
боевая концентрация	баява´я канцэнтра´цыя
боевая личинка (стр.)	баява´я лічы´нка
боевая обстановка	баява´я абстано´ўка
боевая пружина	баява´я спружы´на
боевая рубка (морск. - специальное бронирован.помещение (на судне) на мостике или вблизи его)	баява´я ру´бка
боевая щель	баява´я шчы´ліна
боевое испытание	баяво´е выпрабава´ньне
боевой взвод	баявы´ ўзвод
боевой выступ (стр.)	баявы´ вы´ступ
боевой гребень	баявы´ грэ´бень
боевой комплект	баявы´ кампле´кт
боевой конец (часть клинка)	баявы´ кане´ц
боевой патрон	баявы´ патро´н
боевой порядок	баявы´ пара´дак
боеприпас	бо´япрыпа´с
боевой темп	баявы´ тэмп
боевой участок	баявы´ вуча´стак
боевые действия	баявы´я дзе´йствы
боевые отравляющие вещества	баявы´я атру´тныя рэ´чывы
боек ударника	баё´к уда´рніка
боеприпасы	бо´япрыпа´сы
боеспособность	баяздо´льнасьць
боец	бае´ц
бой	бой
бойница (в.-инж.)	байні´ца
боковое охранение	бакаво´е ахава´ньне
боковой отряд	бакавы´ атра´д
боковой удар	бакавы´ ўда´р
болванка (арт.)	балва´нка
болт	болт
большой привал	вялі´кі прыва´л
бомба	бо´мба
бомбардировка	бамбардыро´ўка
бомбардировочная авиация	бамбардыро´вачная авія´цыя
бомбардировщик	бамбардыро´ўшчык
бомбовоз	бамбаво´з
бомбометание	бо´мбамята´ньне
бона (в.-инж.)	бо´на
борода (арт. - наз.части оруд.)	барада´
бородка (арт)	баро´дка)
борн (автом.)	борн
борт	борт
бортики обоймы	бо´рцікі або´ймы
борьба	барацьба´
боцман (морск.)	бо´цман
брандвахта (морск.)	бра´ндва´хта
бранденоид	брандэно´ід
брандер (морск.)	бра´ндэр
брандсбойт	брандзбо´йт
братание	брата´ньне
браунинг	бра´ўнінг
бревна	бярве´ньня
брезент	брызэ´нт
брезентовая накладка	брызэ´нтавая накла´дка
брейд-вымпель (морск.)	брэйд-вы´мпел
брекватер	брэква´тэр
брешь	брэш, прабо´іна
бригада	брыга´да
бризантный снаряд	брыза´нтны знара´д
брод	брод
брод-камера (морск. - специальное помещение на судне, в котором хранится провизия)	брод-ка´мера
бром (хим.)	бром
бромацетон (хим.)	бро´мацэто´н
бромбензил цианид (хим.)	бромбэнзі´л цыяні´д
бромистый бензил (хим.)	бро´місты бэнзі´л
броне-башня	бро´ня-ве´жа
бронебойная пуля	бранябо´йная ку´ля
бронебойный	бранябо´йны
броневая часть	бранява´я часьць
броневик	браняві´к
броне-поезд	броня-по´езд
броне-каземат	броня-казэма´т
броне-каретка	броня-карэ´тка
броне-купол	броня-ку´пал
броне-лафет	броня-лафэ´т
броне-летучка	броня-ляту´чка
броненосец	броняно´сец
броне-пояс	броня-по´яс
бронзовая колонка (арт.)	бро´нзавая калё´нка
бронированный 	бранява´ны
бронировка	бранё´ўка
броня	бро´ня
брульон	брульё´н
брус	брус
бруствер (в.-инж.)	бру´ствэр
бруствер наносный	бру´ствэр нано´сны
брусья составные	брусы´ састаўны´я
бугель (в.-инж.)	бу´гель
буек (морск.)	бу´ёк
буй (морск.)	буй
буйреп	буйрэ´п
букса (автом.)	бу´кса
буксир	буксі´р
буксировка	буксіро´ўка
буксование (автом.)	буксава´ньне
бурав (в.-инж.)	сьві´дар
буровой	сьвідравы´
буссоль	бусо´ль
буферная тарелка	бу´фэрная тале´рка
буферный вид	бу´фэрны від
буфер рессорный	бу´фэр рысо´рны
бухта (морск. - 1) небольшой залив, 2) трос, свернутый кругами, или снасть, уложенная кругами)	бу´хта
бушлат (морск. - короткое пальто военмора)	бу´шлат
бык (в.-инж.)	бык
быстрогорящий шнур (в.-инж.)	быстразга´рны шнур
быстрота	быстрыня´, шпа´ркасьць
быстротечный	быстраце´чны
бюллетень	бюлетэ´нь
вага (арт.)	ва´га
вагон	ваго´н
вагонетка	вагане´тка
вакуум-апарат(аппарат) (авт.)	вакуу´м-апара´т
вал	вал
валек	валё´к
вальковый крюк (арт.)	ва´лькавы крук
вальтрап (седло)	вальтра´п
ватерлиния	ватэрлі´нія
ватерпас	ватэрпа´с
вахта (морск.)	ва´хта
вахтер	ва´хтэр
вброд	бро´дам, убро´д
вверять пароль	дава´ць паро´ль
вверенная часть	дару´чаная часьць
ввинтное дно (авт.)	увінтно´е дно, ушрубо´ўнае дно
вводное задание	уво´днае зада´ньне
в готовности	напагато´ве
вдалеке	удалячыні´
вдвигать, вдвинуть	усо´ўваць, усу´нуць
вдогонку	наўздаго´н
вдоль	уздо´ўж
вдыхательный клапан	удыха´льны кля´пан
ведение огня	вядзе´ньне агню´
ведомость	ве´дамасьць
ведомство военное и морское	ве´дамства вае´ннае і марско´е
ведущий поясок (арт.)	вяду´чы паясо´к
веер	ве´ер
велосипед	вэлёсыпе´д
вельбот (морск. - легкая продолговатая гребная шлюпка на 5-6 распашных весел)	вэльбо´т
вентиль	вэнты´ль
вентилятор (запорный кран)	вэнтыля´тар
вентиляция	вэнтыля´цыя
венчык(венчик) боевой личинки	вяно´чак баяво´й лічы´нкі
вербовать	вербава´ць
вереск (в.-инж, дорож.)	ве´раск
верки	вэ´ркі
вероятность попадания	магчы´масьць папада´ньня, імаве´рнасьць папада´ньня
верстовка	вярсто´ўка
вертикаль	вэртыка´ль
вертикально	вэртыка´льна
вертикальный паз (стр.)	вэртыка´льны паз
вертлюг	вэртлю´г
верфь (морск.)	вэ´рфа
верхнее строение (в.-инж)	ве´рхняя пабудо´ва
верхние пальцы (стр.)	ве´рхнія па´льцы
верхний спуск	ве´рхні спуск
вершина	вяршы´на
весло	вясло´
весовое количество	вагава´я ко´лькасьць
вестовой	веставы´
ветеринария	вэтэрынары´я
ветромер	ветраме´р
веха	веха´
вечерняя перекличка	вячэ´рняя пераклі´чка
вещевой мешок	рэ´чавы мяшо´к
вещь	рэч
взаимодействие	узаемадзе´йства
взаимоотношение	узаемаадно´сіны
взвод	узво´д
взнуздывание	закі´лзваньне
взрыватель	узрыва´цель
взрыв подводный	узры´ў падво´дны
взрывчатые вещества	узрыўны´я рэ´чывы
взыскание	спагна´ньне
виадук (мост)	віяду´к
вибрация (стр.)	вібра´цыя
видимость	ві´дзімасьць
видимый горизонт	ві´дзімы гарызо´нт
вид огня	від агню´
видозащитный	відаабаро´нны
вид разведки	від выве´дкі
визирная трубка	візі´рная тру´бка
визировать	візі´раваць
вилка соединительной планки	ві´лка злуча´льнай пла´нкі
винтовка	вінто´ўка
винтовой вырез (стр.)	вінтавы´ вы´раз
винтовой выступ	вінтавы´ вы´ступ
винтовые нарезы	вінтавы´я нарэ´зы
вираж (авио)	віра´ж
виридон (маск.)	вірыдо´н
вис, притягивание, вис и соскок	віс, пры´цягваньне, віс і саско´к
вихровой шнур (ав.)	віхравы´ шнур
вица	ві´ца
вкладывание патрона	укла´дваньне патро´на
вкладыш (арт.)	укла´дыш
влага	ві´льгаць
владеть оружием	улада´ць збро´яй
влажность	вільго´тнасьць
влажный противогаз	вільго´тны про´цігаз
власовская трубка	ула´саўская тру´бка
влево	уле´ва
влияние	уплы´ў
влияние погоды на стрельбу	уплы´ў надво´р'я на стральбу´
вменять в обязанность	абавя´зваць
вмешательство	умяша´ньне
внезапность	рапто´ўнасьць, нечака´насьць
вне очереди	без чаргі´
внимание	ува´га
внутренний	уну´траны
внутренний пост	унутраны´ пост
внушение	наразумле´ньне
вогнутость	угну´тасьць
вогнутый	угну´ты
водитель	вадзі´цель
водоизмещение (морское)	вадавымяшчэ´ньне
водокачка	вадака´чка
водолаз (морск.)	вадала´з
водомер	вадаме´р
водопод'емник	вадапад'е´мнік
водопой	вадапо´й
водораздел	вадападзе´л
водород	вадаро´д
водоснабжение	вадазабеспячэ´ньне
водосток	вадасьцё´к
воевать	ваява´ць
военачальник	ваенача´льнік
военком	ваянко´м
военкомат	ваенкама´т
военкор	ваянко´р
военная дорога	вае´нная даро´га
военная игра	вае´нная гульня´
военная пропаганда	вае´нная прапага´нда
военная тайна	вае´нная та´йна
военная техника	вае´нная тэ´хніка
военная химия	вае´нная хі´мія
военно-воздушный флот	вае´нна-паве´траны флёт
военно-голубиная станция	вае´нна-галубі´ная ста´нцыя
военно-дорожный отряд	вае´нна-даро´жны атра´д
военное время	вае´нны час
военное дело	вае´нная спра´ва
военное обмундирование	вае´ннае абмундзірава´ньне
военное обучение 	вае´ннае навуча´ньне
военное положение	вае´ннае стано´вішча
военное сообщение	вае´ннае паведамле´ньне
военно-политическое воспитание	вае´нна-політы´чнае выхава´ньне
военно-санитарное довольствие	вае´нна-саніта´рнае забесьпячэ´ньне
военнослужащий	ваеннаслу´жачы
военностатистический обзор	ваеннастатысты´чны агля´д
военные действия	вае´нныя дзе´йствы
военные занятия	вае´нныя заня´цьці
военный	вае´нны
военный коммунизм	вае´нны камуні´зм
военнохимическое дело	вае´ннахімі´чная спра´ва
военнохимическая подготовка	вае´нна-хімі´чная падрыхто´ўка
военно-хозяйственное управление (Военхозупр)	вае´нна-гаспада´рчая ўпра´ва (Ваенгасупр)
вожак	важа´к
вожатый	важа´ты
вождение	ваджэ´ньне
вождь	правады´р
вожжи	ле´йцы
возвратная пружина	зваро´тная спружы´на
возвратный механизм	зваро´тны мэхані´зм
возвышение	узвышэ´ньне
возвышенность	узвы´шша
возглавление	узнача´леньне
воздействие	узьдзе´йства
воздухоплавание	паве´трапла´ваньне
воздухоплаватель	паве´трапла´вальнік
воздухоочиститель	паве´траачышча´льнік
воздушная разведка	паве´траная выве´дка
воздушное наблюдение	паве´транае назіра´ньне
воздушно-химическая оборона	паве´трана-хімі´чная абаро´на
воздушно-химическое нападение	паве´трана-хімі´чны напа´д
воздушные силы	паве´траныя сі´лы
воздушный бой (ов.)	паве´траны бой
воздушный прибор заражения	паве´траны прыбо´р заражэ´ньня
воздушный рейс	паве´траны рэйс
воздушный флот	паве´траны флёт
воззвание	адо´зва
возмущение	абурэ´ньне
вознаграждение	узнагаро´да
войска	во´йска
войсковая часть	вайско´вая часьць
войсковое соединение	вайско´вае злучэ´ньне
войсковое хозяйство	вайско´вая гаспада´рка
волна (св.)	хва´ля
волнистый паз (арт.)	хвалі´сты паз
волнообразный 	хваляпадо´бны
волнующий	хвалю´ючы
волонтер	валанцё´р
вольно	во´льна
вольт (кавал.)	вольт
вольтижировка (кавал.)	вольтыжыро´ўка
вольтметр	вольтмэ´тр
волчий зуб (авт.)	во´ўчы зуб
воодушевление	натхне´ньне
вооруженная охрана	узбро´еная ахо´ва
вооружение	узбрае´ньне
вооруженные отряды	узбро´еныя атра´ды
вооружить	узбро´іць
воронка (в результ.взрыва)	узры´віна
воронка (для перелив.жидкости)	ле´йка
ворот натяжного винта	калаўро´т нацяжно´га вінта´
воспламенитель терочный	запа´льнік цё´рачны
воспламеняющий	успалымня´льны, запа´льны
воспрепятствовать	перашко´дзіць, затрыма´ць
воспрещать	забараня´ць
восстание	паўста´ньне
восходящие токи воздуха	узыхо´дныя то´кі паве´тра
восходящий угол	узыхо´дны ву´гал
вплавь	уплы´нь, пла´ўма
вправо	упра´ва
впрягать	упрага´ць
враг	во´раг
враждебный	варо´жы
врасплох	зьнячэ´ўку, зьняна´цку
вращение пули	вярчэ´ньне ку´лі
вращение снаряда	вярчэ´ньне знара´ду
временное затишие	часо´вае заці´шша
временный пост	часо´вы пост
временный сторожевой пост	часо´вы вартавы´ пост
врываться	урыва´цца
всадник	ко´нны
всеобщая воинская повинность	усеагу´льная вайско´вая паві´ннасьць
вскачь	наўска´ч
вскидка	ускі´дка
вскок	уско´к
вслушиваться	услухо´ўвацца
всматриваться	угляда´цца
вспахивание дороги	узо´рваньне даро´гі
вспомогательная точка прицеливания	успамо´жная кро´пка прыцэ´льваньня
вспомогательная часть	успамо´жная часьць
вспомогательный	успамо´жны
вспышка ложная 	успы´шка фальшы´вая 
вспышки дистанционные	успы´шкі дыстанцы´йныя
вспышки сигнальные	успы´шкі сыгна´льныя
встать	уста´ць
встречный	сустрэ´чны
вступать (в наряд)	заступа´ць
вступить в бой	уступі´ць у бой
вторгнуться в окопы	уварва´цца ў ако´пы
вторжение	урыва´ньне
второстепенное направление	другара´дны напра´мак
втулка (авт.)	уту´лка
втягивание	уця´гваньне
вулканизация (автом.)	вульканіза´цыя
выбивать	выбіва´ць
выбор цели	вы´бар цэ´лі
выбрасыватель	выкіда´ч
выверенный револьвер	вы´вераны рэвальвэ´р
выводить караул	выво´дзіць караву´л
выводка	вы´вад
выводная трубка	вывадна´я тру´бка
выводной понтон (понт.)	вывадны´ панто´н
выгатить (в.-инж.)	вы´гаціць
выгнутость	вы´гнутасьць
выгодный	выго´дны
выгрузка	вы´грузка
выгул (голуб.ст.)	вы´гул
выдвижение	высо´ўваньне
выдвижение (на должность)	вылучэ´ньне
выдвижной прицел	высо´ўны прыцэ´л
выдержка	вы´трымка
выдыхательный клапан	выдыха´льны кля´пан
выездка	вы´ездка
выезженность (кав.)	вы´езджанасьць
выемка	вы´емка
выем ложи	вы´емка ло´жы
выжидательный	чака´льны
вызов в ружье	вы´клік у ружжо´
вызов смены	вы´клік зьме´ны
выиграть время	вы´гадаць час
выкладка	вы´кладка
выключатель	выключа´льнік, выключа´цель
выколотка (стр.)	выбіва´чка
вылазка	вы´лазка
вымпел	вы´мпэл
выносливость	трыва´ласьць
вынос знамени	вы´нас штанда´ру
вынуть латки (арт.)	вы´няць латкі´
выпад	вы´пад
выпадение	выпадзе´ньне
выправка	вы´праўка
выпрямить самокаты	вы´прастаць самака´ты
выпукло	вы´пукла, пука´та
выпуск (авт.)	вы´пуск
выравнивание	выро´ўніваньне
вырубка	высяка´ньне
выручать	выруча´ць
высадка дессанта(десанта)	вы´садка дэса´нту
выслеживать	высо´чваць
высота	вышыня´
высота прицела	вышыня´ прыцэ´лу
выставить караул	вы´ставіць караву´л
выстрел	стрэл, вы´страл
выстрелить	стрэ´ліць, вы´страліць
выстроиться	вы´страіцца
выступать	выступа´ць
выступ боевой (стр.)	вы´ступ баявы´
выступ коробки (стр.)	вы´ступ каро´бкі
выступление	выступле´ньне
высшее войсковое соединение	вышэ´йшае вайско´вае злучэ´ньне
высшее командование	вышэ´йшае кама´ндаваньне
высший комсостав	вышэ´йшы камсаста´ў
вытягивание 	выця´гваньне
вытяжная труба (стр.)	выцяжна´я труба´
выход из подчинения	вы´хад з паднача´леньня
вычисление	вылічэ´ньне
вышибной заряд (арт.)	вышыбны´ зара´д
вышка	вы´шкі
выявление	выяўле´ньне
вьюк	ую´к
вьюк подрывной	ую´к падрыўны´
вьючное животное	ую´чная жывё´ліна
вьючный ремень	ую´чны рэ´мень
вязкий	вя´зкі
габарит (тр.-дор.)	габары´т
габариты (автом.)	габары´тны
гавань	га´вань
газ	газ
газета	газэ´та
газоанализатор	газааналіза´тар
газобалонный	газабалё´нны
газовая арматура	га´завая армату´ра
газовая волна	га´завая хва´ля
газовая камера (хим.)	га´завая ка´мэра
газомет	газамё´т
газометр	газамэ´тр
газонепроницаемый	га´занепраніка´льны
газообразный	газападо´бны
газоопасный	газанебясьпе´чны
газоопределитель	газавызна´чнік
газоотравление	газаатручэ´ньне
газоотравленный	газаатру´чаны
газоубежище	газасхо´вішча
газоулавливатель	газаўло´ўнік
гайдроп	гайдро´п
гак (морск. - металлический крюк)	гак
гакоборт (морск.)	гакабо´рт
галанить	гала´ніць
галлерея минная	галерэ´я мі´нная
галоп	галё´п
галс (морск. - 1) веревка притягивающая галсовый угол шлюпочного паруса к мачте; 2) курс корабля отоносительно ветра	галс
галсы (авт. - разбивка площади на галсы)	га´лсы
галтель (атр.)	галтэ´ль
галфинд (мор.)	гальфі´нд
гальванометр	гальвано´мэтр
гальваноскоп	гальванаско´п
гальюн (морск.)	галью´н
гараж	гара´ж
гарантия	гара´нтыя
гарнизон	гарнізо´н
гарнизонный	гарнізо´нны
гать	гаць
гаубица	га´ўбіца
гауптвахта	гаўпва´хта
гафель (морск.)	га´фэль
гвардия	гва´рдыя
гвоздь	цьвік, гвозд
гегемония	гэгемо´нія
геликоптер (ав.)	геліко´птэр
гелиограф	геліогра´ф
генератор	гэнэра´тар
геометрическая фигура	геомэтры´чная фігу´ра
геоскоп	геаско´п
герметизация	гэрмэтыза´цыя
герметический	гэрмэты´чны
героизм	гэраі´зм
герой	гэро´й
гетеродин (радио)	гэтэрады´н
гибкость	гі´бкасьць
гигрометр	гіграмэ´тр
гигроскопический	гіграскапі´чны
гидроаэроплан	гі´драаэропля´н
гидрография (морск.)	гідрагра´фія
гидроплан	гідрапля´н
гидропульт	гідрапу´льт
гидрофон (морск.)	гідрафо´н
гильза	гі´льза
гимнастика	гімна´стыка
гимнастический зал	гімнасты´чная за´ля
гипсасульфитный(гипсосульфитный) раствор	гіпсасульфі´тавы раство´р
гипотенуза	гіпатэну´за
гирометр (маш.)	гіро´мэтр
главконитовая зелень	глаўкані´тавая зе´лень
главные силы	гало´ўныя сі´лы
главный удар	гало´ўны ўда´р
глазомер	вокаме´р
глазомерная с'емка	вокаме´рная зды´мка
глазомерное определение расстояния	вокаме´рнае вызначэ´ньне адле´гласьці
глазомерный	вокаме´рны
гласис (инж.)	гля´сіс
глицерин	гліцэры´н
глубина	глыбіня´
глушитель (авт.)	глушы´льнік
гнездо	гняздо´
гнеток (стр.)	гнято´к
головка эфеса	гало´ўка эфэ´са
головной	галаўны´
голубевод	галубаво´д
голубеграмма	галубагра´ма
голубиная почта	галубі´ная по´шта
голубиная связь	галубі´ная су´вязь
гондола	гандо´ла
гониометр (измер.)	ганіё´мэтр
горбатая пружина	гарба´тая спрунжы´на(часцей ў слоўніку сустракаецца «спружына»)
горение	гарэ´ньне
горизонт	гарызо´нт
горизонталь	гарызанта´ль
горизонтальная маска	гарызанта´льная ма´ска
горизонтальная наводка	гарызанта´льная наво´дка
горизонтальная площадка	гарызанта´льная пляцо´ўка
горизонтально	гарызанта´льна
горизонтальный стабилизатор (ав.)	гарызанта´льны стабіліза´тар
гористая местность	гары´стая мясцо´васьць
горка-пике (ав.)	го´рка-піке´
горловина	гарлаві´на
горн-минный	го´ран-мі´нны
горчичный газ (хим.)	гарчы´чны газ
горючая жидкость	гару´чая ва´дкасьць
госпиталь	шпіта´ль
Государственное Политическое Управление (ГПУ)	Дзяржа´ўная Паліты´чная Упра´ва (ДПУ)
готовность	гато´ўнасьць
готовность пулемета	гато´ўнасьць кулямё´та
готово (брон.-маш.-знак)	гато´ва
готовсь	рыхту´йся
гофрированная трубка	гафрава´ная тру´бка
гоширование (ав.)	гашы´раваньне
гравий	гра´вій
градация	града´цыя
градуирование	градуява´ньне
градуировка (прож.)	градуё´ўка
гражданская война	грамадзя´нская вайна´
граната	грана´та
гранатомет	гранатамё´т
гранатаметчик(гранатометчик)	гранатамё´тчык
график	гра´фік
графическая точность	графі´чная дакла´днасьць
гребень стебля затвора	грэ´бень сьцябла´ затво´ра
гребень топографический	грэ´бень тапаграфі´чны
гремучая ртуть	грыму´чая ірту´ць
гремучий студень (хим.)	грыму´чы сту´дзень
грозоотметчик	громаадзна´чнік
громоздкий	грамо´зны
громоотвод	гро´маадво´д
грубая наводка	гру´бая наво´дка
грудная мишень	грудна´я мішэ´нь
грузолента (авт.)	грузасту´жка, грузале´нта
грузоподъемность (автом.)	грузапад'ё´мнасьць
грунт	грунт
грунтовая дорога	грунтава´я даро´га
группа	гру´па
группа хлорофосгена (хим.)	гру´па хло´рафасге´ну
группирование	групава´ньне
группировка войск	групо´ўка во´йска
групповая стрельба	групава´я стральба´
гуж	гуж
гужевой ремень	гужавы´ рэ´мень
гуманный газ	гума´нны газ
гусеница (танк.)	ву´сеніца
гусеничная лента (танк.)	ву´сенічная істу´жка, ле´нта
гуськом	гусько´м
гуттаперчевый	гутапэ´рчавы
давление	ціск
давление противника	на´ціск праці´ўніка
дазиметр(дозиметр)	дазымэ´тр
дальний огонь	да´льны аго´нь
дальнобойность	дальнабо´йнасьць
дальновидность	дальнаба´чнасьць
дальномер	дальняме´р
дальномерное отделение (арт.)	дальняме´рнае аддзяле´ньне
дальномерщик	дальняме´ршчык
дальность выстрела (стр.)	да´льнасьць стрэ´лу, да´льнасьць вы´стралу
дальность полета пули (стр.)	да´льнасьць палё´ту ку´лі
дальность прямого выстрела	да´льнасьць прамо´га стрэ´лу, да´льнасьць прамо´га вы´стралу
дамба	да´мба
дверца револьвера	дзьве´рцы рэвальвэ´ра
двигатель (авт.)	рухаві´к
движение	рух
движение вперед	рух напе´рад
движение шеренги	рух шарэ´нгі
движитель (тракт.)	ру´шыцель
движущаяся цель	рухо´мая цэ´ль
двинуть	ру´шыць
двухколейный	двухкале´йны, двухкаляі´нны
двухколка	двухко´лка
двухперая боевая пружина	двухпё´рая баявая спружы´на
двухслойный огонь	двухсло´йны аго´нь
двухсменный пост	двухзьме´нны пост
двухсторонний	двухбако´вы
двухтактный процесс (авт.)	двухта´ктавы працэ´с
двухфазный ток (электр.)	двухфа´зны ток
двухшереножный строй	двухшарэ´нгавы строй
девиация	дэвія´цыя
дегазационная работа	дэгазацы´йная рабо´та
дегазация (хим.)	дэгаза´цыя 
дежурная комната	дзяжу´рны пако´й
дежурная часть	дзяжу´рная часьць
дежурный	дзяжу´рны 
дежурный по караулам	дзяжу´рны па караву´лах
дезертир	дэзэрты´р
дезертирство	дэзэрты´рства
дезинфекция	дэзынфэ´кцыя
дезорганизация	дэзарганіза´цыя
действие	дзе´йства
действительная военная служба	сапра´ўдная вае´нная слу´жба
действительность огня 	сапра´ўднасьць агню´
действующая армия	дзе´йствуючая а´рмія
действующий пулемёт	дзе´йствуючы кулямё´т
декабрь	сьне´жань
декоративный	дэкарацы´йны
делегат	дэлега´т
деление прицела	падзе´л прыцэ´льніка
делопроизводитель	дзелаво´д
демаркационный	дэмаркацы´йны
демаскировка	дэмаскіро´ўка
демобилизация	дэмабіліза´цыя
демонстрация	дэманстра´цыя
деморализация	дэмараліза´цыя
демультипликатор (автом.)	дэмультыпліка´тар
демультипликация	дэмультыпліка´цыя
денежный ящик	грашо´вая скры´нка
денник	дзё´ньнік
депеша (св.)	дэпэ´ша
дергать	то´ргаць
дерзость	дзё´рзкасьць
деривация	дэрыва´цыя
дерн	дзё´ран
дернина	дзярні´на
десант	дэса´нт
десантный отряд	дэса´нтны атра´д
деталь	дэта´ль
детектофон 	дэтэктафо´н
детонатор	дэтана´тар
детонация	дэтана´цыя
детонирующий шнур	дэтану´ючы шнур
дефиле	дэфіле´
деформация	дэфарма´цыя
децентрализация	дэцэнтраліза´цыя
дешифровка	дэшыфро´ўка
джигитовка	джыгіто´ўка
диагональное крепление (мост.)	дыягана´льнае ўмацава´ньне
диаграмма	дыягра´ма
диалектика	дыяле´ктыка
диалектический метод	дыялекты´чны мэ´тад
диаметр	дыя´мэтр
диаметральный	дыя´мэтральный
дианизидин	дыянізыды´н
диапазон (св.)	дыяпазо´н
диатомит (хим.)	дыятамі´т
диафрагма	дыяфра´гма
дивизион	дывізіё´н
дивизия	дыві´зія
диктатура	дыктату´ра
динамит (в.инж.)	дынамі´т
динамомашина	дына´мамашы´на
динамометр	дына´мамэ´тр
диоптр	дыо´птр
дипломатия	дыплёматы´я
директива	дырэкты´ва
директрисса	дырэктры´са
дирижабль (ав.)	дырыжа´бль
диск (автом.)	дыск
диск магазина (авт.)	дыск магазы´ну
диск-распылитель	дыск-распы´льнік
дисковая пружина (стр.)	дыскава´я спружы´на
дислокация	дысьлёка´цыя
диспозиция	дыспазы´цыя
дистанционная трубка	дыстанцы´йная тру´бка
дистанционный огонь	дыстанцы´йны аго´нь
дистанция	дыста´нцыя 
дисциплина	дысцыплі´на
дисциплинарная политика	дысцыпліна´рная палі´тыка
дисциплинарное взыскание	дысцыпліна´рнае спагна´ньне
дисциплинарное воздействие	дысцыпліна´рнае ўздзе´йства
дифенил хлорарсин (хим.)	дыфэні´л хлёрарсі´н
дифосген	дыфасге´н
дифферент (авт.)	дыфэрэ´нт
дифференциал (маш.)	дыфэрэнцыя´л
дифференциальный индикатор (маш.)	дыфэрэнцыя´льны індыка´тар
диффузия	дыфу´зія
дихлордиэтилсульфид (хим.)	дыхлё´рдыэты´лсульфі´д
длительность	даўгача´снасьць, праця´жнасьць
длительный отдых	даўгача´сны адпачы´нак, до´ўгі адпачы´нак
дневальный	днява´льны
дневка	днё´ўка
дневной наряд	дзё´нны нара´д
днище ввинтовое (авт.-бр.)	дні´шча ўвінтно´е, дні´шча ўшрубо´ўнае
дно рва окопа	дно ако´пнага ро´ву
доблестный	гэраі´чны
доброволец	дабраво´лец
довольствие	забесьпячэ´ньне
дождемер (мет.)	дажджаме´р
дожать затвор	даці´снуць затво´р
дознание	дазна´ньне
дозор	дазо´р
док (морск.)	док
докладная записка	дакладна´я запі´ска
докладывать	дакла´дваць
документ	дакумэ´нт
долгий	до´ўгі
должностное лицо	службо´вая  асо´ба
доложить	далажы´ць
долы штыка (стр.)	до´лы штыха´
домашний арест	ха´тні а´рышт
Дом Красной армии	Дом Чырво´най а´рміі
домкрат	дамкра´т
донесение	данясе´ньне
донная втулка (атр.)	до´нная ўту´лка
донная труба	до´нная тру´бка
дополнительный 	дадатко´вы
допризывник	дапрызы´ўнік
допуск	до´пуск
дорога	даро´га
дорожка шомпольная	даро´жка шо´мпальная
дорожки выпуклые (стр.)	даро´жкі вы´пуклыя
доска	до´шка
дослать патрон	дасла´ць патро´н
досрочный	датэрміно´вы
доставка	даста´ўка
достигать	дасяга´ць
достижение	дасягне´ньне
достреливать	дастрэ´льваць
досылание	дасыла´ньне
досылатель (стр.)	дасыла´ч
досягаемость	дася´жнасьць, дасяга´льнасьць
древесный уголь	драўля´ны ву´галь
дредноут (линейн.корабль)	дрэдно´ут
дренаж	дрэна´ж
дренажная канава (в.-инж.)	дрэна´жная кана´ва
дробящий	драбі´льны
дроссель (ант.)	дро´сэль
дроссельная заслонка	дро´сэльная за´сланка
дрэгон (танк.)	дрэго´н
дуга под'емного механизма	дуга´ пад'ё´мнага мэхані´зму
дудка (морск. - свисток)	ду´дка
дуло (стр.)	ду´ла
дульная накладка (стр.)	ду´льная накла´дка
дым маскировочный	дым маскірава´льны
дымная бомба	ды´мная бо´мба
дымная граната	ды´мная грана´та
дымная смесь	ды´мная су´месь
дымные буи	ды´мныя буі´
дымный прибор	ды´мны прыбо´р
дымовая завеса	дымава´я засло´на
дымогенератор	дымагэнэра´тар
дымообразный	дымападо´бны
дымообразователь	дымаўтвара´льнік
дымообразующие вещества	дымаўтвара´ючыя рэ´чывы
дым ядовитый	дым ядаві´ты
дышло	ды´шаль
дышловая подставка	дышлава´я падста´ўка
дышловой ремень	дышлавы´ рэ´мень
единоначалие	адзінанача´льле
едкая щелочь	е´дкая шчо´лач
едкий калий	е´дкі ка´лій
еж (в.-инж.)	во´жык
езда	язда´
ездовой	ездавы´
емкость	ё´містасьць
естественное маскирование (в.-инж.)	натура´льнае маскірава´ньне
естественное рассеивание выстрелов	натура´льнае расьсе´йваньне стрэ´лаў
есть	ёсьць
жало (арт.)	джа´ла
жалоба	ска´рга
жгут (в.-инж.)	жгут
ждать	чака´ць
железная дорога	чыгу´нка
железный купорос	жале´зны купарва´с
железный цилиндр	жале´зны цылі´ндр
железо-бетон	жале´за-бэто´н
желоб-цевья	жо´лаб-цаўя´
желобок (стр.арт.)	жалабо´к
желтый фосфор	жо´ўты фо´сфар
женная умбра	па´леная у´мбра
жердь	жэ´рдка
жерло	жарло´
живая газета	жыва´я газэ´та
живец (часть седла)	жыве´ц
жиклер (авт.)	жы´клер
жирометр (маш.)	жыро´мэтр
жироскопический компас (морск.)	жыраскапі´чны ко´мпас
жироскопический кренометр (ав.)	жыраскапі´чны крэно´мэтр
жом	сьціска´ч
забивка	забі´ўка
забинтовать	забінтава´ць
заблаговременно	заўча´сна
заблаговременный	заўча´сны
забоина (стар.)	забо´іна
заболачивание (в.-инж.)	забало´чваньне
заботливость	клапатлі´васьць, руплі´васьць
забронировать	забранява´ць
завал (в.-инж.)	зава´л
заведение	устано´ва, завядзеньне
завертка (арт.)	за´крутка
завеса	засло´на
завинтованное гнездо (арт.)	завінтава´нае гняздо´
завинтованный конец (стр.)	завінтава´ны кане´ц
завод орудийный	заво´д гарма´тны
заводная лошадь	запасны´ конь
завоевание	заваё´ва
завязка	завя´зка
загиб	загі´б
загораживать	загаро´джваць
заградительный огонь	заграджа´льны аго´нь
заградительный отряд	заграджа´льны атра´д
заграждение	загаро´да
загроможденность	заграмо´джанасьць
загребной	заграбны´
задача (боев.)	зада´ча
задвижка (стр.арт.)	за´саўка
задвижной щиток (арт.)	засо´ўны шчыто´к
задержка (стр.)	затры´мка
задержник (арт.)	затрыма´ч
заднее отверстие ствола	за´дняя адту´ліна ствала´
задняя вага (атр.)	за´дняя ва´га
задраить (морск. - плотно закрыть)	задраі´ць
задувание (ав.)	задува´ньне
заезд	зае´зд
зажигательная трубка	запа´льная тру´бка
зажигательница (в.-инж.)	запа´льніца
зажигательные вещества	запа´льныя рэ´чывы
зажигательный снаряд	запа´льны знара´д
зажим (предмет)	за´ціск
зажимная матка (арт.)	заціскна´я ма´тка
зажимное кольцо (арт.)	заціскно´е кальцо´
зажимное приспособление 	заціскна´я прыла´да
зажимные кулаки (арт.)	заціскны´я кулакі´
заземление	зазямле´ньне
зазор (авт.)	празо´р
зазубрина (стр.арт.)	зазу´брына
закаленный 	загартава´ны
закалка	загарто´ўка, гарт
закатка (арт.снар.)	зака´тка
закладывать фугас	заклада´ць фуга´с
заклепка (стр.)	заклё´пка
закраина вкладыша (маш.)	закра´іна ўкла´дыша
закрепитель	замацава´льнік
закрепляющий болт (стр.)	замацава´льны болт
закрытая позиция	закры´тая пазы´цыя
закуска (понт. - клинья и т.п.)	заку´ска
залегать	заляга´ць
залив	зато´ка
заложение	залажэ´ньне
заложник	зало´жнік
залп	залп
замазка	зама´зка
замаскировать	замаскірава´ць
замедление движения	зацішэ´ньне ру´ху
замедлитель (арт.)	заціша´льнік
замечание	заўва´га
замешательство	замяша´ньне
замковое кольцо (арт.)	замко´вае кальцо´
замок	замо´к
замочный механизм (стр.)	замко´вы мэхані´зм
замундштучивание	замуншту´чваньне
замыкатель трубчатый	замыка´льнік трубча´сты
замыкающая шпилька (стр.)	замыка´льная шпі´лька
занимать (место)	займа´ць
заносы снежные	сумё´ты сьне´жныя
западня	западня´
запажиливание (понт.)	запажы´льваньне
запал накаливания	запа´л напа´льваньня
запал платиновый	запа´л пляты´навы
запал у лошади	запа´л у каня´
запальная трубка (стр., арт.)	запа´льная тру´бка
запальное отверстие (стр.)	запа´льная адту´ліна
запальный патрон	запа´льны патро´н
запас	запа´с
запасная сумка	запа´сная то´рбачка
запасная часть	запасна´я часьць
запасный	запасны´
запах	пах
запевала	запява´ла
записка	запі´ска
записка об арестовании	запі´ска аб арыштава´ньні
заплечник (стр.)	запле´чнік
запрессовать	запрэсава´ць
запрет	забаро´на
запряжка	запрэ´жка
запускать (мотор)	запуска´ць
запутывать	заблы´тваць
запяток	запя´так
заражение местности	заражэ´ньне мясцо´васьці
зараженный участок	заражо´ны вуча´стак
зарубка	зару´бка
заручная амуниция	зару´чная амуні´цыя
заручное оружие	зару´чная збро´я
заряд наружный 	зара´д знадво´рны
заряд буровой 	зара´д сьвідравы´
заряд сосредоточенный	зара´д сканцэнтрава´ны
заряд удлиненный 	зара´д падо´ўжаны
заряд фигурный	зара´д фігу´рны
зарядить	зарадзі´ць
зарядный ящик	зара´дная скры´нка
засада	заса´да
засвинцование	засьвінцава´ньне
засека	засе´ка
засекречивание	засакрэ´чваньне
засечка	засе´чка
заслон	засло´на
засов с чекой	за´саўка з за´гваздкай
застава	заста´ва
застежка крышки (стр.)	за´шпілька на´крыўкі
застой	засто´й
застрелить	застрэ´ліць
заступка	засту´пка
затвердевание	зацьвердзява´ньне
затвор	затво´р
затворная задержка (стр.)	затво´рная за´трымка
затененный	заце´нены
затихать (в бою)	заціха´ць
затор ледяной	зато´р ледзяны´
затрава (арт.)	затра´ва
затравочное отверстие	затра´вачная адту´ліна
затруднение	ця´жкасьць, перашко´да
затухание	патуха´ньне
затылок приклада	паты´лак прыкла´да
затылочный винт	паты´лачны вінт
затыльник (пул.)	паты´льнік
затыльный (стр.)	паты´льны
заусеница (арт.)	заву´сеніца
захват	захва´т
захватка со спускной собачкой (маш.)	захва´тка са спускны´м саба´чкам
захваченный рубеж	захва´чаны рубе´ж
зацеп выбрасывателя	зачэ´п выкіда´льніка
защелка магазинной коробки	за´шчапка магазы´навай каро´бкі
защепка прицельного хомутика	за´шчапка прыцэ´льнага хамутка´
защита	абаро´на, ахо´ва
защитная мазь	ахо´ўная мазь
защитный	ахо´ўны
збруя	збру´я
звезда	зьвязда´
звено	зьвяно´
звеньями	зьве´ньнямі
звуковой сигнал	гукавы´ сыгна´л
звукомаскировка	гу´камаскіро´ўка
звукоприемник	гу´капрыё´мнік
звукопровод	гу´каправо´д
звукоулавливатель	гукаўло´ўнік
здравствуйте	до´бры дзень
землянка	зямля´нка
зенитная артиллерия	зэні´тная артыле´рыя
зенитный	зэні´тны
зенитный пулемет	зэні´тны кулямё´т
зеркальный эккер (измер.)	люстэ´рачны э´кер
зигзаг	зыгза´г
змейка	зьме´йка
змейковый аэростат (ав.)	зьме´йкавы аэраста´т
знамена	штанда´ры
знаменщик	штанда´рнік
значек	значо´к
зона	зо´на
заря	зара´
зрительная связь	зро´кавая су´вязь
зуб защелки	зуб за´шчапкі
зубило	зубі´ла
зуб отсечки отражателя	зуб адсе´чкі адбівача´
зубчатая рейка (стр.)	зубча´стая рэ´йка
зубчатка (авт.)	зубча´тка
зубчатое колесо (стр.)	зубча´стае ко´ла
зубатый сектор (арт.)	зубча´сты сэ´ктар
зуммер (св.)	зу´мэр
зюйд-вестка (непроникаемая морская шляпа с полями)	зю´йд-вэ´стка
игра (воен.)	гульня´
избегать	ухіля´цца
известие 	зьве´сткі, паведамле´ньне
известно	вядо´ма
известь	ва´пна
извещение	паведамле´ньне
извилина	зьві´ліна
извлекать (о предмете)	выця´гваць, дастава´ць, выма´ць
извлекать (о пользе)	здабыва´ць, атры´мліваць
извлечение (из дела)	вы´нятка
изгородь	плот, агаро´жа
изготовка	згато´ўка
издание	выда´ньне
излом (травма)	злом
излом (о дороге)	вы´гіб
излучаемая волна (св.)	выпрамяня´льная хва´ля
излучина (реки)	лука´, вы´гіб
измена	здра´да
изменник	здра´днік
измерительный прибор	вымяра´льны прыбо´р
износ изгибов боевой личинки	знос згі´баў баяво´й лічы´нкі
изнурение	змо´ранасьць
изображение (как действие)	нанясе´ньне
изображение (как результат)	малю´нак
изобразительный	выяўле´нчы
изобретатель	вынахо´дца, вынахо´днік
изолирование	ізалява´ньне
изолированная лента (св.)	ізалява´ная істу´жка, ле´нта
изолированный	ізалява´ны
изолирующий противогаз	ізалю´ючы про´цігаз
изолятор (св.)	ізаля´тар
изоляция 	ізаля´цыя
изотерма	ізатэ´рма
изотермическое сжатие (авт.)	ізатэрмі´чны сьціск
изувечить	скале´чыць
изучение	вывучэ´ньне
изыскание (о местности)	дасьле´джаньне
изыскание (о средствах)	вышука´ньне
иллюминатор (морск. - круглое окно в борту судна)	ілюміна´тар
имитация 	іміта´цыя
империалистическая война	імперыялісты´чная вайна´
импровизация	імправіза´цыя
имущество	маё´масьць
инвалид	інвалі´д
инвентарь	інвэнта´р
ингалятор (прибор искусств.дыхания)	інгаля´тар
индивидуальная защита	індывідуа´льная абаро´на
индикатор (маш.)	індыка´тар
индуктивный ток (св.)	індукты´ўны ток
индуктор (св.)	інду´ктар
индукционная катушка (св.)	індукцы´йная шпу´лька
инерция	інэ´рцыя
инжектор	інжэ´ктар
инженер	інжынэ´р
инженерная подготовка (в.-инж.)	інжынэ´рная падрыхто´ўка
инженерно-техническая часть	інжынэ´рна-тэхні´чная часьць
инженерное дело	інжынэ´рная спра´ва
инженерные войска	інжынэ´рнае во´йска
инициатива	ініцыяты´ва
инспектирование	інспэктава´ньне
инспектирующий	інспэкту´ючы
инспектор	інспэ´ктар
инспекторский	інспэ´ктарскі
инспекторское обследование	інспэ´ктарскае абсьле´дваньне
инспекция	інспэ´кцыя
инстанция	інста´нцыя
инструктаж	інструкта´ж
инструктирование	інструктава´ньне
инструктор	інстру´ктар
инструкция	інстру´кцыя
инструмент шанцевый	інстру´мант ша´нцавы
инструментальная с'емка	інструманта´льная зды´мка
интенсивный 	інтэнсы´ўны
интервал	інтэрва´л
интервенция	інтэрвэ´нцыя
интернационал	інтэрнацыяна´л
интернирование	інтэрнава´ньне
интернировать	інтэрнава´ць
интерференция (радио)	інтэрфэрэ´нцыя
инфекция	інфэ´кцыя
информатор	інфарма´тар
информация	інфарма´цыя
информировать	інфармава´ць
инцидент	інцыдэ´нт
иприт	іпры´т
искатель	шука´льнік
исключать, исключить	выключа´ць, вы´ключыць
исключительное положение	выклю´чнае стано´вішча
искоренять, искоренить	выкараня´ць, вы´караніць
искра	іскра´
искривление	скрыўле´ньне
искротушитель (электр.)	іскратушы´льнік
искусно	па-майстэ´рску, уме´ла
искусный	уме´лы, ло´ўкі
искусственная маскировка	шту´чная маскіро´ўка
искусственное освещение	шту´чнае асьвятле´ньне
искуственный	шту´чны
испарение	выпарэ´ньне
испаритель (маш.)	выпа´рнік
исполнение	выкана´ньне
исполнительная команда	выкана´ўчая кама´нда
использование	выкарыста´ньне
исправный	спра´ўны
испытанный	апрабава´ны, вы´прабаваны
исследование	дасьле´дваньне
исток реки	пача´так ракі´
источник	крыні´ца
истощение	вычарпа´ньне, зьнясі´леньне
истребитель	зьнішча´льнік
истребительная авиация	зьнішча´льная авіа´цыя
истребительная эскадрилья (ав.)	зьнішча´льная эскадры´лья
истребовать	вы´трабаваць
исход	захо´д, вы´нік
исходное положение	захо´днае палажэ´ньне
исходный пункт	захо´дны пункт
исчезать	зьніка´ць
исчисленный	зьлі´чаны
июль	лі´пень
июнь	чэ´рвень
кабанчик (ав.)	каба´нчык
кабель (св.)	ка´бэль
кабель подводный	кабэ´ль падво´дны
кабинет	габінэ´т
кабинка (автом.)	кабі´нка
каботаж (мор.)	кабата´ж
кабрирование (ав.)	кабры´раваньне
кабур	кабу´р
кавалерийский	кавалеры´йскі
кавалерист	кавалеры´ст
кавалерия	кавале´рыя
кадло	кадло´
кадмий	ка´дмій
кадр	кадр
кадровые части	ка´дравыя ча´сьці
кадровый	ка´дравы
казарма	каза´рма
казарменное расположение	каза´рменнае разьмяшчэ´ньне
каземат (морск. - изолированное помещение для орудия)	казэма´т
казематированный 	казэматава´ны
казенная часть ствола	казё´нная ча´стка ствала´
казенник (атр.)	казё´ньнік
казначей	казначэ´й
каленчатый	кале´нчасты
калибр	калі´бр
калибромер (стр.)	калі´брамер
калька	ка´лька
камбуз (морск. - судовая кухня)	камбу´з
камера (авт.)	ка´мэра
камера минная	ка´мэра мі´нная
камера окуривания	ка´мэра аку´рваньня
камора (арт.)	камо´ра
кампания	кампа´нія
камуфлет	камуфле´т
камуфляж (в.-инж.)	камуфля´ж
камуфлированный халат (в.-инж.) 	камуфлява´ны хала´т
канава	кана´ва
канал (стр.)	кана´л
канал соединительной планки (стр.)	кана´л злуча´льнай пла´нкі
канал ствола (стр.)	кана´л ствала´
канал ствольной коробки	кана´л ство´льнай каро´бкі
канал стебля затвора	кана´л сьцябла´ затво´ру
канат	вяро´ўка
канифоль	каніфо´ль
канонада	канана´да
кантилевер (авт.)	кантыле´вер
кантилеверная рессора (ант.)	кантыле´верная рысо´ра
канцелярия	канцыля´рыя
каолин	каалі´н
капельмейстер	капэльмэ´йстар
капиталистический	капіталісты´чны
капитан (судна)	капіта´н
капитуляция	капітуля´цыя
капковый	ка´пкавы
капок (растительный пух, набиваемый в карманы лодки Иолшина)	капо´к
капонир	капані´р
капот (ав.)	капо´т
капотирование (ав.)	капаты´раваньне
капотировать (ав.)	капаты´раваць
капсуль (взрыв)	ка´псуль
капсуль-детонатор	ка´псуль-дэтана´тар
капюшон	капюшо´н
карабин	карабі´н
караван	карава´н
карантин	каранты´н
карательные меры	ка´рныя ме´ры
карательный	ка´рны 
караул	караву´л
караульная служба	караву´льная слу´жба
караульная часть	караву´льная часьць
караульное помещение	караву´льнае памяшка´ньне
карбюратор (ав.мот.)	карбюра´тар
карбюрация (авт.)	карбюра´цыя
кардан	карда´н
карданная передача	карда´нная перада´ча
карданное соединение	карда´ннае злучэ´ньне
карданное сочленение	карда´ннае сучляне´ньне
карданный вал (автом.)	карда´нны вал
каретка (автом.)	карэ´тка
каркас (часть лодки Иолшина)	карка´с
карманный счетчик оборотов	кішэ´нны лічы´льнік абаро´таў
кароссери (авт.)	карасэ´ры
карта квадратов (авиац.)	ка´рта квадра´таў
картер (автом.)	ка´ртэр
картечь	карце´ч
картография	картагра´фія
картуз двойной (арт.)	мяшо´чак двайны´
картуз одиночный (арт.)	мяшо´чак адзіно´чны
картушка (комп.)	карту´шка
карьер	кар'е´р
каска	ка´ска
касса	ка´са
касторовое масло	рыцы´на
катапульта (гид.)	катапу´льта
катастрофа	катастро´фа
категория	катэго´рыя
катер	ка´тэр
катет	ка´тэт
катетометр	ка´тэтамэ´тр
катки пулеметные	каткі´ кулямё´тныя
катушка	шпу´лька
качество	я´касьць
каюта (морск. - комната на корабле)	каю´та
кают-компания (морск.)	каю´т-кампа´нія
квадрант	квадра´нт
квалифицированный	кваліфікава´ны
квартирьер 	кватыр'е´р
кентер (кав.)	кэ´нтэр
кернение	кярне´ньне
кернер	ке´рнер
киль	кіль
кильватер	кальва´тэр
кильсон	кільсо´н
кинематография	кі´нематаграфі´я
кинжал	кінжа´л
кинжальный	кінжа´льны
кипрегель	кіпрэге´ль
кирка (сан.)	кірка´
кирка-мотыга (в.-инж.)	кірка´-маты´ка
кирпич	цэ´гла
кислород	кісларо´д
кислородная подушка	кісларо´дная паду´шка
кладчик настилки (понт.)	кла´дчык насьці´лу
клапан (авт.)	кля´пан
клапанная камера	кля´панная ка´мэра
класс	кля´са
классификация	клясыфіка´цыя
классовая сознательность	кля´савая сьвядо´масьць
клевок (арт.)	кляво´к
клеевая краска	клеева´я фа´рба
клемма (маш.)	кле´ма
клепан	кле´пан
клин	клін
клинок	кліно´к
клиренс (танк.)	клірэ´нс
клопфер (св.)	клё´пфэр
клуб	клюб
ключ	ключ
кобальт	ко´бальт
ковочная ведомость	ко´вачная ве´дамасьць
код	код
кодовая таблица	ко´давая таблі´ца
коэффициент полезного действия	каэфіцые´нт кары´снага дзе´йства
коэффициент трения	каэфіцые´нт трэ´ньня
кожух	кажу´х
козлостав (понт.)	казласта´ў
козлы	ко´злы
козырек	казыро´к
кокор (арт.)	ко´кар
колебание	хіста´ньне, вага´ньне, калыва´ньне
колебательный контур (рад.)	хіста´льны ко´нтур
коленчатый вал (авт.)	кале´нчасты вал
коленчатый вал (рычаг)	кале´нчасты вага´р
колесо	ко´ла
колея	каляі´на
колиматор	каліма´тар
количество	ко´лькасьць
коллектив	калекты´ў
коллектор (автом.)	кале´ктар
коллекторная щетка (св.)	кале´ктарная шчо´тка
коллекторное кольцо (авт.)	кале´ктарнае кальцо´
колодец водосборный	кало´дзезь вадазбо´рны
колодец минный	кало´дзезь мі´нны
колодец портоновский	кало´дзезь парто´наўскі
колодка (авт.)	кало´дка
колодка прицельная (стр.)	кало´дка прыцэ´льная
колокол (сигн.)	звон
колоколообразный стакан (танк.)	зво´нападо´бная шкля´нка
колониальные войска	калёнія´льнае ва´йска
колонна	калё´на
колотушка (стр.)	пабіва´чка
колпак (автом.)	каўпа´к, капту´р
колпачек (стр.)	каўпачо´к, каптуро´к
колпачек отвертки	каўпачо´к адкру´ткі
кольцовая дорожка дульной накладки (стр.)	кальцава´я даро´жка ду´льнай накла´дкі
кольцевой выступ (арт.)	кальцавы´ вы´ступ
кольцевой паз ствольной коробки (стр.)	кальцавы´ паз ство´льнай каро´бкі
кольцо боевого взвода (стр.)	кальцо´ баяво´га ўзво´да
кольчужный	кальчу´жны
команда	кама´нда
комендант	камэндант
комендантское управление	камэнда´нцкая ўпра´ва
командир	камандзі´р
командирские занятия	камандзі´рскія заня´ткі
командирская разведка	камандзі´рская выве´дка
командная высота	кама´ндная вышыня´
командно-строевой состав	кама´ндна-страявы´ саста´ў, кама´ндна-страявы´ склад
командные курсы	кама´ндныя курсы
командный пункт (КП.)	кама´ндны пункт (КП.)
командование точек	кама´ндваньне кро´пак
комендор (военмор артиллерийской специальности)	камэндо´р
командующие высоты	кама´ндныя вышы´ні
командующий округом	кама´ндуючы акру´гай
комиссар	каміса´р
комиссариат	камісарыя´т
коммуникационная линия	камунікацы´йная лі´нія
коммунист	камуні´ст
коммунистическая партия	камуністы´чная па´ртыя
коммутатор (св.)	камута´тар
коммутация (св.)	камута´цыя
компактный	кампа´ктны
компас	ко´мпас
компенсационный цилиндр (авт.)	кампэнсацы´йны цылі´ндр
компенсация	кампэнса´цыя
комплект	кампле´кт
комплектование	камплектава´ньне
комполитсостав	кампалітсаста´ў, - кампалітскла´д
компрессионные краники (авт.)	кампрэсы´йныя кра´нікі
компрессор (арт.)	кампрэ´сар
комуляция	камуля´цыя
комуфлированный 	камуфлява´ны
комуфляж	камуфля´ж
конвекция	канвэ´кцыя
конвенция	канвэ´нцыя
конвоировать	канваі´раваць
конвой	канво´й
конвойная команда	канво´йная кама´нда
конденсатор	кандэнса´тар
конденсация	кандэнса´цыя
конденсационный сосуд (маш.)	кандэнсацы´йная пасу´дзіна
конечная скорость (авт.)	канцава´я ско´расьць
конечный	канцавы´
коническая гайка (арт.)	кані´чная га´йка
консервация	кансэрва´цыя
консервы	кансэ´рвы
конский противогаз	ко´нскі про´цігаз
конское снаряжение	ко´нскае знаражэ´ньне
консоль (св.)	кансо´ль
конструкция	канстру´кцыя
контакт (авт.)	канта´кт
контингент	кантынгэ´нт
контр-атака	ко´нтр-ата´ка
контр-буфер (арт.)	ко´нтр-бу´фэр
контр-минный	ко´нтр-мі´нны
контр-наступление	ко´нтр-наступле´ньне
контрольная черточка ствола (стр.)	кантро´льная ры´ска ствала´
контрольный пункт	кантро´льны пункт
контрольный столб (св.)	кантро´льны слуп
контр-разведка	ко´нтр-выве´дка
контр-удар	ко´нтр-уда´р
контр-фарс	ко´нтр-фа´рс
контузия	канту´зія
контур	ко´нтур
конус	ко´нус
конус задульный	ко´нус заду´льны
конференция	канфэрэ´нцыя
конфигурация	канфігура´цыя
концентрация	канцэнтра´цыя
концентрационный лагерь	канцэнтрацы´йны ля´гер
координаты	каардына´ты
копер (в.-инж.)	капё´р
копье	кап'ё´
кордит (вид бездымного пороха)	карды´т
кордон	кардо´н
корень	ко´рань
короб (арт.стр.)	ко´раб
коробка	каро´бка
коромысло	каро´мысла
корпус	ко´рпус
корректирование	карэктава´ньне
корректор	карэ´ктар
косвенный	уско´сны
косой	ко´сы
косоприцельный	косапрыцэ´льны
костыль (ав.)	касты´ль
костюм маскировочный	касьцю´м маскірава´льны
костяк	касьця´к
котелок	кацяло´к
котлован	катлава´н
котловина	катлаві´на
кошка (ав. - прибор для принятия авиаграммы)	ко´шка
коэффициент	каэфіцые´нт
кран	крант
краскомет	фарбамё´т
Красная армия	Чырво´ная а´рмія
красная доска	чырво´ная до´шка
красная присяга	чырво´ная прыся´га
красноармеец	чырво´наарме´ец
красноармейский	чырво´наарме´йскі
красногвардейский отряд	чырво´нагвардэ´йскі
краснота	чы´рвань
красящее вещество	хварбу´ючае рэчыва
крейсер	крэ´йсэр
краткосрочный	каро´ткатэрміно´вы
крейцкопф (авт.)	крэ´йцко´пф
кремальера	крэмалье´ра
кремальерный тип	крэмалье´рны тып
кренгельс (м.понт.)	крэ´нгельс
кренометр (ав.)	крэно´мэтр
крепление	змацава´ньне; (процесс) - змацо´ўваньне
крепость	крэ´пасьць
крестовина (в.-инж.)	крыжаві´на
кривизна	крывізна´
криволинейная траектория	крываліне´йная траекто´рыя
кривошып(кривошип) (танк.)	крывашы´п
кривошипный механизм (авт.)	крывашы´пны мэхані´зм
криптография	крыптагра´фія
кристаллы	крышта´лі
критический	крыты´чны
кроки	кро´кі
кронверк	кранвэ´рк
кронциркуль	кранцы´ркуль
кронштейн	кранштэ´йн
круговой желобок (стр.)	кругавы´ жалабо´к
круговой паз (стр.)	кругавы´ паз
кругооборот	кругазваро´т
кругообразный	кругападо´бны
круг поворотный	круг паваро´тны
крупный	бу´йны
крутая траектория	крута´я траекто´рыя
крутизна	круці´зна
крутость	кру´тасьць
крытый	нары´ты
крышечный клапан	ве´чкавы кля´пан
крышка	ве´чка
крюйт-камера	кру´йт-ка´мэра
крючек спусковой (стр.арт.)	кручо´к спускавы´
ксилил (хим.)	ксылі´л
кубрик (морск.)	ку´брык
кузов (автом.)	ку´заў
кулачек (стр.)	кулачо´к
кульминационный	кульмінацы´йны
курок	куро´к
курсант	курса´нт
курсомер (арт.)	курсаме´р
куртина	курці´на
куст свай (в.-инж.)	куст па´ляў
кучность	ку´чнасьць
кювет	кювэ´т
кюрвиметр	кюрвімэ´тр
лаг (морск. - прибор для измерения пройденного судном расстояния)	ляг
лагерь	ля´гер
ладыга (арт.)	лады´га
ладыжка (стр.)	лады´жка
лазарет	лазарэ´т
лазаретная линейка	лазарэ´тная ліне´йка
лазутчик	лазу´тчык
лайба (морск.)	ла´йба
лак	ляк
лакримотор (хим.)	ля´крымато´р
ландкарта	ляндка´рта
лапки обоймы	ла´пкі або´ймы
лапчатый (стр.)	лапча´сты
латунь	лату´нь
лафет-тумба	ляфэт-ту´мба
лебёдка	лябё´дка
легенда	легэ´нда
легкий	лё´гкі
легкобомбардировочная авиация	лёгкабамбава´льная авіа´цыя
лежень береговой	ле´жань берагавы´
лезвие (стр.)	ля´зо
лекала	ляка´ла
лекарский помощник	ле´карскі памо´чнік
ленинский уголок	ленінскі куто´к
лента	істу´жка, ле´нта
лентопротяжный валик (св.)	і´стужкапраця´жны валё´к, лентапраця´жны валё´к
ленточный порох (арт.)	істу´жачны по´рах, лентачны по´рах
ленчик (часть седла)	ле´нчык
лестница	драбі´ны, лесьвіца
летать	лята´ць
летик (голуб.ст.)	лё´цік
летнее обмундирование	ле´тняе абмундзірава´ньне
летучая жидкость	ляту´чая ва´дкасьць
летчик-наблюдатель (ав.)	лё´тчык-назіра´льнік
лечебное заведение	ле´кавая ўстано´ва
ликвидационный	ліквідацы´йны
ликвидация	ліквіда´цыя
ликвидировать	ліквідава´ць
лимб (пеленгат.станц.)	лімб
линейка	ліне´йка
линейный	ліне´йны
линза (арт.)	лі´нза
линия	лі´нія
лирка	лі´рка
лиственный лес	лісьцяны´ лес
листовка	лісто´ўка
лист	ліст
лист (о припасах)	ліст (аб прыпа´сах)
лисья нора (в.и.ж.)	лісі´ная нара´
литер	лі´тэр
личная разведка	асабо´вая выве´дка
личный	асабо´вы
лобовая часть лафета	лабава´я ча´стка ляфэ´ту
ловкость	спры´тнасьць, ло´ўкасьць
ловушка	па´стка
лог	лог
ложа	ло´жа
ложевое кольцо (стр.)	ло´жавае кальцо´
ложевые глазки (стр.)	ло´жавыя во´чкі
ложемент (в.-инж.)	лажамэ´нт
ложиться 	лажы´цца
лозунг	лё´зунг
лом	лом
ложный	абма´нны, фальшы´вы
лонжерон	лёнжаро´н
лопасть (стр.)	ло´пасьць
лопата	лапа´та
лопатка	лапа´тка
лот (морск.)	лот
лоток-кокор (арт.)	лато´к-како´р
лоция (морск.авиац.)	ло´цыя
лоцман (морск.)	ло´цман
лошадь	конь
лощина	лагчы´на
лубок	лубо´к
лубрикатор (автом.)	лубрыка´тар
лука (у седла)	лука´
лунка	я´мка
лупа	лу´па
луч (прож.)	праме´нь
лыжи	лы´жы
лыжник	лы´жнік
люверсы (ав.)	лювэ´рсы
люизит (хим.)	люізі´т
люк	люк
люлька (арт.стр.)	лю´лька
люнет (в.инж.)	люнэ´т
люфт (брон.арт.)	люфт
лямка	ля´мка
магазин (стр.)	магазы´н
магазинный	магазы´нны
магистраль	магістра´ль
магнето (авт.тр.)	магнэ´то
магний	ма´гній
магнит	магні´т
магнитная стрелка	магні´тная стрэ´лка
май	май
макет	маке´т
малая чувствительность	мала´я чу´ласьць
малозарядный	малазара´дны
малочисленный	малалі´кі
маневр	манэ´ўр
маневрирование	манэўрава´ньне
маневрирующий	манэўру´ючы
манеж	мане´ж
манетка (тракт.)	мане´тка
манжет (авт.)	манжэ´т
манипулятор (св.)	маніпуля´тар
манометр	мано´мэтр
мантелет (инж.)	мантэ´лет
марксизм-ленинизм	марксы´зм-леніні´зм
марс (морск. - площадка на мачте)	марс
марсовый (морск.)	ма´рсавы
март	сакаві´к
марш	марш
маршевая рота	ма´ршавая ро´та
маршировать	маршава´ць, маршырава´ць
маршрут следования	маршру´т руху
маска	ма´ска
маскировка	маскіро´ўка
маскируясь	маскіру´ючыся
масленка	масьлё´нка
масса	ма´са
массирование огня (арт.)	масава´ньне агня´
массовый огонь	ма´савы аго´нь
мастика восковая	масьці´ка васко´вая
масштаб	масшта´б
мата	ма´та
материальная часть	матэрыя´льная ча´стка
материк	кантынэ´нт
матка (арт.)	ма´тка
матрос-кок (морск. - повар)	матро´с-кок
маховичок (авт.-бр.)	махавічо´к
маховик (маш.)	махаві´к
маховое колесо (маш.)	махаво´е ко´ла
мачта	ма´чта
машина	машы´на
маяк	мая´к
медицинский	меды´чны
медлительность	паво´льнасьць, мару´днасьць
медперсонал	мэдпэрсана´л
междусборовая работа	міжзбо´равая рабо´та
мелинит	мэліні´т
мелкая мушка	мала´я му´шка, дро´бная му´шка
мембрана (рад.авт.)	мэмбра´на
мензула	мэ´нзула
мерная лента	ме´рная істу´жка, ме´рная ле´нта
мерная рейка (изм.)	ме´рная рэ´йка
мерная цепь	ме´рны ланцу´г
мертвое пространство	мё´ртвая прасто´ра
мертвые петли (ав.)	мё´ртвыя пе´тлі
меры поощрения	ме´ры заахво´чвання
меры предосторожности	ме´ры перасьцяро´гі
местность	мясцо´васьць
метание	кіда´ньне
метальщик	кіда´льшчык
метацентр	мэтацэ´нтр
метеорология	мэтэаралё´гія
метилдихлорарсин	мэты´льдыхлё´рарсі´н
метко	тра´пна
меткость	тра´пнасьць
метод	мэ´тод
метр	мэтр
механический	мэхані´чны
механическое раздробление	мэхані´чнае раздрабне´ньне
мешок землянистый	мяшо´к земляні´сты
мешок Иолшина (в.-инж.)	мяшо´к Іо´лшына
мигание 	міга´ньне
микрометрический винт	мікрамэтры´чны вінт
микротелефон (св.)	мікратэлефо´н
микрофон (св.)	мікрафо´н
милитаризм	мілітары´зм
милиампер (св.)	міліампэ´р
милиция	мілі´цыя
милиционная система	міліцы´йная сыстэ´ма
мимикрия	мімі´крыя 
мина	мі´на
минное убежище (в.-инж.)	мі´ннае схо´вішча
минный заградитель (воен.судно)	мі´нны заграджа´льнік
миноискатель (морск.)	мінашука´льнік
миномет	мінамё´т
минометный огонь	мінамё´тны аго´нь
миноносец (воен.судно)	мінано´сец
митинг	мі´тынг
мишень	мішэ´нь
младший	мало´дшы
многооборотный (авт.)	многабо´ртавы
многократный	многакра´тны, шматразо´вы
многотиражка	шматтыра´жка
мобилизационный план	мабілізацы´йны плян
мобилизация	мабіліза´цыя
могущество	магу´тнасьць
модератор (арт.)	мадэра´тар
мол (морск.)	мол
монитор (моторное или паровое мелко-сидящее бронированное судно)	маніто´р
моноблок (авт.)	монаблё´к
монокуляр (прож.)	монакуля´р
монометр	мано´мэтр
моноплан (ав.)	монапля´н
монохлор-мятия (хим.)	монахлё´р-мя´ція
моральная стойкость	мара´льная ўсто´йлівасьць
моральный	мара´льны
мортира	марты´ра
мост	мост
моторизация	матарыза´цыя
моторизированные части	матарызава´ныя ча´сьці
мотоцикл	матацы´кль
мотоциклетный	матацыкле´тны
мотоциклист	матацыклі´ст
мотыга (сап.)	маты´га
мотыль (стр.)	маты´ль
мочала	мача´ла
мочка (у хомута)	мо´чка
мощность	магу´тнасьць
мощь	сі´ла
мужественно	му´жна, адва´жна
мужественность	му´жнасьць, адва´жнасьць
мундштук (кав.)	муншту´к
мундштучное суголовье	муншту´чнае сугало´ўе
муфта (арт.)	му´фта
мушка	му´шка
мышеловка	па´стка
мышьяк	арсэ´ньнік
набивка лент	набі´ўка істу´жак, набі´ўка лент
набивка сальниковая	набі´ўка са´льнікавая
наблюдатель	назіра´льнік
наблюдательный пункт (НП)	назіра´льны пункт (НП)
наблюдение	назіра´ньне
набойка	набо´йка
набор повода	набо´р по´вада
навесный	наве´сны
навинтованное очко (арт.)	навінтава´нае во´чка
наводка	наво´дка
наводчик	наво´дчык
навык	звы´чка
нагар	нага´р
нагель	на´гель
нагнетающий рукав	нагнята´льны рука´ў
наготове	напагато´ве
награда	награ´да
награждение	узнагаро´да
нагрудный знак	нагру´дны знак
нагрудный ремень	нагру´дны рэ´мень
надзор	нагля´д
надульник	наду´льнік
наездник	нае´знік
назад	наза´д
наземная разведка	назе´мная выве´дка
назначение	назначэ´ньне
найменьший прицел	найме´ншы прыцэ´л
накаливание	награва´ньне, напа´льваньне
накапливание	нако´пліваньне
накапливаться	нако´плівацца
накатник	нака´тнік
накладка	накла´дка
наклонение	нахіле´ньне
наклонность	нахі´л, нахі´льнасьць
наковальня 	кава´дла
наконечник ленты	накане´чнік істу´жкі
нактоуз (морск. - шкафик для компаса)	накто´уз
налево	нале´ва
наливная дыра	наліўна´я дзі´рка
наливной элемент	наліўны´ элемэ´нт
наличие	ная´ўнасьць
наличный состав	ная´ўны саста´ў, ная´ўны склад
налобник (уздечка)	нало´бнік
намерение	наме´р
наметка (брон.арт.)	по´крыўка
наносный	нано´сны
нападение	напа´д
напар'е трубчатое	напа´р'е трубча´стае
напилок	напі´лак
напирать	напіра´ць, націска´ць
напоминание	напамі´нак
направление	кіру´нак, напра´мак
направляющая чатсь	накіро´ўчая часьць
направо	напра´ва
нарушение	парушэ´ньне
нарыв	нары´ў
нарывное действие	нарыўно´е дзе´йства
наряд	нара´д, прызначэ´ньне
нарядить в караул	прызна´чыць у караву´л
наряжаемый	прызнача´льны
наряженный	прызна´чаны
насадка	наса´дка
нарезной стволик	наразны´ ство´лік
наружная трубка	знадво´рная тру´бка
наружный пост	знадво´рны пост
нарез (стр.)	нарэ´з
напряженность огня	напру´жанасьць агня´
наседать на противника	насяда´ць на праці´ўніка
наседающие части	насяда´ючыя ча´сьці
наставление	настаўле´ньне
настигать (кого-либо)	наганя´ць, даганя´ць
настигать (о ветре, дожде)	захапля´ць
настил 	насьці´л
настилка (в.-инж)	насьці´лка
настилочная повозка (понт.)	насьці´лачная паво´зка
настильность боя (стр.)	насьці´льнасьць бо´ю
настойчиво	насто´йліва
настойчивость	насто´йлівасьць
настроение	настро´й
наступательный	наступа´льны
наступление	наступле´ньне
насыпь	на´сып
насыщать	насыча´ць
насыщенность	насы´чанасьць
насыщенный раствор	насы´чаны раство´р
натиск	на´ціск
натяжной винт	нацяжны´ вінт
наугольник	навуго´льнік
нафтоль	нафто´ль
находчивость	здага´длівасьць, знахо´длівасьць
нахрапник (уздечка)	нахра´пнік
национально-революционная война	нацыяна´льна-рэвалюцы´йная вайна´
начальная скорость (стр.)	пачатковая ско´расьць
начальник гарнизона	нача´льнік гарнізо´ну
начальник караулов	нача´льнік караву´лаў
начальник связи	нача´льнік су´вязі
начальник военно-хозяйственного снабжения (Нач.ВХС)	нача´льнік вае´нна-гаспа´дарчага забесьпячэ´ньня (Нач.ВГЗ)
начальник военно-воздушных сил моря (ВВС моря)	нача´льнік вае´нна-паве´траных сіл мо´ра (ВПС мо´ра)
начальник штаба армии (начштарм)	нача´льнік шта´ба а´рміі (начштарм)
начальник политотдела дивизии (начподив)	нача´льнік палітаддзе´лу дыві´зіі (начпады´ў)
начальник эшелона	нача´льнік эшалё´ну
начальствующий состав (начсостав)	нача´льніцкі саста´ў, нача´льніцкі склад (начсаста´ў)
начальник военной дороги (начвоендор)	нача´льнік вае´ннай даро´гі (начваенда´р)
начертание	на´рыс
нашатырь	нашаты´р
нашильный крюк	нашы´льны крук
неблагоприятный	няспрыя´ючы
невыбрасывание гильзы	нявыкіда´ньне гі´льзы
негашеная известь (хим.)	няту´шаная ва´пна
недовольство	нездаво´леньне
недолет	недалё´т
недосмотр	недагля´д
недоступный участок	няпрысту´пны вуча´стак
недоуздок	ка´нтар
неизбежный	няўхі´льны, няміну´чы
неисправность	няспра´ўнасьць
неисправный	няспра´ўны
неиспытнанный	неапрабава´ны, нявы´прабаваны
нейтрализация	неўтраліза´цыя
неожиданно	нечака´на
неоднородность	неаднаро´днасьць
нейтральный	неўтра´льны
неоктинический	неатыні´чны
неопытный	няво´пытны, неспрактыкава´ны
неослабный	неасла´бны
неосторожный	неасьцяро´жны
неотвязный	неадчэ´пны
неотражение (стр.)	неадбіва´ньне
неочередной	нечарго´вы
непобедимый	неперамо´жны
неповиновение	непаслушэ´нства
неподвижная цель	нерухо´мая цэль
непоражаемое пространство	непаража´льная прасто´ра
непосредственное охранение	непасрэ´дная ахо´ва
непосредственный начальник	непасрэ´дны нача´льнік
непрерывный	бязупы´нны
неприкосновенный запас	непару´шны запа´с
непринужденно	свабо´дна
неприятель	не´прыяцель
неприятельская территория	тэрыто´рыя праці´ўніка
непродолжительный 	каро´ткі, нядо´ўгі
непромокаемая ткань	непрамака´льная ткані´на
непроницаемый	непраніка´льны
нерастворимый	нераство´рны
нервюра (ав.)	нэрвюра´
нерешительный	нерашу´чы
несоблюдение	незахава´ньне
нестойкие (ОВ)	нясто´йкія (АР)
нестроевой	нестраявы´
неуклонно	няўхі´льна
неустанный	бязупы´нны
неустрашимость	бязбо´язнасьць
нефоскоп (метеор.)	нэфаско´п
нефтепродукт	нафтапраду´кт
нечаянный выстрел	ненаўмы´сны стрэл, ненаўмы´сны выстрал
нивеллир (топ.)	нівэлі´р
нивеллировать	нівэлі´раваць
нивеллировка	нівэліро´ўка
нижнее окно (стр.)	ні´жняе акно´
нижний спуск (стр.)	ні´жні спуск
ниппель (часть распылителя)	ні´пэль
нитроглицерин	нітрагліцэры´н
нитроклетчатка	нітракле´тчатка
ниша (в.-инж. - в окопе)	ні´ша
новобранец	навабра´нец
ножницы	нажні´цы
ножны	но´жны
ножовка	нажо´ўка
номератор (св.)	нумэра´тар
номограмма (арт.)	номогра´ма
нониус (арт.)	но´ніус
нос (ав.морск.)	нос
носилки	насі´лкі
носимый прибор заряжения	насі´мы прыбо´р заражэ´ньня
носки (стать на носки)	наскі´
носки (на ноги)	шкарпэ´ткі
носовой зажим	насавы´ заціска´ч
ночлег	начле´г
ночная атака	начна´я ата´ка
ноябрь	лістапа´д
нулевой	нулявы´
оазис	аа´зіс
обвинительный акт	абвінава´ўчы акт
обезвреживание	абясшко´дваньне
обеззараживание	абеззара´жваньне
обезоружить	абяззбро´іць
обеспечение	забесьпячэ´ньне
обеспеченность	забясьпе´чанасьць
обжим (в.-инж.инструм.)	абціска´ч
обзор	агля´д
облако газа (хим.)	во´блака га´зу
облегченная рысь (хим.)	абле´гчаная рысь
облический	аблі´чны
обмораживание	абмаро´жваньне
обмотка	абмо´тка
обмундирование	абмундзірава´ньне
обнажать, обнажить (фронт)	агаля´ць, агалі´ць
обнаруживать	выяўля´ць
ободовый ремень	абадо´вы рэ´мень
обоз	або´з
обозное довольствие	або´знае забесьпячэ´ньне
обойма (стр.)	або´йма
оболочка холщевая	абало´нка палатня´ная 
оборонительная полоса	абаро´нчая паласа´
оборонительный	абаро´нчы
обороняющийся	у абаро´не
оборудование	абсталява´ньне
обочина дороги	або´чына даро´гі
образец	узо´р
образуется 	утвара´ецца
обратно	наза´д
обрез	абрэ´з
обрез дульца гильзы (стр.)	абрэ´з ду´льца гі´льзы
обрушиваться (на противника)	нава´львацца, напада´ць
обрушиваться (о строении)	валі´цца, разва´львацца
обсадка	абса´дка
обследовать	абсьле´даваць
обстановка	абстано´ўка
обстрел	абстрэ´л
обстреленность	абстрэ´ленасьць
обстреливамая зона	абстрэ´льваемая зо´на
обстреливание	абстрэ´льваньне
обтекать	абцяка´ць
обтекатель (ав.)	абцяка´льнік
обтюратор (арт.стр.)	абцюра´тар
обтюрация	абцюра´цыя
обувь	абу´так
обход	абхо´д
обшлаг	абшла´г
общение	су´вязь
общевойсковый	агульнавайско´вы
общественно-политический	грама´дзка-паліты´чны
об'ект	аб'е´кт
об'ектив (арт.)	аб'екты´ў
об'емное действие ОВ	аб'ё´мнае дзе´йства АР
об'явление	абвяшчэ´ньне, абве´стка
обязанность	абавя´зак
овальные части (стр.)	ава´льныя ча´сткі
огневой мешок	агнявы´ мяшо´к
огневой шквал	агнявы´ шквал
огневые клещи	агнявы´я абцугі´
огнемет	агнямё´т
огнеопасный	агнянебясьпе´чны
огнеприпасы	агнязапа´сы
огнеприводные шнуры	агняпрыво´дныя шнуры´
огнестрельное оружие	агнястрэ´льная збро´я
оголовье (кавал.)	агало´ўе
огонь	аго´нь
огонь косоприцельный	аго´нь косапрыцэ´льны
огонь продольный	аго´нь прадо´ўжны
огонь фланговый	аго´нь фля´нгавы
огонь фронтальный	аго´нь франта´льны
огонь навесный	аго´нь наве´сны
огонь очередями	аго´нь чарга´мі
огонь перекидной	аго´нь перакідны´
ограничитель	абмежава´льнік
одежда окопа (в.-инж.)	адзе´жа ако´пу
одиночная стрельба	адзіно´чная стральба´
одиночный выстрел	адзіно´чны стрэл, адзіно´чны вы´страл
однообразие прицеливания	аднаста´йнасьць прыцэ´льваньня
односторонний 	аднабако´вы
однофазный ток (электр.)	аднафа´зны ток
ожесточенный бой	жо´рсткі бой, заця´ты бой
оживление 	ажыўле´ньне
ожигающий	апаля´ючы
озокерит (связь)	азакеры´т
озокеритная ткань	азакеры´тная ткані´на
окаймление	акаймле´ньне
окаймлять	акаймо´ўваць
окапывание (в.инж.)	ако´пваньне
окапываться 	ако´пвацца
окарауливание	акараву´льваньне
окислитель	акісьля´льнік
окислить	акісьлі´ць
окись углерода	во´кіс вугляро´ду
окись цинка	во´кіс цы´нку
оккупация	акупа´цыя
окно	акно´
окоп пулемётный	ако´п кулямё´тны
окоп стрелковый	ако´п стралко´вы
окоп орудийный	ако´п гарма´тны
окоп ячейковый	ако´п ячэ´йкавы
окоп расчлененный	ако´п расчленава´ны
окоп ложный	ако´п фальшы´вы
окружать, окружить	абкружа´ць, абкружы´ць
окружение	абкружэ´ньне
октябрь	кастры´чнік
Октябрьская революция	Кастры´чніцкая рэвалю´цыя
окуляр (срт.)	акуля´р
окуривать	абку´рваць
олеум	але´ум
олифа	алі´ва
ольдгамовское соединение	альдга´маўскае злучэ´ньне
омметр (св.)	амэ´тр
опасное направление	небясьпе´чны кіру´нак
опасность	небясьпе´ка
оперативная сводка	апэраты´ўная зво´дка
оперативное распоряжение	апэраты´ўнае распараджэ´ньне
операция	апэра´цыя
опериливание (понт.)	апарэ´нчываньне
оперировать	апэрава´ць
опись поста	во´пісь паста´
опидометр (авт.)	апідамэ´тр
оповещение	апавяшчэ´ньне
опознание	апазна´ньне
опознавательный	апазнава´льны
опора	апо´ра
опорная щека (маш.)	апо´рная шчака´
опорный башмак (маш.)	апо´рны башма´к
опорный клин (арт.)	апо´рны клін
опорный пункт (ОП)	апо´рны пункт (АП)
оппортунизм	апартуні´зм
оправа поперечного уровня (авт.)	апра´ва папярэ´чнага ўзро´ўню
оправдывать	апра´ўдваць
оправиться	апра´віцца
определение расстояния	вызначэ´ньне адле´гласьці
оптика	о´птыка
оптическая сигнализация	опты´чная сыгналіза´цыя
оптический пирометр	опты´чны пірамэ´тр
оптический прицел (арт.)	опты´чны прыцэ´л
оптическое измерение скорости (маш.)	опты´чнае вымярэ´ньне ско´расьці
опускай	апуска´й
опустошение	спусташэ´ньне
опыт	во´пыт
опытная мобилизация	во´пытная мабіліза´цыя
организационно-политическая работа	арганізацы´йна-паліты´чная рабо´та
организация работ	арганіза´цыя рабо´т
организация химнападения	арганіза´цыя хімнапа´ду
организация химобороны	арганіза´цыя хімабаро´ны
организация химразведки	арганіза´цыя хімвыве´дкі
организация химтревоги	арганіза´цыя хімтрыво´гі
органы военного управления	о´рганы вае´ннага кіраўні´цтва
органы снабжения	о´рганы забесьпячэ´ньня
орден Красной Звезды	о´рдэн Чырво´най Зьвязды
орден Красного Знамени	о´рдэн Чырво´нага Штанда´ру
орден Ленина	о´рдэн Ле´ніна
орден трудового Красного Знамени	о´рдэн працо´ўнага Чырво´нага Штанда´ру
ординарец	ардына´рац
ордината	ардына´та
ориентация	арыента´цыя
ориентир	арыенты´р
ориентироваться	арыентава´цца
ориентировка	арыентыро´ўка
орнитоптер (ав.)	арніто´птар
ортоскоп	артаско´п
орудие	гарма´та
оружейная мастерская	збро´йная майстэ´рня
орудийное гнездо (арт.)	гарма´тнае гняздо´
орудийное учение (арт.)	гарма´тнае вучэ´ньне
орудийный начальник (арт.)	гарма´тны нача´льнік
орудийный расчет (арт.)	гарма´тны разьлі´к
оружие	збро´я
осадить	асадзі´ць
осведомленность	асьвядо´мленнасьць
осветительная система (прож.)	асьвятля´льная сыстэ´ма
осветительный пистолет	асьвятля´льны пістале´т
осевой подшипник	во´севы падшы´пнік
оседлать, оседлывать	асядла´ць, асё´длываць
осечка (стр., арт.)	асе´чка
осколок (снаряд)	аско´лак
осколочно-химический снаряд	аско´лкава-хімі´чны знарад
осколочный	аско´лкавы
ослабление	аслабле´ньне
ослаблять	аслабля´ць
ослепление	асьляпле´ньне
осмотр	агля´д
оснастка столба (св.)	асна´стка слупа´
основа замка (стр.)	асно´ва замка´
основа станка (стр.)	асно´ва станка´
основание масштаба 	асно´ва масшта´бу
основание прицела (стр.)	асно´ва прыцэ´лу
основное орудие	асно´ўная гарма´та
особое направление	асо´бны кіру´нак
остов станка (замка)	шкіле´т станка´ (замка´)
остов треноги (стр.)	шкіле´т трыно´гі
остойчивость (ав.)	асто´йлівасьць
острие	вастрыё´
острога	во´сьці
ось барабана (стр.)	вось бараба´на
ось курка (стр.)	вось курка´
отбить	адбі´ць
отбой	адбо´й
отборочная комиссия	адбо´рачная камі´сія
отбросить противника	адкі´нуць праці´ўніка
отвал (понт.)	адва´л
отверстие	адту´ліна
отвертка	адкру´тка
ответвление	адгалінава´ньне
ответственная полоса	адка´зная паласа´
ответственность	адка´знасьць
отвоевать	адваява´ць
отдать трос (морск.-отв.трос.)	адвяза´ць трос
отдача	адда´ча
отдел	аддзе´л
отделение	аддзяле´ньне
отдельный 	асо´бны, паасо´бны
отдельный разъезд (О.Р.)	асо´бны разье´зд (А.Р.)
откат (арт.)	адка´т
откидная рамка (стр.)	адкідна´я ра´мка
отклонение	адхіле´ньне
отклонитель (маш.)	адхіля´льнік
откомандировать	адкамандырава´ць
откос	адко´с
открывать огонь	адкрыва´ць аго´нь
открытая местность	адкры´тая мясцо´васьць
отличный	адме´нны, адметны
отлогая траектория	пака´тая траекто´рыя
отлогость (в.-инж.)	пака´тасьць
отмах (сигнал)	адма´х
отметка	адзна´ка
отметка высоты	адзна´ка вышыні´
отомкнуть штык	адамкну´ць штых
отпор	адпо´р
отпрягай	адпрага´й, выпрага´й
отработанный	адпрацава´ны
отравление	атручэ´ньне
отравленный	атру´чаны
отравляющая волна	атру´тная хва´ля
отражатель	адбіва´льнік
отражательный выступ (мтр.)	адбіва´льны вы´ступ
отражать	адбіва´ць
отрицательный	адмо´ўны
отряд	атра´д
отряд особого назначения (ОСНАЗ)	атра´д асо´бага прызначэ´ньня (Аспры´з)
отсек (в.-инж.)	адсе´к
отсекающий зуб (стр.)	адсяка´ючы зуб
отсечение	адсячэ´ньне
отсечка-отражатель (стр.)	адсе´чка-адбіва´ч
отставить	адста´віць
отстойник (авт.)	адсто´йнік
отстойчивость (ав.)	адсто´йлівасьць
отступательный	адступа´льны
отступление	адступле´ньне
отсыпь (маск.)	во´дсып
оттенение 	адцяне´ньне
оттяжка (св.)	адця´жка
от'езд	ад'е´зд
оценка	ацэ´нка
охранительный блиндаж (в.-инж.)	ахава´льны блінда´ж
охранение	ахава´ньне
охрана	ахо´ва
отчетная карточка	справазда´чная ка´ртка
охват фланга	абхва´т фля´нга
охлаждающий язычек	ахаладжа´льны язычо´к
очередной	чарго´вы
очко (арт.)	во´чка
паек	паё´к
пажилина (в.-инж. - часть моста)	пажы´ліна
паз ствольной коробки (стр.)	паз ство´льнай каро´бкі
пакгауз	пакга´уз
пакет	паке´т
палатка	пала´тка
палец (стр., арт.)	па´лец
палечник	па´лечнік
палуба (пол на корабле)	па´луба
пальба	пальба´
панель (инж. - часть железнодорожного моста)	панэ´ль
паника	па´ніка
панорама (арт.)	панара´ма
панорамный перископ	панара´мны пэрыско´п
пантанёр	пантанё´р
пантограф	панто´граф
панцырь	па´нцыр
параван (прибор, предохраняющий судно от мин.заграждения)	парава´н
парад	пара´д
парализовать	паралізава´ць
параллельное преследование	парале´льнае прасьле´даваньне
параллельный веер	парале´льны ве´ер
парапет (в.-инж.)	парапэ´т
парафин	парафі´н
парашют	парашу´т
парк (арт.)	парк
парламентер	парлямэнцё´р
парный пост	па´рны пост
паравоз	параво´з
паро-дизель	пара-ды´зель
пароль	паро´ль
паром	паро´м
парообразный	парападо´бны
пароотводное отверстие	параатво´дная адту´ліна
пароход	парахо´д
партизан	партыза´н
партийная комиссия	парты´йная камі´сія
партийный	парты´йны
партийно-политическое руководство	парты´йна-паліты´чнае кіраўні´цтва
партия	па´ртыя
партийная организация	парты´йная арганіза´цыя
парусина	парусі´на
пассивная оборона	пасы´ўная абаро´на
патрон	патро´н
патрон унитарный	патро´н уніта´рны
патронник (стр.)	патро´ньнік
патронные коробки	патро´нныя каро´бкі
патронный вьюк (стр.арт.)	патро´нны ю´к(часцей ў слоўніку сустракаецца «ўюк»)
патронташ	патранта´ш
патрубок (арт.брон.)	патру´бак
патруль	патру´ль
пахва (уздечка)	па´хва
педаль (авт.)	пэда´ль
педаль сцепления	пэда´ль счапле´ньня
пеленг (угол, заключенный между магнитным меридианом и румбом)	пэ´ленг
пеленгатор (морск. - прибор, установленный на компасе для определения компосного направления)	пэленга´тар
пеленгаторный (св.)	пэленга´тарны
пеленгация (прож.)	пэленга´цыя
пеленгирование	пэленгава´ньне
пеленговать (засек.направл.)	пэлегава´ць
пенек ствола (стр.)	пянё´к ствала´
пеньковый фитиль	пянько´вы кнот
перебрасывание войск	перакі´дваньне во´йска
первая шеренга	пе´ршая шарэ´нга
первичный 	першапачатко´вы, першаразо´вы
пергамент	пэрга´мант
перебежка	перабе´жка
перебежчик	перабе´жчык
перебой 	перабо´й
переброска	перакі´дка
перевал	перава´л
перевес	перава´га
переводина (в.-инж.)	перекла´дзіна
перевозочные средства	пераво´зачныя сро´дкі
перевязка	перавя´зка
перевязочный отряд	перавя´зачны атра´д
перегруппировка сил	перагрупо´ўка сіл
перегруппировка средств	перагрупава´ньне сро´дкаў
передача (авт.)	перада´ча
передаточный пост	перада´тачны по´ст
передатчик	перада´тчык
передвижение	перасо´ўваньне
передний конец ствола	пярэ´дні кане´ц ствала´
передний ход (арт.)	пярэ´дні ход
передняя выдвижная лапа (стр.)	пярэ´дняя высо´ўная ла´па
передовая линия	перадава´я лі´нія
передок	перадо´к
передышка	перады´шка
перезарядка (стр.)	перазара´дка
перезаряжать, перезарядить (стр.)	перазараджа´ць, перазарадзі´ць
перекат	перака´т
перекидная сапа (в.-инж.)	перакідна´я са´па
перекидной огонь	перакідны´ аго´нь
перекличка	пераклі´чка
переключатель (св.)	пераключа´льнік
перекос патрона (стр.)	перако´с патро´на
перекрестный	скрыжава´ны
перекрещивание	скрыжава´ньне
перелесок	перале´сак
перемена (цели, направл.)	пераме´на
переменная скорость	пераме´нная ско´расьць
переменный состав	пераме´нны саста´ў, пераме´нны склад
переменный ток (св.)	пераме´нны ток
переметная сума	перакідна´я то´рба
перемещение	перамяшчэ´ньне
перемычка (арт.)	перамы´чка
перенос	перано´с
переносная засека (в.-инж.)	перано´сная засе´ка
переносные препятствия	перано´сныя перашко´ды
переподчинение	перападнача´леньне
переползать	перапаўза´ць
переправа	перапра´ва
переправочные средства	перапра´вачныя сро´дкі
перепряжка	перапрага´ньне
перерыв огня	перары´ў агню´
переседлывать	перасядла´ць
пересекать	перасяка´ць
пересеченная местность	перасе´чаная мясцо´васьць
пересмотр	перагля´д
перестрелка	перастрэ´лка
перестроение	перастрае´ньне
перетягивание	пераця´гваньне
перехватывание	перахва´тваньне
переход	перахо´д
перила (в.-инж. - части моста)	парэ´нчы, по´ручні
перископ (вертикальная подзорная трубка)	пэрыско´п
перо (стр.-ч.пруж.)	пяро´
передовой питательный пункт (ПЕР ПИТ)	перадавы´ харчавы´ пу´нкт (ПХП)
перпендикуляр	пэрпэндыкуля´р
петарда (падрыв.)	пэта´рда
петлица	пятлі´ца
пехота	пяхо´та
пехотная разведка	пяхо´тная выве´дка
пехотная часть	пяхо´тная часьць
печатная агитация	агіта´цыя праз друк
пешеходный 	пешахо´дны
пеший	пе´шы
пешим порядком	пе´шым пара´дкам
пешком 	пехато´ю
пика	пі´ка
пикет	піке´т
пикирование (прож.)	пікі´раваньне
пикировать (прож.)	пікі´раваць
пикнометр	пікно´мэтр
пикраты	пікра´ты
пикриновая кислота	пікры´навая кіслата´
пилот	піло´т
пилотаж (ав.)	пілата´ж
пилотажная фигура (ав.)	пілата´жная фігу´ра
пилотировать	пілётава´ць
пироксилин	піраксылі´н
пироксилиновая шашка	піраксылі´навая ша´шка
пирометр	піро´мэтр
писарь	пі´сар
пистон	пісто´н
письменный приказ	пісьмо´вы зага´д
письмо	пісьмо´, ліст
питание	харчава´ньне
питание патронами	забесьпячэ´ньне патро´намі
питомник	гадава´льнік
пишущий штифт (св.)	пі´шучы штыфт
плавный спуск курка	пла´ўны спуск ку´рка
плавный ход (маш.)	пла´ўны ход
плавучая база (мор.)	плыву´чая ба´за
плавучая мина (морс.)	плыву´чая мі´на
плакат	пляка´т
пламя	по´лымя
план	пля´н
планетарная передача (танк.)	плянэта´рная перада´ча
планиметр	плянімэ´тр
планиметрирующий индикатор	плянімэтру´ючы індыка´тар
планирование	плянава´ньне
планировать	плянава´ць
планка (стр.-арт.)	пла´нка
планка соединительная	пла´нка злуча´льная
план	плян
планомерно	плянаме´рна
планшет	пляншэ´т
планшетка (прож.)	пляншэ´тка
пластичная пружина	плясты´чная пружы´на(часцей ў слоўніку сустракаецца «спружына»)
пластинки ленты	пласьці´нкі істу´жкі
пластиночная пружина	пласьці´нкавая спружы´на
платформа	пляцфо´рма
плацдарм (инж.)	пляцда´рм
плашмя	пла´зам
плен	пало´н
пленный	пало´нны
плетень (в.-инж.)	пляце´нь
плечики (стр.-арт.)	пле´чкі
пломбир	плёмбі´р
плоскогорие	плоскаго´р'е
плоскозубцы	плосказу´бцы
плоскоострогубцы	пло´скавострагу´бцы
плоскость	пло´скасьць
плот	плыт
плотина	плаці´на
плотность	шчы´льнасьць, шчы´тнасьць
площадка	пляцо´ўка
площадка замка (стр.)	пляцо´ўка замка´
площадка пулемётная	пляцо´ўка кулямё´тная
площадь	пляц
площадь попадания (стр.)	пло´шча папада´ньня
площадь рассеивания (стр.)	пло´шча расьсе´йваньня
плунжер (машин.)	плюнжэ´р
плутонг (морск. - несколько орудий в одном помещении, имеющих одинаковый угол обстрела)	плюто´нг
пневматика (авт.)	пнэўма´тыка
пневматическая мортира	пнэўматы´чная марты´ра
политическое управление армии (ПУАРМ)	паліты´чная упра´ва а´рміі (Пуарм)
победа	перамо´га
поведение	паво´дзіны
поверка боя винтовки (стр.)	праве´рка бо´ю вінто´ўкі
поверка караулов	праве´рка караву´лаў
повестка	абве´стка
повинность	паві´ннасьць
повозка	паво´зка
повозочный	паво´зачны
поворачивание	поваро´чваньне 
поворотный механизм (стр.-арт.)	паваро´тны механі´зм
поворотный стол (прож.ст.)	паваро´тны стол
повреждение	папсава´ньне, пашко´джаньне
повязка	павя´зка
поглотитель (хим.)	паглына´льнік
поглощение	паглына´ньне
погонный	паго´нны
пограничная охрана (погранохрана)	паграні´чная ахо´ва (пагра´нахо´ва)
пограничный район	паграні´чны раё´н
погреб (в.-инж.)	склеп
подаватель (стр.)	падава´льнік
подавление (огня)	прыдушэ´ньне
подающий механизм (стр.)	падава´льны мэхані´зм
подающий рычаг (стр.)	падава´льны вага´р
подбор	падбо´р
подбородник (уздечка)	падбаро´днік
подвесы	падве´сы
подвижная оборона	рухо´мая абаро´на
подвижная трубка	рухо´мая тру´бка
подвижная цель	рухо´мая цэль
подвижной затвор (стр.)	рухо´мы затво´р
подвижной запас	рухо´мы запа´с
подводная лодка (подлодка)	падво´дная ло´дка (падло´дка)
подвоз	падво´з
подволок (морск. - потолок)	падвало´к
подвязать	падвяза´ць
подвязь	по´двязь
подготовительный	падрыхто´ўчы
подготовка	падрыхто´ўка
подгрудный ремень	падгру´дны рэ´мень
подгруппа (арт.)	падгру´па
поддержка	падтры´мка
поддон (стр.)	паддо´нца, паддо´н
подзорная труба	падзо´рная труба´
политический отдел	паліты´чны аддзе´л
подколенник (арт.)	падкале´ньнік
подкоп	падко´п
подкос (инж.)	падко´с
подкрепление	падмацава´ньне
подлокотник	падлако´тнік
поднимай	падыма´й
поднимание	падыма´ньне
подножка	падно´жка
подножная часть двуколки	падно´жная ча´стка двухко´лкі
подносчик патронов	падно´счык патро´наў
попалзывать, подползти	падпо´ўзваць, падпаўзьці´
подперстье (часть седла)	падпе´рсьце
подпруга	папру´га
подпятник (арт.)	падпя´тнік
подразделение	падразьдзе´л
подрессоренный	падрысо´раны
подручный (арт.)	падру´чны
подрывная машина	падрыўна´я машы´на
подрывные работы	падрыўны´я рабо´ты
подрывные средства (в.-инж.)	падрыўны´я сро´дкі
подседельник	падсядзё´лак, сядзё´лак
подступ скрытый	по´дступ скры´ты
подступы	по´дступы
подсумок	падсу´мак
подтверждение	падцьвярджэ´ньне
подтягивание	падця´гваньне
под уздцы	пад цу´глі
подушка	паду´шка
подчасок	падча´сак
подчиненная часть	паднача´леная часьць
подчиненный	паднача´лены
подшипник	падшы´пнік
подшкипер (морск. - помощник шкипера)	падшкі´пер
под'ездной	пад'яздны´
под'ем	пад'ё´м
под'емная сіла	пад'ё´мная сі´ла
пожилина	пажы´ліна
поздороваться	паздаро´ўкацца, прывіта´цца
позиционная война	пазыцы´йная вайна´
позиция	пазы´цыя
позывной (св.)	пазыўны´
поиски	по´шукі
показная мушка	паказна´я му´шка
показная стрельба	паказна´я стральба´
показчик	пака´зчык
покрытие	пакрыцьцё´
по команде	па кама´ндзе
покрышка (авт.)	по´крыўка
поле боя	по´ле бо´ю
полевая почта	палява´я по´шта
полевой караул	палявы´ караву´л
полевой устав	палявы´ стату´т
полевые войска	паляво´е во´йска
поле канала ствола 	по´ле кана´лу ства´ла
полет пули	палё´т ку´лі
полетная служба (ав.)	лё´тная слу´жба
ползун	паўзу´н
ползушка (маш.)	паўзу´шка
полигон	паліго´н
политический аппарат (политаппарат)	паліты´чны апара´т (палі´тапара´т)
политическое воспитание	політы´чнае выхава´ньне
политические занятия	політы´чныя заня´ткі
политикоморальное состояние	політыкамара´льны стан
политическая информация	політы´чная інфарма´цыя
политическая обстановка	політы´чная абстано´ўка
политическая разведка	політы´чная выве´дка
политическое донесение	політы´чнае данясе´ньне
политическое руководство	політы´чнае кіраўні´цтва
политический орган	політы´чны о´рган
политпросветимущество	політасьветмаё´масьць
политработа	політрабо´та
политический работник	політы´чны рабо´тнік
политический руководитель	політы´чны кіраўні´к
политическая сводка	політы´чная зво´дка
политический состав	політы´чны саста´ў, політы´чны склад
политический суд	політы´чны суд
полица (седло)	по´ліца
полк	полк
полковая артиллерия (ПА)	палкава´я артыле´рыя (ПА)
полный	по´ўны
положение (на фронте)	стано´вішча
полозья	палазы´
полоса	паласа´
полость (стр.)	по´ласьць
полотнище	пало´тнішча
полотняный	палатня´ны
полуверстка	паўвё´рстка
полукапонир	паўкапані´р
полуобратная засечка	паўзваро´тная засе´чка
полупонтон	паўпанто´н
полуприседание	паўпрысяда´ньне
получить	атрыма´ць
полуэлиптическая рессора (автом.)	паўэліпты´чная рысо´ра
полый	пусты´, по´лы
полюс батареи (св.)	по´люс батарэ´і
помощник	памо´чнік
помощной канат (понт.)	дапамо´жны канат
помпа	по´мпа 
понтон (в.-инж.)	панто´н
понтонер	пантанё´р
понтонные части	панто´нныя ча´сьці
поощрение	заахво´чваньне
попадание	папада´ньне
попеременно	папераме´нна
поперечник	папярэ´чнік
поперечный	папярэ´чны
поплавковая камера (авт.)	паплыўко´вая ка´мэра
поплавок	паплыво´к
пополнение	папаўне´ньне
попона	гу´нька
попытка	спро´ба
поражаемое пространство (стр.)	паража´льная прасто´ра
пористость	сі´цістасьць, сітава´тасьць
пором(паром)	паро´м
порох	по´рах
пороховой погреб	парахавы´ склеп
порт	по´рт
портупея	партупэ´я
порты (морск. - отверстия в борту)	по´рты
поручение	даручэ´ньне
поручни (стр.-арт.)	по´ручні
поршень	по´ршань
порыв (стремление)	пары´ў, парыва´ньне
порыв (разрыв)	парва´ньне, разры´ў
порядок	пара´дак
посадка	паса´дка
посадочная площадка	паса´дачная пляцо´ўка
последовательно	пасьлядо´ўна
последовательность	пасьлядо´ўнасьць
последствие	вы´нік
последующий	дале´йшы, насту´пны
поспешный	пасьпе´шны
посредник	пасрэ´днік
пост	пост
постановка курка	пастано´ўка курка´
пост наблюдения (П.Н.)	пост назіра´ньня (П.Н.)
постовая ведомость	пастава´я ве´дамасьць
постоянный	пастая´нны
пострадавший	пацярпе´ўшы
построение (по-ротно)	пастрае´ньне
построение (для развода)	пастрае´ньне для разво´ду
построение (шеренги)	пастрае´ньне шарэ´нгі
постромки	пастро´нкі
поступок	учы´нак
пост химнаблюдения	пост хімназіра´ньня
пост химтревоги	пост хімтрыво´гі
посыльный	пасы´льны
поташ	по´таш
потеря рабочей смеси (авт.)	стра´та рабо´чай су´месі
потник	патні´к
потолок (ав. - предельная высота под'ёма)	столь
потолочное перекрытие	сто´льнае перакрыцьцё´
поход	пахо´д
походная колонна	пахо´дная калё´на
походная кухня	пахо´дная ку´хня
походное охранение	пахо´днае ахава´ньне
походное положение	пахо´днае стано´вішча
походное снаряжение	пахо´днае знаражэ´ньне
походный порядок	пахо´дны пара´дак
почетная грамота	ганаро´вая гра´мата
почетный красноаармеец	ганаро´вы чырвонаармеец
почин	пача´так
почтарь (голуб.стр.)	пашта´р
появляющаяся цель	цэль, яка´я зьяўля´ецца
пояс	по´яс
поясной ремень	паясны´ рэ´мень
правило (арт.)	праві´ла
правильный	пра´вільны
правильный (арт.)	праві´льны
право	пра´ва
правонарушение	правапарушэ´ньне
правофланговый	правафлянго´вы
превосходство	перава´га
превышение	перавышэ´ньне
преграда	перагаро´да, перашко´да
преграждение	перагаро´да, перагараджэ´ньне
преданность	адда´насьць
предварительная команда	папярэ´дняя кама´нда
предварительный	папярэ´дні
предельная дистанция	грані´чная дыста´нцыя
предельный	грані´чны
предосторожность	перасьцяро´га
предотвращение	папярэ´джаньне, адхіленьне, адвядзе´ньне
предохранитель	засьцяро´жнік
предплечье	прадпле´чча
предпринимать	прадпрыйма´ць, распачына´ць
представление (к награде)	прадстаўле´ньне
предстоящий	надыхо´дзячы
предупреждение	папярэ´джаньне
предшествующий	папярэ´дні
преимущество	перава´га
прекратить	спыні´ць
прекращение	спыне´ньне
преодоление	перамага´ньне, перасі´леньне
препятствие	перашко´да
препятствовать	перашкаджа´ць
прерыватель (св.)	прарыва´льнік
преследование	прасле´дваньне
пресс	прэс
приближение	набліжэ´ньне
приближающийся	той, які набліжа´ецца
прибойник (арт.)	прыбо´йнік
прибор	прыбо´р
привал	прыва´л
приведение в порядок	прывядзе´ньне ў пара´дак
привлечение	прыцягне´ньне
привод (арт.)	прыво´д
приводной	прывадны´
привязь	пры´вязь
пригонка	падго´нка
приготовиться	падрыхтава´цца
прием	прыё´м
приёмная станция	прыё´мная ста´нцыя
приемы изготовки	прыё´мы згато´ўкі
приемный покой	прыё´мны пако´й
прижимные винтики	прыціскны´я ві´нцікі
приз	прыз
приземление	прызямле´ньне
призма	пры´зма
призматический бинокль	прызматы´чны біно´кль
признак	адзна´ка, прыме´та
призыв (в армию)	прызы´ў
приказ	зага´д
приказание	загада´ньне
приклад	прыкла´д
прикладка (стр.)	прыкла´дка
приколыш (палатки, коновязи)	прыко´лыш
прикрытие	прыкрыцьцё´
прикрытие щитовое (арт.)	прыкрыцьцё´ шчытаво´е
прилетная доска (голуб.ст.)	прылё´тная до´шка
прилив	прылі´ў
применение к местности	прыстасава´ньне да мясцо´васьці
применительно	прыстасо´ўна, прыстасава´льна
применять оружие 	ужыва´ць збро´ю
пример	пры´клад
примерный	пры´кладны
примкнуть	прымкну´ць
принуждение	прыму´с
приседание	прысяда´ньне
присмотр	до´гляд
присоединение	далучэ´ньне
пристань	пры´стань
пристегивать	прышпі´льваць
пристрелка	прыстрэ´лка
пристрелка приближением	прыстрэ´лка набліжэ´ньнем
приструг (седло)	прыстру´г
приступить	прыступі´ць
присяга	прыся´га
приторочить (кав.)	прытаро´чыць
притягивай	прыця´гвай
прифронтовой	прыфранто´вы
прицел	прыцэ´л
прицеливание	прыцэ´льваньне
прицеливаться	прыцэ´львацца
прицельная дальность	прыцэ´льная далячыня´
прицельная колодка	прыцэ´льная кало´дка
прицельная муфта	прыцэ´льная му´фта
прицельный прорез	прыцэ´льны прарэ´з
прицельная пружинка	прыцэ´льная спружы´на
прицельная рамка	прыцэ´льная ра´мка
прицельная шпилька	прыцэ´льная шпі´лька
прицельный	прыцэ´льны
прицельный хомутик (стр.)	прыцэ´льны хамуто´к 
пришабить	прышабрава´ць
пришпоривать, пришпорить	прышпо´рваць, прышпо´рыць
пробанивать, пробанить (орудие)	праба´ньваць, праба´ніць
пробег	прабе´г
пробивное действие (стр.)	прабіўно´е дзе´йства
пробка	за´тычка
пробная стрельба	спро´бная стральба´
пробный выстрел	спро´бны стрэл, выстра´л
пробоина	прабо´іна
проведение	правядзе´ньне
проверка	праве´рка
провешивание	праве´шваньне
провод	про´вад
проводить	право´дзіць
проводы	про´вады
проволока	дрот
проволочный	драцяны´
продвигать, продвигаться	прасо´ўваць, прасо´ўвацца
продовольственный	харчо´вы
продолговатый	прадаўгава´ты
продолжительный	доўгача´сны
продольный	прадо´ўжны 
продувка (авт.)	прадува´ньне
проекция	прае´кцыя
прожектор	пражэ´ктар
производить (о разводе)	зрабі´ць
производить (в командиры)	надава´ць го´днасьць
производство выстрела (стр.)	вы´твар стрэлу, вы´стралу
прокладка (авт.)	пракла´дка
пролет (в.-инж)	пралё´т
пролетарская революция	пралета´рская рэвалю´цыя
пролетарское государство	пралета´рская дзяржа´ва
проложение	праклада´ньне
проложить	пракла´сьці
промедление	прамару´джаньне
промежуточный	праме´жны
промер	праме´р
проникать, проникнуть	праніка´ць, прані´кнуць
проникновение	пранікне´ньне
пропеллер (ав.)	прапэ´лер
пропуск	про´пуск
прорезиненная ткань	прагумава´ная ткані´на
прорезь прицела (стр.)	прарэ´з прыцэ´лу
прорезь ударника (стр.)	прарэ´з уда´рніка
прорыв	прары´ў
прорывать, прорываться; прорвать, прорваться	прарыва´ць, прарыва´цца; прарваць, прарвацца
просачивание (о жидк.)	працяка´ньне
просачивание (о живой силе)	праніка´ньне
просека	прасе´ка
проскок	праско´к
прослойка жесткая	прасло´йка цьвё´рдая
пространство	прасто´ра, прасто´р
прострел	прастрэ´л
проступок	прасту´пак, правінава´чаньне
противник	праці´ўнік
противовоздушная оборона (ПВО)	проціпаве´траная абаро´на (ППА)
противогаз	проціга´з
противодействие	процідзе´йства
противоипритный костюм	процііпры´тавы касьцюм
противоминный зонд	процімі´нны зонд
противоречие	супярэ´чнасьць
противотанковое орудие	проціта´нкавая гарма´та
противохимический	про´ціхімі´чны
противоэпизоотия	проціэпізао´тыя
протирка (стр.)	праці´рка
проушина	праву´шына
профилактика	прафіля´ктыка
профиль	про´філь
проходимость (дорожн.)	прахо´днасьць
пружина двуперая (стр.)	спружы´на двупё´рая 
пружина тарелочная	спружы´на тале´ркавая
прыжок	скачо´к
прямая наводка (арт.)	прама´я наво´дка
прямо	пра´ма
прямой выстрел	прамы´ стрэл, вы´страл
прямой начальник	прамы´ нача´льнік
прямой угол	прамы´ ву´гал
пуговка курка (стр.)	гало´ўка курка´
пулемет	кулямё´т
пулемет ручной	кулямё´т ручны´
пулемет станковый	кулямёт ста´нкавы
пулеметная лента	кулямё´тная істу´жка
пулеметные гнезда (в.-инж.)	кулямё´тныя гнё´зды
пулеметные катки 	кулямё´тныя каткі´
пулеметные точки	кулямё´тныя кро´пкі
пулеметный вьюк	кулямё´тны ўюк
пулеметчик	кулямё´тчык
пулеотражатель (ав.)	куляадбіва´льнік
пульверизатор (авт.)	пульвэрыза´тар
пульверизационный карбюратор (авт.)	пульвэрызацы´йны карбюра´тар
пульный вход (стр.)	ку´льны ўвахо´д
пуля 	ку´ля
пункт медицинской помощи	пункт мэды´чнай дапамо´гі
пусковая рукоять (ав.)	пускава´я ру´чка
пустотелая рама (авт.)	пустаце´лая ра´ма
путевое довольствие	забесьпячэ´ньне на даро´гу
путеразрушитель	шляхаразбу´ральнік
пути подвоза	шляхі´ падво´зу
пути сообщения	шляхі´ зно´сін
путлище	путлі´шча
путь следования	шлях ру´ху
пучки (пороха)	пучкі´
пушка (арт.)	пу´шка
пушечная батарея (арт.)	пу´шачная батарэ´я
пыж (стр.арт.)	пыж
пятка	пя´тка
пятно	пля´ма
работное время (прож.)	рабо´тны час
рабочий ход (авт.)	рабо´чы ход
равнение	раўне´ньне
равнинная местность	ро´ўная мясцо´васьць
равномерность	раўнаме´рнасьць
равняйсь	раўня´йся
радиатор	радыя´тар
радио	ра´дыё
радиосредства (св.)	радыёсро´дкі
радиотелеграмма	радыётэлегра´ма
радиотелефон (св.)	радыётэлефо´н
радист	рады´ст
радиус	ра´дыус
разамуничивание (кав.)	разамуні´чваньне
разамуничивать (кав.)	разамуні´чваць
разбивать, разбить	разьбіва´ць, разьбі´ць
разбивка (в.-инж.)	разьбіўка
разборка	разбо´рка
разбрызгиватель (авт.)	распы´рсьнік
разбросанность	раскі´данасьць
развалина	руі´на
разведка	выве´дка
разведчик	выве´дчык
разведывание	выве´дваньне
разведывать	выве´дваць
разведывательный	выве´дчык
развернись	разгарні´ся
развернутый строй	разго´рнуты строй
развернуть	разгарну´ць
развертывание	разго´ртваньне
разветвление 	разгалінава´ньне
развитие (огня)	разьвіцьцё´
развить	разьві´ць
развод	разво´д
разводное кольцо (арт.)	развадно´е кальцо´
разводящий	разво´дны
развьючивание	разую´чваньне
разгар	разга´р
разгибание	разгіна´ньне
разгибатель (арт.)	разгіна´льнік
разграничительная линия	разьмежава´льная лі´нія
разгром противника	разгро´м праці´ўніка
раздвижная щель (бр.)	рассо´ўная шчы´ліна
раздробленность	раздро´бленасьць
раздражающая концентрация	раздражня´ючая канцэнтра´цыя
раздутость (стр.)	разду´тасьць
разлет	разьлё´т
размер	разьме´р
размеренный	разьме´раны
размещать, разместить	разьмяшча´ць, разьмясьці´ць
размещение	разьмяшчэ´ньне
размундштучивать	размуншту´чваць
размыкать, разомкнуть	размыка´ць, разамкну´ць
разнобойность (стр.)	разнабо´йнасьць
разновидность	разнаві´днасьць
разносная книа	разно´сная кні´га
разношенность ствола	разно´шанасьць ствала´
разоблачение	выкрыва´ньне
разойдись	разыйдзі´ся
разомкнись	разамкні´ся
разомкнутый строй	разамкну´ты стро´й
разоружение	разбрае´ньне
разреженный	разрэ´джаны
разрез	разрэ´з
разрезной патрон	разразны´ патро´н
разрыв	разры´ў
разрывной заряд	разры´ўны зара´д
разрядник (арт.)	разра´днік
разряжай	разраджа´й
разряжать	разраджа´ць
разряжение	разраджэ´ньне
раз'езд	разье´зд
раз'едающее действие	разьяда´ючае дзе´йства
район	раё´н
районный пункт	раё´нны пункт
ракета	раке´та
ракетница	раке´тніца
раковина	ра´кавіна, вы´едзіна
рама	ра´ма
ранение	ране´ньне
раненый	ра´нены
ранец	ра´нец
ранцевые огнемёты	ра´нцавыя агнямё´ты
рапорт	ра´парт
рапортовать	рапартава´ць
расквартирование	раскватэрава´ньне
раскос (в.-инж.)	раско´с
раскосной канат (понт.)	раско´сны канат
расположение	разьмяшчэ´ньне
распорядитель	распара´дчык
распорядительность 	распараджа´льнасьць
распорядок	распара´дак
распоряжение	распараджэ´ньне
распределение	разьмеркава´ньне
распределитель (автом.)	разьмеркава´льнік
распределительный вал (авт.)	размеркава´льны вал
распыление 	распыле´ньне
распылитель	распы´льнік
рассеивание	расьсе´йваньне
рассеивающий механизм	расьсе´ваючы мэхані´зм
рассеяный луч (прож.)	расьсе´яны праме´нь
расследование	расьсьле´дваньне
расспрос	ро´спыт
рассредоточение (стр.)	расканцэнтрава´ньне, разгрупава´ньне
расстановка	расстано´ўка
раствор (хим.)	раство´р
раствор циркуля	расчыне´ньне
расстеряность	замяша´ньне
расторопность	растаро´пнасьць
растояние(расстояние)	адле´гласьць
растрелянный	растрэ´ляны
расстройство	расстро´йства
раструб	растру´б
растушевка	растушо´ўка
растяжка	расьця´жка
расчет	разьлі´к
расчленение	расчленава´ньне
расшифровка	расшыфро´ўка
рация (св.)	ра´цыя
реборда (танк.)	рабо´рда
ребро хомутика	кант хаму´ціка
революционный военный совет	рэвалюцы´йны вае´нны саве´т
революционный военный трибунал	рэвалюцы´йны вае´нны трыбуна´л
реверс (авт.)	рэ´верс
реверсивная муфта	рэвэрсы´ўная му´фта
револьвер	рэвальве´р
революция	рэвалю´цыя
революционный	рэвалюцы´йны
революционный комитет	рэвалюцы´йны камітэ´т (Рэўко´м)
регулирующий	рэгулю´ючы
регулятор скоростей (авт.)	рэгуля´тар ско´расьцяй
редан (ав.)	рэда´н
редкий	рэ´дкі
редукционный клапан (авт.)	рэдукцы´йны кля´пан
резерв	рэзэ´рв
резервуар (св.)	рэзэрвуа´р
резиновый 	гу´мавы
результат	рэзульта´т, вы´нік
рейбал (разворотка)	рэйба´л
рейд	рэйд
рейефедор (можа «рейсфедер» ?)	рэйефэ´дар (можа «рэйсфэ´дар ?)
рейка	рэ´йка
рекогносцировка	рэкагнацыро´ўка
рельеф	рэлье´ф
рельефно-перспективный план	рэлье´фна-пэрспэкты´ўны плян
рельс (ж.-д.)	рэ´йка
релэ(реле) (автоматический переключатель)	рэлэ´
реляция (отчет о бое)	рэля´цыя
ремонт	рамо´нт
репс	рэпс
рессора	рысо´ра
рефлектор	рэфле´ктар
решающий	раша´ючы
решение	рашэ´ньне
решительность	рашу´часьць
ржавчина	іржа´
рикошет	рыкашэ´т
риск	ры´зыка
ровик	раво´к
рогатка (в.-инж.)	рага´тка
рогожа	раго´жа
род войск	род во´йска
род оружия	род збро´і
рожки боевой личинки	ро´жкі баяво´й лічы´нкі
ролик (арт.)	ро´лік
ромб	ромб
рота	ро´та
ротный	ро´тны
ротор (авт.)	рато´р
рубашка цилиндра (авт.)	саро´чка цылі´ндра
рубеж	рубе´ж
руби	сячы´
рубильник (прож.)	рубі´льнік
рубка (морск. - каюта на верхней палубе судна или мостике)	ру´бка
ружейные приемы	ружэ´йныя прыё´мы
ружейный	ружэ´йны
ружье	ружжо´
рукав	рука´ў
руководство	кіраўні´цтва
руководство по связи	настаўле´ньне
рукопашный бой	рукапа´шны бой
рукоятка	ру´чка
рукоять эфеса	ру´чка эфэ´са
рулетка	руле´тка
рулон (в.-инж.)	руло´н
руль	руль
румб (направление из центра видимого горизонта к точке его окружности в соответствии с показаниями компаса)	румб
румпель (морск. - рычаг для поворачиванияруля вправо или влево)	румпэ´ль
рупор (сигн.)	ру´пар
русло реки	рэ´чышча
ручка затыльник	ру´чка паты´льніка
ручной	ручны´
рыльце	ры´льца
рысь	рысь
рысью	ры´сьсю
рядовой состав	радавы´ саста´ў, радавы´ склад
рычаг переключения скоростей	вага´р пераключэ´ньня ско´расьцей
рычаг ручного тормоза	вага´р ручно´га то´рмаза
рычажный циркуль	вага´рны цы´ркуль
сабля	ша´бля
сабулит	сабулі´т
садись	сяда´й
сажень	са´жань
саква (кав.)	са´ква
салазки (арт.)	са´начкі
сальник (арт.)	са´льнік
салют	салю´т
самовзвод	самаўзво´д
самовзрывание	самаўзрыва´ньне
самовзрывной	самаўзрыўны´
самовозбуждение	самаўзбуджэ´ньне
самовольная отлучка	самаво´льная адлу´чка
самодействующий	самадзе´йствуючы
самозащита	самаабаро´на
самокат	самака´т
самолет	самалё´т
самообладание	самаўлада´ньне
самоокапывание	самаахвя´рны
самоотверженность	самаахвя´рнасьць
самопожертвование	самаахвярава´ньне
самоснабжение	самазабесьпячэ´ньне
самострел	самастрэ´л
самоувечие	самакале´чаньне
санаторий	санато´ры
сани	са´ні
санитар	саніта´р
санитария	санітары´я
санитарная помощь	саніта´рная дапамо´га
санитарно-обмывочный пункт	саніта´рна-абмыва´льны пункт
санитарный осмотр	саніта´рны агля´д
сантиметр	сантымэ´тр
сапа перакидная(перекидная) (в.-инж.)	сапа перакідна´я
сапа покрытая	сапа накры´тая
сапер	сапё´р
саперная сеть	сапё´рная се´тка
саперная часть	сапё´рная часьць
саперный инструмент	сапё´рны інстру´мант
сапло	сапло´
сапная работа	сапна´я рабо´та
сапун (авт.)	сапу´н
сателит (авт.)	сатэлі´т
сбережение	зьберажэ´ньне
сближение	зьбліжэ´ньне
сбор	збор
сборка	збо´рка
сборное место	збо´рнае ме´сца
сборный пункт	збо´рны пункт
сбруя	збру´я
свайная насадка (в.-инж.)	па´левая наса´дка
сваливание (винт.)	зва´льваньне
свая (в.-инж.)	па´ля
сведение	зьве´стка
свертывание	зго´ртваньне
сверхсрочнослужащий	звыштэрміно´васлу´жачы
светобоязнь	сьветабаязьлі´васьць
световая завеса	сьветава´я засло´на
световой пол (прож.)	сьветава´я падло´га
светометрическая батарея	сьветамэтры´чная батарэ´я
светометрия	сьветамэ´трыя
светофильтр (св.)	сьветафі´льтр
светящаяся бомба	асьвятля´ючая бо´мба
светящиеся снаряды	асьвятля´ючыя знара´ды
свечи	сьве´чкі
свинец	сьвіне´ц
свинцовая оболочка	сьвінцо´вая абало´нка
свисток (сигнал)	сьвісто´к
сводка	зво´дка
своевременный	сваечасо´вы
свойство	уласьці´васьць
связь	су´вязь
сгруппировать	згрупава´ць
сдаться	зда´цца
сегмент	сэ´гмэнт
седлание	сядла´ньне
седло	сядло´
седловина	седлаві´на
седловка	сядло´ўка
секрет	сакрэ´т
секретарь	сакрата´р
секретный	сакрэ´тны
секстан (моркс. - угломерный инстр.)	сэкста´н
сектор (арт.)	сэ´ктар
секундомер	сэкундаме´р
селитра	сялі´тра
селитро-угольная смесь (взр.-вещ.)	сялі´тра-ву´гальная су´месь
сентябрь	ве´расень
сера	се´рка
сердечник	сардэ´чнік
сердцевина рассеивания	сэрцаві´на расьсе´йваньня
среднее отклонение пули	сярэ´дняе адхіле´ньне ку´лі
сережка	падве´сачка
серная кислота	се´рная кіслата´
сернистый газ	сярні´сты газ
сероуглерод	се´ркавугляро´д
сеть	се´тка, сець
сжатая смесь (авт.)	сьці´снутая су´месь
сжатие (авт.)	сьціск
сжатый воздух	сьці´снутае паве´тра, сьці´слае паве´тра
сжиженный	звадкава´ны
сжимающий ход (авт.)	сьціска´ючы ход
сигнал	сыгна´л
сигнализация	сыгналіза´цыя
сигнализировать	сыгналізава´ць
сигналист	сыгналі´ст
сигнальная ракета	сыгна´льная раке´та
сигнальная связь	сыгна´льная су´вязь
сигнальное полотнище	сыгна´льнае пало´тнішча
сигнальный аппарат	сыгна´льны апара´т
сигнальный флажок	сыгна´льны сьцяжо´к
сигнальщик	сыгна´льшчык
сиенна (морск.)	сіе´на
сила	сі´ла
силки	сіло´
сильный напор	мо´цны напо´р
синильная кислота	сіні´льная кіслата´
сирена (сигн.)	сырэ´на
система	сыстэ´ма
сито	сі´та
сифонная трубка	сыфо´нная тру´бка
скатка	ска´тка, скру´так
скат-конус (стр., соединяющийся патронник с каналом)	спуск-ко´нус
скачок	скачо´к
скашивание (ав.)	ско´шваньне
скважина	шчы´ліна
скелет	шкіле´т
скипидар	шпігіна´р
складка	скла´дка
склон	схіл
склянка	шкля´нка
скоба	скаба´
сковывающая группа	ско´ўваючая гру´па
скопление войск	згуртава´ньне во´йска
скорострельность	ско´растрэ´льнасьць
скоротечный 	ско´раце´чны
скошенный паз (стр.)	скры´ўлены паз
скребница	скрабло´
скрещение	скрыжава´ньне
скрытность	скры´тасьць
скрытый 	скры´ты, схава´ны
скрытие	скры´цьце
скульпто-макет	ску´льпта-маке´т
скульпто-маскировка	ску´льпта-маскіроўка
слабый напор	сла´бы напо´р
слаженность	зла´джанасьць, дапасава´ньне
слаженный	зла´джаны
слань (половая слань - понтон.дело)	слань
слева	зьле´ва
следить	сачы´ць
следование команд	рух кама´нд
слезай	зьляза´й
слезоточивое ОВ	сьлезаго´ннае АР
слепка	зьле´пка
сливочное отверстие	зьліўна´я адту´ліна
словесная передача поста	ву´сная перада´ча паста´
словесный приказ	ву´сны зага´д
служба воздушного наблюдения	слу´жба паве´транага назіра´ньня
служба боевого питания	слу´жба баяво´га забесьпячэ´ньня
служу трудовому народу	служу´ працо´ўнаму наро´ду
слюда	сьлюда´
смазочное перо (маш.)	зма´зачнае пяро´
смазочный материал	зма´зачны матэрыя´л
смежная полоса	суме´жная паласа´
смелость	сьме´ласьць
смена	зьме´на
смена углей (прож.)	пераме´на ву´галю
смертельная концентрация	сьмяро´тная канцэнтра´цыя
смесительная камера (маш.)	зьмяша´льная ка´мэра
сметливость	ке´мкасьць, ке´млівасьць
смешанная часть	зьме´шаная ча´сьць
смирно	зважа´й
смола	смала´
смотр	агля´д
смотровая щель (авт.бр.)	назіра´льная шчы´ліна
снабжение	забесьпячэ´ньне
снаряд	знара´д
снаряжение	знараджэ´ньне
снаряженный	знара´джаны
снимок	зды´мак
сноп огня	сноп агню´
сноровка	звы´чка
собачка (морск. - время с 12 до 4 ч. ночи вахтенной службы)	саба´чка
соблюдение	захава´ньне
собрание	сход
собрать лошадь	сабра´ць каня´
совершенно секретно	зусі´м сакрэ´тна
совет (как орг. власти)	саве´т
совещание	нара´да
совокупность	суку´пнасьць
современный	суча´сны
согласование	узгадне´ньне
содействие	садзе´йства
содержание	утрыма´ньне, зьмест
соединение	злучэ´ньне
соединительная втулка (стр.)	злуча´льная ўту´лка
соединительная планка	злуча´льная пла´нка
соединительное кольцо	злуча´льнае кальцо´
соединительный винт	злуча´льны вінт
соединительный рычаг	злуча´льны вага´р
создавать	ствара´ць
сознание	сьвядо´масьць
сокрушительный разгром	руйну´ючы разгро´м, сакруша´льны разгро´м
сокрытие	сукрыцьцё´
соленоид (авт.)	саляно´ід
сомкнись	самкні´ся
сомкнутый	самкну´ты
сомкнуть колонну	самкну´ць калё´ну
соображать	ке´міць, ця´міць
сообразительность	ке´млівасьць, ця´млівасьць
сообщение	паведамле´ньне
сообщить	паве´даміць
сооружение	пабудо´ва
соотношение сил	суадно´сіны сіл
сопло (ав.)	сапло´
соприкосновение	суты´к, сутыка´ньне
соприкасаться	сутыка´цца
сопроводитель (прож.)	суправаджа´льник
сопровождать	суправаджа´ць
сопротивление	супраціўле´ньне
сопряжение (понт.)	супрэ´жаньне
соревнование	спабо´рніцтва
сосок боевой личинки	сасо´к баяво´й лічы´нкі
сосредоточенный заряд (в.-инж. подр.д.)	сканцэнтрава´ны зара´д
сосредоточие	сканцэнтрава´ньне, згуртава´ньне
сосредоточивание огня	сканцэнтрава´ньне агню, згурто´ўваньне агню´
состав	саста´ў
состав обоза	саста´ў або´зу
состав терочный	саста´ў цё´рачны
состав частей	саста´ў часьце´й, склад часьце´й
составление	склада´ньне
состязание	выпярэ´дніцтва, спабо´рніцтва
состояние	стан
сохранение	захава´ньне
социалистическое соревнование	сацыялісты´чнае спабо´рніцтва
социальный	сацыя´льны
сочетание	спалучэ´ньне
сошка	со´шка
сошник (арт.стр.)	сашні´к
сошниковые борозды	сашніко´выя баро´зны
спайка	спа´йка; (о телах) - зьлітава´ньне, зьліто´ўка
спардек (морск. - надстройка над верхней палубой)	спардэ´к
спасательный круг (мор. и понт.)	ратава´льны круг
спектор	спэ´ктар
спектральный (маск.)	спэктра´льны
спектрофотометр	спэктрафато´мэтр
специальный	спэцыя´льны
спираль	сьпіра´ль
спирт	сьпірт
список	сьпі´сак
спица (в.-инж.)	сьпі´ца
сплочение	згуртава´ньне
сплошной	суцэ´льны, по´ўны
сподручное оружие	спадру´чная збро´я
спонсон танка (бр.авт.)	спансо´н та´нка
спортивный	спарты´ўны
способ	спо´саб
спотыкач (в.-инж. - сеть на низких кольях)	спатыка´ч
справка	даве´дка
справочная работа	даве´дчая рабо´та
спуск ударника	спуск уда´рніка
спусковой крючек	спускавы´ кручо´к
спусковой механизм	спускавы´ мэхані´зм
спусковая пружина (стр.)	спускава´я спружы´на
спусковая скоба	спускава´я скаба´
спусковая тяга	спускава´я ця´га
спусковой рычаг	спускавы´ вага´р
сражение	бі´тва
сразить	зьбі´ць, забі´ць
средний	сярэ´дні
средняя скорость (ав.)	сярэ´дняя ско´расьць
средняя точка попадания	сярэ´дняя кро´пка папада´ньня
средства сообщения	сро´дкі зно´сін
средства маскирования	сро´дкі маскірава´ньня
срок	тэ´рмін
срочнослужащий	тэрміно´ва-слу´жачы
сруб (в.-инж.)	зруб
стабилизатор (ав.)	стабіліза´тар
ставить на вид	ста´віць на від
ставка	ста´ўка
стайка	ста´йка
стальной	сталё´вы
станина (арт.)	стані´на
станковый пулемет	ста´нкавы кулямё´т
становой хребет	станавы´ хрыбе´т
становиться	станаві´цца
станок (стрелк.)	стано´к
станция	ста´нцыя
стапель (ав.-мор.)	ста´пель
стартер (в.-инж. - спуск.пруж.)	ста´ртэр
старший	ста´ршы
старшина	старшыня´
статив	статы´ў
статистический материал	статісты´чны матэ´рыял
ствол	ствол
ствольная коробка	ство´льная каро´бка
ствольная накладка (арт.)	ство´льная накла´дка
створ	праме´жак
стебель затвора	сьцябло´ затво´ра
стебель протирки	сьцябло´ праці´ркі
стеклоочиститель	шкло´ачышча´льнік
стелаж	стэ´ляж
стенная газета	насьце´нная газэ´та
степень 	ступе´нь 
стереоскопический снимок	стэрыаскапі´чны зды´мак
стерео-труба (арт.)	стэ´рэа-труба´
стереофотометрия	стэрыафатамэ´трыя
стержень	стры´жань
стесненность	сьці´скнасьць
стихийность	стыхі´йнасьць
стой	стой
стойка (оружие в особых стойках)	сто´йка
стойкие ОВ	сто´йкія АР
стойкость	сто´йкасьць
столкновение	суты´чка
столкнуться	сутыкну´цца
стопни (стр.)	сто´пні
стопор (арт.-стр.)	сто´пар
стопорный клин	сто´парны клін
сторожевое охранение	вартаво´е ахава´ньне
сторожевой	вартавы´
стоя	сто´ячы
стоянка	стая´нка
стража	ва´рта
стратегический	стратэгі´чны
стратегия	стратэ´гія
стрела (морс. - приспособление на судне для под'ема тяжестей)	страла´
стрелка	стрэ´лка
стрелковый	стралко´вы
стрелок 	страло´к
стрельба навесная	стральба´ навесная
стрельба прицельная	стральба´ прыцэ´льная
стрельба по площади	стральба´ па пло´шчы
стрельба с руки	стральба´ з рукі´
стрельба с упору	стральба´ з упо´ру
стрельба очередями	стральба´ чарга´мі
стрельбище	стрэ´льбішча
стрелковое обучение	стралко´вае навуча´ньне
стрелковый городок	стралко´вы гарадо´к
стрелок 	страло´к
стрелять	страля´ць
стремительность	імпэ´тнасьць
стремя	стрэ´мя
стремянки (авт.)	стрэмя´нкі
стрингель (гидр.)	стрынге´ль
стробоскоп (приб. для изм.вибр.звук. и движ.предм.)	страбаско´п
строевой	страявы´
строй	строй
строиться	стро´іцца
структура	структу´ра
струя	струме´нь
студенистый динамит	студзяні´сты дынамі´т
ступень скорости (авт.)	ступе´нь ско´расьці
ступица колеса	кало´дка ко´ла
стык	суты´к, сутыка´ньне
стягивать	сьця´гваць
стягивающий винт	сьця´гваючы ві´нт
суголовный ремень (уздечка)	сугало´ўны рэ´мень
судно	судно´
суживать	зву´жваць, звужа´ць
сумка	то´рбачка
супонь	супо´нь
сурик	су´рык
суточное довольствие	су´тачны спажы´так
суточный наряд	су´тачны нара´д
сухопутное войско	сухапу´тнае во´йска
сухие противогазы	сухі´я проціга´зы
сухопарник (паровоз)	сухапа´рнік
сфера 	сфэ´ра
сферический	сфэры´чны
схватка	схва´тка
схема	схэ´ма
сходня (понт.)	схо´дня
сходственная сторона	падо´бны бок
сходящиеся линии	сходны´я лі´ніі
стяги	сьця´гі
счет	раху´нак
счетчик (автом.)	лічы´льнік
счетчик числа ходов (маш.)	лічы´льнік лі´ку хо´даў
сыпь.	сы´пка
табель	та´бель
таблица	таблі´ца
тавот (смаз.вещ.)	таво´т
тавотница (авт.)	таво´тніца
тавро (арт.)	таўро´
тайна	та´йна
тайный	тае´мны
такелаж (мор.)	такела´ж
таксикология(токсикология)	таксыкалё´гія
таксические(токсические) свойства	таксі´чныя ўласьці´васьці
такт	такт
тактика	та´ктыка
тактический	такты´чна
талант	та´лент
талантливый	таленаві´ты
тамбур	та´мбур
тангентная спица (авт.)	та´нгентная сьпі´ца
тангенцианальная опора (мост.)	тангенцыяна´льная апо´ра
танк	танк
танк-дегазатор	танк-дэгаза´тар
танкетка	танке´тка
танкодром (танк)	танкадро´м
таран (морск. - выдающаяся под водой носовая часть корабля)	тара´н
тарелочные пружины	тале´ркавыя спружы´ны
тарель (арт.)	та´рель
тахограмма (маш.)	тахагра´ма
тахограф (маш.)	тахо´граф
тахометр (маш.)	тахо´мэтр
тачанка	тача´нка
твердый	цьвё´рды
тебенок (крыло у седла)	тэ´бянок
телеграмма	тэлегра´ма
телеграф	тэлегра´ф
телеграф акустический	тэлегра´ф акусты´чны
телеграф беспроолочный	тэлегра´ф бяздро´тавы
телеграф оптический	тэлегра´ф опты´чны
телеграф электрический	тэлегра´ф электры´чны
телеграфист (св.)	тэлеграфі´ст
телеграфия	тэлеграфі´я
телеграфный	тэлегра´фны
телескоп	тэлеско´п
телефон	тэлефо´н
телефонировать	тэлефанава´ць
телефония	тэлефані´я
телефонная двуколка	тэлефо´нная двухко´лка
телефонограмма	тэлефо´награ´ма
тело орудия (пулемета)	це´ла гарма´ты
темляк	цямля´к
темнота	це´мра, цемната´
темный	цё´мны
темп	тэмп
температура	тэмперату´ра
темя	це´мя
тендер (паровоз)	тэ´ндэр
тень	цень
теодолит	тэадалі´т
термит	тэрмі´т
термический	тэрмі´чны
термометр	тэрмо´мэтр, гра´дусьнік
термометрия	тэрмамэтры´я
термос	тэ´рмас
термосифонный (авт.)	тэрмасыфо´нны
термостат (автом.)	тэрмоста´т
территория	тэрыто´рыя
территориальный	тэрытарыя´льны
территориальнаячасть	тэрытарыя´льная часьць
тесак	цяса´к
теснина	цясьні´на
теснить	цясьні´ць
тесьма (стр.)	тасьма´
тетрил (взрыв.)	тэтры´л
техника	тэ´хніка
техник	тэ´хніка
технический	тэхні´чны
течение	цячэ´ньне
течение (в перен. смысле)	плынь
типограф	друка´р
типография	друка´рня
тир	цір
ткань	ткані´на
товарищ	тава´рыш
товарищеский	тавары´скі
ток	ток
токовращатель	то´кавярча´льнік
токсичность	таксы´чнасьць
тол (взрыв.вещ.)	тол
толкатель (авт.)	штурха´ч, штурха´льнік
толовая сумка (подрывн.дело)	то´лавая то´рбачка
толовый капсуль (взрывч.)	то´лавы ка´псуль
толуол	талюо´л
тонна	то´на
тоннель	тунэ´ль
топлипровод (авт.)	апалаправо´д
топограф	тапо´граф
топография	тапагра´фія
топографический	тапаграфі´чны
топор	сяке´ра
топорище	тапары´шча
торба конская (кавал.)	то´рба ко´нская
торец (авт.)	то´рэц
торжественный 	урачы´сты
тормоз	то´рмаз
тормозная лента (авт.)	то´рмазная істу´жка, то´рмазная ле´нта
тормозная пластинка	тармазна´я пласьці´нка
торопливость	пасьпе´шлівасьць, пасьпе´шка
торпеда (морск. - самодвижущаяся мина)	тарпэ´да
торпедоносная авиация (морск.)	тарпэдано´сная авіа´цыя
точка	кро´пка
точка зрения	пункт по´гляду, пункт гле´джаньня
точка попадания	кро´пка папада´ньня
точка прицеливания	кро´пка прыцэ´льваньня
точность масштаба	дакла´днасьць машта´бу
траверс (в.-инж.)	тра´вэрс
традиция	трады´цыя
траектория	траекто´рыя
трактор	тра´ктар
тракторист	трактары´ст
тральщик (судно, приспособленное для вылавливания и уничтожения мин.заграждений)	тра´льшчык
трамблер (распределитель)	тра´мблер (разьмеркава´льнік)
трамплин	трамплі´н)
транслятор (тел.)	трансля´тар
трансляция	трансля´цыя
трансмиссия (авт., тракт.)	трансмі´сія
транспортный	тра´нспартны
транспортный	тра´нспарт
транспортир	транспарты´р
трансформатор (арт.)	трансфарма´тар
трансформирование (арт.)	трансфармава´ньне
трансформация (арт.)	трансфарма´цыя
транцевый брусок (понтон)	тра´нцавы брусо´к
траншея	траншэ´я
трап (лестница на корабле)	трап
трапеция (физо)	трапэ´цыя
трасировка	трасыро´ўка
трасировочный шнур (сап.)	трасырава´льны шнур
трасирующая пуля	трасыру´ючая ку´ля
трафарет	трафарэ´т
требование	патрабава´ньне
требовать	патрабава´ць
тревога	трыво´га
тревожить	трыво´жыць
трензель	трэ´нзель
трензельные поводья	трэ´нзельныя павады´
трензельные удила (кавал.)	трэ´нзельныя цу´глі
трение	трэ´ньне
тренировка	трэніро´ўка
тренога	трыно´га
тресировка (в.-инж.)	трэсіро´ўка
треугольник	тро´хвуго´льнік, трыку´тнік
треугольник погрешности (топ.)	трохку´тнік пагрэ´шнасьці
трехгранный	трохканто´вы
треххлористый мышьяк	тро´ххлёрны арсэ´н
трехсторонний	тро´хбако´вы
трехфазный ток (электр.)	тро´хфаз´ны ток
трещать	трашча´ць
трещетка	трашчо´тка
трещина	шчы´ліна
трибунал	трыбуна´л
тригонометрическа точка (топ.)	трыганамэтры´чная кро´пка
тринитротоул	трынітрато´ул
тринитрофенол (хим.)	трынітрафэно´л
триплан (ав.)	трыпля´н
тройник	трайні´к
тройник-патрубок	трайні´к-патру´бак
тройной	трайны´
трок	трок
тропа	сьце´жка
тропик	тро´пік
трос (морск.)	тро´с
тросовая подвеска (танк)	тро´савая падве´ска
тротил	траты´л
трофеи	трафэ´і
труба (в.-инж.)	труба´
трубач	труба´ч
трубить	трубі´ць
трубка дистанционная	тру´бка дыстанцы´йная
трубка вытежная(вытяжная)	тру´бка выцяжна´я
трубка замочных рычагов	тру´бка замкавы´х вагаро´ў
трубка пароотводная	тру´бка параадво´дная
трубка штыковая	тру´бка штыхава´я
трубчатая ось (стр.)	трубча´стая вось
труд	пра´ца
труднолетучий	цяжкалё´тны
тринчик	тры´нчык
трюм (морск.)	тру´м
трясина	дрыгва´
тугой	тугі´
тугость	ту´гасьць
туз (морск. - самая маленькая шлюпка для одного гребца)	туз
туловище	ту´лава
тулуп	кажу´х
туман	тума´н
тумба (брон.-ч., арт.)	ту´мба
туманообразование	туманаўтварэ´ньне
тупик	тупі´к
тупой	тупы´
тур	тур
турбовентилятор (авт.)	турбавэнтыля´тар
турбокомпрессор (ав.мот.)	турбакампрэ´сар
турель (ав. - часть самол)	турэ´ль
турник	турні´к
тусклый	цьмя´ны
тушить	тушы´ць
тщательно	стара´нна
тыл	тыл
тыл армии	тыл а´рміі
тыл глубокий	тыл глыбо´кі
тыловая позиция	тылава´я пазы´цыя
тыловая часть	тылава´я часьць
тыловые пути	тылавы´я шляхі´
тыльный	ты´льны
тычком	тарчма´
тяжесть	цяжа´р
тюфяк фашинный	сяньні´к фашы´навы
тяга (авт.)	ця´га
тягометр	цягаме´р
тягометр (мех.)	цягамэ´тр
тяж несущий	цяж нясу´чы
убегать, убежать	уцяка´ць, уцячы´
убеждать, убедить	перако´нваць, пераканаць
убеждение	перакана´ньне
убежище	схо´вішча
убежище котлованное	схо´вішча катлава´ннае
убежище тяжелое	схо´вішча ця´жкае
убойная 	забо´йная
убирать, убрать	убіра´ць, убра´ць
убирать, убрать (о помещении)	прыбіра´ць, прыбра´ць
убор	убо´р
уборка	убо´рка
уборка лошади	чы´стка каня´
уборщик	прыбіра´льшчык
уведомление	паведамле´ньне
уведомлять, уведомить	паведамля´ць, паве´даміць
увеличение	павялічэ´ньне
увеличивать, увеличить	павялі´чваць, павялі´чыць
увеличительный	павяліча´льны
уверенность	упэ´ўненасьць
уверенный	упэ´ўнены
увечье	кале´цтва
увлекать	захапля´ць
увлекать (личным примером)	натхня´ць
увлечение	захапле´ньне, натхне´ньне
увольнение	звальне´ньне
увольнительная записка	запі´ска аб звальне´ньні
увязка	увя´зка
увязываться в бой	увя´звацца ў бой
углекислотаа	вуглякіслата´
угломер	вугламе´р
угломерное кольцо	вугламе´рнае кальцо´
угломерный барабанчик	вугламе´рны бараба´нчык
угломер-трансформатор (арт.)	вугламе´р-трансфарма´тар
углубление	паглыбле´ньне
углублять, углубить	паглябля´ць, паглы´біць
угнетать	прыгнята´ць
угнетение	прыгне´чаньне
угол	ву´гал
угол бросания	ву´гал кі´даньня
угол встречи	ву´гал сустрэ´чы
угол вылета	ву´гал вылё´ту
угол выстрела	ву´гал стрэ´лу, вы´стралу
угол местности	ву´гал мясцо´васьці
угол наклона прямой	ву´гал нахі´лу простай
угол отклонения	ву´гал адхіле´ньня
угол падения	ву´гал падзе´ньня
угол приклада	ву´гал прыкла´да
угол прицельвания	ву´гал прыцэ´льваньня
угол склонения	ву´гал схіле´ньня
угольник	вуго´льнік
угрожать	пагража´ць
угроза	пагро´за
удар	уда´р
ударная группа	уда´рная гру´па
ударник	уда´рнік
удвоение	падвае´ньне
удвоять	падвая´ць
удельный вес	удзе´льная вага´
удержание пространства	утрыма´ньне прасто´ру
удила	цу´глі
удлиненный заряд (в.-инж.-подр.дело)	падо´ўжаны зара´д
удовлетворительно	здавальня´юча
удостоверение	пасьве´дчаньне
удушье	уду´шша, заду´шша
удушающие ОВ	удуша´льныя АР
удушливый газ	уду´шлівы газ, уду´шны газ
ужин	вячэ´ра
ужинать	вячэ´раць
уздечка	вуздэ´чка
узел	ву´зел
узкий	ву´зкі
узловые пазы (стр.)	вузлавы´я пазы´
указатель числа оборотов (маш.)	пака´зьнік лі´ку зваро´таў
указательный	указа´льны
указка	ука´зка
укладывать, уложить	уклада´ць, укла´сьці
уклон	ухі´л, нахі´л
уклонение	ухіле´ньне
уклоны корпуса	нахі´лы ко´рпусу
уклоняться	ухіля´цца
укомплектовать	укамплектава´ць
укоренение	укаране´ньне
укрепление боеспособности	умацава´ньне бо´яздо´льнасьці
укрепленный	умацава´ны
укреплять, укрепить	умацо´ўваць, умацава´ць
укрытие	прыкрыцьцё´
укрыться	схава´цца
уличный бой	ву´лічны бой
ультиматум	ультыма´тум
ультрамарин	ультрамары´н
умбра	у´мбра
уменьшение	памяньшэ´ньне
умеренный	уме´рны, ме´рны
уничтожать, уничтожить	зьніштажа´ць, зьнішто´жыць, зьнішча´ць, зьні´шчыць
унос	уно´с
уносный крюк (арт.)	уно´сны кру´к
упадок	заняпа´д
уполномоченный	упаўнава´жаны
упор	упо´р
упорная муфта	упо´рная му´фта
упорная оборона	упа´ртая абаро´на
упорядочить	упара´дкаваць
управление	кіраўні´цтва
управлять	кірава´ць
упражнение	практыкава´ньне
упражнять, упражняться	практыкава´ць, практыкава´цца
упреждение	упярэ´джаньне
упругость паров	пру´гкасьць па´ру
упряжь	ву´праж
ура	гура´
ураган	гурага´н
ураганный	гурага´нны
уровень	узро´вень
урегулировать	урэгулява´ць
усердный	шчы´ры
усиленное питание (боеприп.)	узмо´цненае забесьпячэ´ньне
усиленное питание (продов.)	узмо´цненае харчава´ньне
ускоренный шаг	паско´раны шаг
ускоритель (стр.)	паскара´льнік
условие	умо´ва
условные сигналы	умо´ўныя сыгна´лы
усложнять	ускладня´ць
усовершенствование	удаскана´леньне
успех	по´сьпех
успешность	пасьпяхо´васьць
устав	стату´т
уставлять, уставить	устаўля´ць, уста´віць
усталость	сто´мленасьць
усталость	сто´млены
установка прицела	устано´ўка прыцэ´лу
установление	устанаўле´ньне
устное распоряжение	ву´снае распараджэ´ньне
устойчивость	усто´йлівасьць
устранение	устаране´ньне, адхіле´ньне
устройство	будо´ва
утопить патрон	утапі´ць патро´н
утренняя заря	ра´нішняя зара´
утренний осмотр	ра´нішні агля´д
утяжелитель	уцяжа´рнік
участник	удзе´льнік
участок	уча´стак
учебный	вучэ´бны
учет	улі´к, улічэ´ньне
учитель	наста´ўнік
учреждение	устано´ва
уход (досмотр)	дагля´д
ушко (стр.)	ву´шка
ущелье	вушчэ´льле
уязвимость	сла´басьць, уця´тнасьць
уязвимый	слабы´, уця´тны
усы	ву´сы
фаза	фа´за
факел	фа´кел
фаланга	фаля´нга
фальсификация	фальсыфіка´цыя
фамилия	про´зьвішча
фара (авт.)	фа´ра
фашина	фашы´на
февраль	лю´ты
февральский	лю´таўскі
фейерверк	фэервэ´рк
фельдшер	фэ´льчар
ферватер (морск.)	фэрва´тар
ферма (мост.)	фэ´рма
феррадо (авт.)	фэра´до
фехтование	фэхтава´ньне
фехтовать	фэхтава´ць
фигура	фігу´ра
фигурный	фігу´рны
физика	фі´зыка
физический	фізы´чны
фильтр (в.-инж.)	фільтр
фильтр-поглотитель	фільтр-паглына´льнік
фильтрирующий слой	фільтру´ючы слой
фитиль	кнот
флаг	сьцяг
флагман (морск. - лицо, командующее отрядом или эскадрой, имеющее право держать на своем корабле присвоенный его званию флаг)	фля´гман
фланг	фля´нг
фланговый	фля´нгавы
фланец	фля´нец
фланкирующая постройка	флянку´ючая пабудо´ва
флейцы	фле´йцы
флот	флёт
флотилия	флётылія
флюгер	флю´гер
фляга	бакла´жка, фля´га
фок-мачта (морск. - передняя мачта)	фо´к-ма´шта
фокус	фо´кус
фон	фон
фонарь	ліхта´р
форма	фо´рма
формалин	фармалі´н
формирование	фармава´ньне
формула	фо´рмула
формуляр	формуля´р
форпост	фарпо´ст
форпостник	фарпо´ставік
форпостный аппарат (св.)	фарпо´ставы апара´т
форсирование	фарсірава´ньне
форсировать	фарсірава´ць
форт	форт
фортификация (в.-инж.)	фартыфіка´цыя
фортификация полевая	фартыфіка´цыя палява´я
форштевень	фарштэ´вень
фосген	фасгэ´н
фотограмметрия	фатаграмэ´трыя
фотограф	фато´граф
фотография	фатаграфі´я
фотосъемка	фотазды´мка
фототеодолит	фо´татэадалі´т
фрикцион (тракт.)	фрыкцыё´н
фронт	фронт
фронтальный	франта´льны
фронтовой	франтавы´
фугас камнеметный	фуга´с каменямё´тны
фугас подводный	фуга´с падво´дны
фугас пороховой	фуга´с парахавы´
фугас противотанковый	фуга´с проціта´нкавы
фугас-спотыкач	фуга´с-спатыка´ч
фугас шрапнельный	фуга´с шрапнэ´льны
фугас ярусный	фуга´с я´русны
фугасный огнемет	фуга´сны агнямё´т
фугасный снаряд	фуга´сны знара´д
функция	фу´нкцыя
функционировать	функцыянава´ць
фураж	фура´ж
фургон	фурго´н, фу´ра
фут	фут
фюзеляж (ав.)	фюзеля´ж
фюзеляжный аппарат (ав.)	фюзеля´жны апара´т
халат	хала´т
халатный	нядба´йны
характер	хара´ктар
характеристика	характары´стыка
хватание	хапа´ньне
хватать	хапа´ць
хвост	хвост
хвостовой винт	хваставы´ вінт
химическая бомба	хімі´чная бо´мба
химический состав	хімі´чны саста´ў
химия	хі´мія
хирург	хіру´рг
хирургический	хірургі´чны
хлебапек	хлебапё´к
хлор	хлёр
хлораты	хлёра´ты
хлорацетофенон	хлё´рацэтафэно´н
хлорацетон	хлё´рацето´н
хлорид	хлёры´д
хлористый аммоний	хлё´рысты амо´ній
хлористый кремний	хлё´рысты крэ´мній
хлорпикрин	хлёрпікры´н
хлорноватокислый натрий	хлёрнаватакі´слы на´тры
хлорсульфоновая кислота	хлёрсульфо´навая кіслата´
хобот	хо´бат
ход	ход
ходовая линия	хадава´я лі´нія
ходовой винт	хадавы´ ві´нт
ходоуменьшитель (маш.)	хо´дапамяньша´льнік
ход сообщения (в.-инж.)	ход зносін
ход сообщения змейкой	ход зносін зьме´йкай
ход сообщения зигзагом	ход зносін зігза´гам
ход сообщения изломами	ход зносін зало´мамі
хозяйственная часть	гаспада´рчая часьць
холмистая местность	узго´рыстая мясцовасьць
холм	узго´рак
холод	хо´лад
холодильник	халадзі´льнік
холодное оружие	хало´дная збро´я
холостой заряд	халасты´ зара´д
холостой патрон	халасты´ патро´н
хомут	хаму´т
хомутик штыковой	хамуто´к штыхавы´
хомутина	хамуці´на
храбрость	хра´брасьць, адва´жнасьць
хранилище огнеприпасов	хава´льня агняпрыпа´саў
храповое колесо	храпаво´е ко´ла
хребет	хрыбе´т
хронометр	храно´мэтр
хроноскоп	хранаско´п
цапфа	ца´пфа
царапина	дра´піна
цвет	ко´лер
цветозащитный	ко´лераахо´ўны
цевье	цаўё´
цейхгауз	цэйхга´уз
целесообразность	мэтазго´днасьць
целик	цэ´лік
целиться	цэ´ліцца
цель	цэ´ль
цель (переносно)	мэ´та
целлюлоидный круг	цэлюлё´ідны круг
цементирующий	цэмэнту´ючы
центр	цэнтр
централизация	цэнтраліза´цыя
центрующее утолщение	цэнтру´ючае патаўшчэ´ньне
цепь	ланцу´г
цикл	цыкль
цилиндр	цылі´ндр
цилиндр двойного действия	цылі´ндр падво´йнага дзе´йства
цилиндрический луч (прож.)	цыліндры´чны праме´нь
цинк	цынк
цинковые белила	цы´нкавыя бялі´лы
циркуль	цы´ркуль
циркуляр	цыркуля´р, абе´жнік
циркуляционный насос	цыркуляцы´йная по´мпа
цифра	цы´фра
чапрак (седло)	чапра´к
часовой	часавы´
частный	прыва´тны
часть	часьць
часть (предмета)	ча´стка
часы	гадзі´ньнік
чашечка (стр.)	ча´шачка
чека	за´гваздка
челнок	чаўно´к
червеобразный винт	чарвяпадо´бны вінт
червяк	чарвя´к
черта	ры´са, чырта´
чертеж	чарцё´ж
четкость	дакла´днасьць, выра´знасьць
четный	цо´тны
четырехгранный	чатырохгра´нны
четырехлористый углерод	чатыро´хлё´рысты вугляро´д
четырехлористый титан	чатырохлё´рны тыта´н
четырехтактный процесс (ав.)	чатыро´хтакта´вы працэ´с
четырехугольный	чатыро´хвуго´льны
чехол	чахо´л
чечевица (тех.)	чачаві´ца
численность войск	ко´лькаснасьць во´йска
численный состав	ко´лькасны саста´ў, ко´лькасны склад
чистить	чы´сьціць
чистка	чы´стка
чихательные О.В.	чыха´льныя А.Р.
чолка	гры´ўка
чрезвычайный	надзвыча´йны
чугун	чыгу´н
чумбур (кавал.)	чумбу´р
чучело	чу´чала
шаблон	шаблё´н
шабровка	шабро´ўка
шаг	шаг
шагом	ша´гам
шагомер	шагаме´р
шайба	ша´йба
шалаш	шала´ш
шанцевый	ша´нцавы
шанцевые молотки	ша´нцавыя малаткі´
шар	шар
шариковый подшипник	ша´рыкавы падшы´пнік
шарнир	шарні´р
шарнирное сцепление	шарні´рнае счапле´ньне
шарнирный клапан	шарні´рны кля´пан
шарнирный болт (стр.)	шарні´рны болт
шаровары	штаны´
шарообразный	шарападо´бны
шатание	хіста´ньне
шатун	шату´н
шатунный подшипник	шату´нны падшы´пнік
шашка	ша´шка
шашка буровая	ша´шка сьвідрава´я
шваллер	шва´лер
шедит	шэды´т
шейка	шы´йка
шенкель	шэ´нкель
шептало	шапта´ла
шеренга	шарэ´нга
шероховатый	шурпа´ты
шестерня	шасьцярня´
шефство	шэ´фства
шило	шы´ла
шина	шы´на
шинель	шынэ´ль
шип	шып
ширина	шырыня´
широта	шырата´
шифр	шыфр
шифрер	шыфрэ´р
шкала отражателя 	шкала´ адбіва´льніка
шканцы (морское.)	шка´нцы
шкафут (морск.)	шкафу´т
шквал	шквал
шкив	шкі´ў
шкипер (морск.)	шкі´пер
шлагбаум	шлягба´ум
шланг	шля´нг
шлем 	шлем
шлея	шле´я
шлица	шлі´ца
шлюз	шлюз
шлюзованный	шлюзава´ны
шляпка патрона	шля´пка патро´на
шнейдерит	шнэйдэры´т
шнур	шнур
шомпол	шо´мпал
шомпольная дорожка	шо´мпальная даро´жка
шомпольная муфта	шо´мпальная му´фта
шоссе	шаса´
шпага	шпа´га
шпангоут	шпанго´ут
шпахтель	шпа´хтэль
шпигель (арт.)	шпі´гель
шпилька	шпі´лька
шпиндель клапана (маш.)	шпіндэль кля´пана
шпион	шпіё´н
шпионаж	шпіяна´ж
шплинт (арт.)	шплінт
шплинтовыдергиватель	шплінтавырыва´льнік
шпонка	шпо´нка
шпоры	шпо´ры
шприц	шпрыц
шпрунт (кав.)	шпру´нт
шрапнель	шрапнэ´ль
штаб	штаб
штабной	штабны´
штамп	штамп
штанга	шта´нга
штангенцыркуль	штангенцы´ркуль
штат	штат
штевень (м., понт.)	штэ´вень
штепсель (св.)	штэ´псель
штиборт (ав.-мор.)	штыбо´рт
штифт (св.)	штыфт
шток	шток
штопор (авиац.)	што´пар
шторм-трап (морск. - веревочная лестница, свешиваемая за борт для приема людей)	што´рм-тра´п
штрих	штрых
штроп (понт.)	штроп
штурвал (ав.)	шту´рвал
штурм	штурм
штурман (морск. - кораблеводитель)	шту´рман
штурмовать	штурмава´ць
штурмовик (ав.)	штурмаві´к
штуцер (автом.)	шту´цар
штык	штых
штыковой хомутик	штыхавы´ хамуто´к
штырь (арт.)	штыр
шуруп	шуру´п
щеколда	шчыкалда´
щелка	шчы´ліна
щелкать (затвором)	ля´скаць (затво´рам)
щелочь	шчо´лач
щель	шчы´ліна
щепа (в.-дорож.дело)	шчапа´, дрань
щечный ремень (узд.)	шчо´чны рэ´мень
щит стрелковый	шчыт стралко´вы
щитовидный	шчытападо´бны
щуп (авт.)	шчуп
щупальцы (кав.)	шчу´пальцы
эбонит	эбані´т
эвакуацыя	эвакуа´цыя
эвакуированный	эвакуава´ны
эжектор	эжэ´ктар
экипаж (команда судна)	экіпа´ж
экипаж (пролетка)	фая´тон
эккер	э´кер
эклимер	эклімэ´тр
экселлератар (авт.)	эксэсэра´тар
экскаватар	экскава´тар
экспедитор	экспэды´тар
экспедиционный отдел	экспэдыцы´йны аддзе´л
экспедиция	экспэды´цыя
экстрактор (приб. - для извлеч.гильз)	экстра´ктар
эксцентрик (маш.)	эксцэ´нтрык
эксцентрическая ось (авт.)	эксцэнтры´чная вось
электрический способ взрывания	электры´чны спо´саб узрыва´ньня
электрод (авт.-тракт.)	электро´д
электродетонатор	электрадэтана´тар
электромагнит	электрамагні´т
электроосветительный	электраасьвятля´льны
элемент	элемэ´нт
элерон (ав. - часть крыльев)	элеро´н
эллинг (морск. - место постройки кораблей на берегу)	э´льлінг
эллипс рассеивания	эліпс расьсе´йваньня
эпидемия	эпідэ´мія
эскадра	эска´дра
эскадрилья	эскадры´лья
эскадрон	эскадро´н
эскадронный миноносец (эсминец)	эскадро´нны мінано´сец (э´сьмінец)
эскарп	эска´рп
эспадрон	эспадро´н
эспланада	эспляна´да´
эстакада (понт.)	эстака´да
этап	эта´п
этапно-транспортная служба	эта´пна-тра´нспартная слу´жба
эфес	эфэ´с
эффект	эфэ´кт
эшалон	эшалё´н
эшелонирование	эшалёнава´ньне
юг	по´ўдзень
юго-восток	паўднё´вы ўсхо´д
юнга	ю´нга
ют (кормовая часть верхней палубы)	ют
ядовитый газ	ядаві´ты газ
ядро	ядро´
явка	я´ўка
являться, явиться	зьяўля´цца, зьяві´цца
язычек	язычо´к
якорь (морск. и понт.)	я´кар
яма	я´ма
январь	сту´дзень
ярость	я´расьць
ячэйка	ячэ´йка
ящик зарядный	скры´нка зара´дная
##Chapter: 2. Дадатак
АРГК	АРГК (артылерыя рэзэрву Галоўнага Камандаваньня)
БКП	БКП (батарэйны камандзірскі пункт)
БУсП	БСтП (баявы статут пяхоты)
ВВ	УР (узрыўныя рэчывы)
ВВС моря	ВВС мора (Ваенна-паветраныя сілы мора)
ВЛКСМ	УсеЛКСМ (Усесаюзны Ленінскі Камуністычны Саюз Моладзі)
ВНОС	ПНАС (паветранае назіраньне, апавяшчэньне і сувязь)
ВОХИМУ	ВАХІМУ (Ваенна-Хімічная Управа)
ВЦИК	УсеЦВК (Усесаюзны Цэнтральны Выканаўчы Камітэт)
ДД	ДД (Дывізыённая група далёкага дзейства)
ДКП	ДКП (Дывізіённы Камандны пункт)
КП	КП (Камандны пункт)
Начваендор	Начваендар (Начальнік ваеннай дарогі)
Нач.ВХС	Нач.ВГЗ (Начальнік ваенна-гаспадарчаго забесьпячэньня)
начсостав	начсастаў, начсклад (Начальніцкі састаў, начальніцкі склад)
начштаба	начштаба (Начальнік штаба)
начштарм	начштарм (Начальнік штаба арміі)
НП	НП (Назіральны пункт)
ОВ	АР (Атрутныя рэчывы)
ОП	АП (Апорны пункт)
ОР	АР (Асобны разьезд)
ОСНАЗ	АСПРЫЗ (Атрад асобага прызначэньня)
ОСОАвиахим	АСОАвіахім (Таварыства садзейнічаньня авіацыі і хіміі)
ОСП	АСП (Аддзяленьне сувязі з пяхотай)
ПА	ПА (Палкавая артылерыя)
ПБ	ПБ (Перадавы батальён)
ПЕРПИТ	ПЕРХП (Перадавы харчавальны пункт)
погранохрана	пагранахова (Пагранічная ахова)
Подив	Падыў (Політычны аддзел дывізіі)
Подлодка	падлодка (Падводная лодка)
ПОКОР	ПАКОР (Палітычны аддзел Корпусу)
ПП	ПП (Артылерыя падтрыманьня пяхоты)
ПТО	ПТА (Процітанкавая абарона)
ПУ	ПС (Палявы статут)
ПУАРМ	ПУАРМ (Палітычная Управа Арміі)
РККА	РСЧА (Рабоча-Сялянская Чырвоная Армія)
РО	ВА (Выведчы атрад)
СОВ	УАР (Устойлівыя атрутныя рэчывы)
